Game Id;PlayerId;TeamId;Game Rating;SA;GA;SV;SV%;TOI;PIM
23029;13;7;0;0;0;0;.00nan;0;0
23029;295;24;64;18;1;17;.944;3600000;0
23029;316;7;59;37;5;32;.865;3600000;0
23029;593;57;0;0;0;0;.00nan;0;0
23031;360;16;77;23;2;21;.913;3600000;0
23031;1149;12;0;0;0;0;.00nan;0;0
23031;1278;12;47;40;5;35;.875;3600000;0
23031;2687;16;0;0;0;0;.00nan;0;0
23024;419;20;0;0;0;0;.00nan;0;0
23024;707;20;79;46;5;41;.891;3600000;0
23024;1163;0;86;32;2;30;.938;3600000;0
23024;2804;0;0;0;0;0;.00nan;0;0
23038;737;23;85;44;4;40;.909;3600000;0
23038;1021;15;78;25;1;24;.960;3600000;0
23038;2375;23;0;0;0;0;.00nan;0;0
23038;2751;50;0;0;0;0;.00nan;0;0
23095;711;3;100;30;0;30;1.000;3600000;0
23095;1731;3;0;0;0;0;.00nan;0;0
23095;2174;18;53;18;2;16;.889;3544000;0
23095;2314;18;0;0;0;0;.00nan;0;0
23079;734;2;23;29;7;22;.759;3363000;0
23079;1355;2;41;2;1;1;.500;237000;0
23079;1962;58;43;31;6;25;.806;3600000;0
23079;2800;1;0;0;0;0;.00nan;0;0
23103;112;13;53;46;6;40;.870;2733000;0
23103;714;13;55;5;0;5;1.000;867000;0
23103;2269;25;90;32;1;31;.969;3600000;0
23103;2973;36;0;0;0;0;.00nan;0;0
23082;482;6;0;0;0;0;.00nan;0;0
23082;483;6;100;53;0;53;1.000;3600000;0
23082;998;8;0;0;0;0;.00nan;0;0
23082;2266;8;81;43;4;39;.907;3600000;0
23019;103;30;75;27;2;25;.926;3600000;0
23019;1406;21;71;33;4;29;.879;3600000;0
23019;1690;21;0;0;0;0;.00nan;0;0
23019;2549;30;0;0;0;0;.00nan;0;0
23020;429;28;74;29;3;26;.897;3900000;0
23020;735;5;62;21;3;18;.857;3900000;0
23020;2841;37;0;0;0;0;.00nan;0;0
23020;2886;38;0;0;0;0;.00nan;0;0
23016;0;48;0;0;0;0;.00nan;0;0
23016;710;26;41;36;6;30;.833;1258000;0
23016;1239;26;45;27;4;23;.852;2342000;0
23016;2947;29;61;31;4;27;.871;3600000;0
23015;318;22;76;34;3;31;.912;3547000;0
23015;487;27;68;29;2;27;.931;3600000;0
23015;1036;22;0;0;0;0;.00nan;0;0
23015;2557;27;0;0;0;0;.00nan;0;0
23017;727;4;82;43;4;39;.907;3632000;0
23017;1332;9;99;43;3;40;.930;3632000;0
23017;2846;41;0;0;0;0;.00nan;0;0
23017;2848;54;0;0;0;0;.00nan;0;0
23096;1163;0;0;0;0;0;.00nan;0;0
23096;2016;14;100;37;0;37;1.000;3600000;0
23096;2057;14;0;0;0;0;.00nan;0;0
23096;2804;0;39;27;5;22;.815;3600000;0
23018;318;22;0;0;0;0;.00nan;0;0
23018;734;2;0;0;0;0;.00nan;0;0
23018;1036;22;48;26;4;22;.846;3565000;0
23018;1355;2;76;32;2;30;.938;3600000;0
23039;1332;9;0;0;0;0;.00nan;0;0
23039;2174;18;0;0;0;0;.00nan;0;0
23039;2314;18;65;31;3;28;.903;3600000;0
23039;2848;54;99;42;2;40;.952;3600000;0
23037;13;7;71;22;2;20;.909;3600000;0
23037;316;7;0;0;0;0;.00nan;0;0
23037;998;8;66;28;3;25;.893;3586000;0
23037;2266;8;0;0;0;0;.00nan;0;0
23046;1021;15;0;0;0;0;.00nan;0;0
23046;2269;25;0;0;0;0;.00nan;0;0
23046;2751;50;65;31;3;28;.903;3600000;0
23046;2973;36;93;40;2;38;.950;3600000;0
23064;277;10;0;0;0;0;.00nan;0;0
23064;295;24;0;0;0;0;.00nan;0;0
23064;593;57;71;50;5;45;.900;3600000;0
23064;812;24;74;27;2;25;.926;3600000;0
23057;737;23;0;0;0;0;.00nan;0;0
23057;1406;21;0;0;0;0;.00nan;0;0
23057;1690;21;61;33;4;29;.879;3600000;0
23057;2375;23;90;30;1;29;.967;3600000;0
23021;103;30;0;0;0;0;.00nan;0;0
23021;112;13;0;0;0;0;.00nan;0;0
23021;714;13;85;41;3;38;.927;3600000;0
23021;2549;30;59;31;4;27;.871;3596000;0
23026;482;6;83;34;2;32;.941;3600000;0
23026;483;6;0;0;0;0;.00nan;0;0
23026;735;5;0;0;0;0;.00nan;0;0
23026;2841;37;69;33;3;30;.909;3543000;0
23028;783;11;77;37;3;34;.919;3600000;0
23028;1962;58;0;0;0;0;.00nan;0;0
23028;2800;1;74;50;5;45;.900;3574000;0
23028;2810;11;0;0;0;0;.00nan;0;0
23027;487;27;0;0;0;0;.00nan;0;0
23027;489;19;0;0;0;0;.00nan;0;0
23027;1056;19;90;33;2;31;.939;3600000;0
23027;2557;27;65;41;4;37;.902;3518000;0
23034;505;17;0;0;0;0;.00nan;0;0
23034;1149;12;53;38;5;33;.868;3900000;0
23034;1278;12;0;0;0;0;.00nan;0;0
23034;1333;17;65;42;5;37;.881;3899000;0
23045;711;3;85;30;2;28;.933;3900000;0
23045;727;4;75;35;2;33;.943;3900000;0
23045;1731;3;0;0;0;0;.00nan;0;0
23045;2846;41;0;0;0;0;.00nan;0;0
23073;277;10;80;24;2;22;.917;3600000;0
23073;710;26;62;34;3;31;.912;3545000;0
23073;812;24;0;0;0;0;.00nan;0;0
23073;1239;26;0;0;0;0;.00nan;0;0
23025;360;16;46;17;3;14;.824;3657000;0
23025;419;20;91;47;4;43;.915;3657000;0
23025;707;20;0;0;0;0;.00nan;0;0
23025;2687;16;0;0;0;0;.00nan;0;0
23022;0;48;36;27;5;22;.815;3600000;0
23022;783;11;0;0;0;0;.00nan;0;0
23022;2810;11;42;35;6;29;.829;3600000;0
23022;2947;29;0;0;0;0;.00nan;0;0
23092;489;19;50;28;4;24;.857;3600000;0
23092;1056;19;0;0;0;0;.00nan;0;0
23092;2016;14;84;27;1;26;.963;3600000;0
23092;2057;14;0;0;0;0;.00nan;0;0
23053;103;30;54;19;3;16;.842;3600000;0
23053;419;20;0;0;0;0;.00nan;0;0
23053;707;20;84;45;4;41;.911;3546000;0
23053;2549;30;0;0;0;0;.00nan;0;0
23178;360;16;0;0;0;0;.00nan;0;0
23178;429;28;68;32;3;29;.906;3600000;0
23178;2687;16;50;31;5;26;.839;3590000;0
23178;2886;38;0;0;0;0;.00nan;0;0
23032;505;17;53;24;3;21;.875;3570000;0
23032;735;5;99;40;1;39;.975;3600000;0
23032;1333;17;0;0;0;0;.00nan;0;0
23032;2841;37;0;0;0;0;.00nan;0;0
23036;1021;15;54;35;4;31;.886;3585000;0
23036;1332;9;96;37;2;35;.946;3600000;0
23036;2751;50;0;0;0;0;.00nan;0;0
23036;2848;54;0;0;0;0;.00nan;0;0
24273;112;13;71;26;2;24;.923;3600000;0
24273;714;13;0;0;0;0;.00nan;0;0
24273;737;23;37;21;4;17;.810;3578000;0
24273;2375;23;0;0;0;0;.00nan;0;0
23076;1163;0;64;29;3;26;.897;3600000;0
23076;1962;58;68;38;4;34;.895;3592000;0
23076;2800;1;0;0;0;0;.00nan;0;0
23076;2804;0;0;0;0;0;.00nan;0;0
23507;13;7;0;0;0;0;.00nan;0;0
23507;316;7;34;27;5;22;.815;3585000;0
23507;711;3;0;0;0;0;.00nan;0;0
23507;1731;3;69;27;3;24;.889;3600000;0
23186;710;26;81;30;2;28;.933;2529000;0
23186;734;2;71;29;2;27;.931;3600000;0
23186;1239;26;30;17;4;13;.765;1071000;0
23186;1355;2;0;0;0;0;.00nan;0;0
23068;277;10;0;0;0;0;.00nan;0;0
23068;812;24;76;35;2;33;.943;3900000;0
23068;1406;21;100;42;2;40;.952;3900000;0
23068;1690;21;0;0;0;0;.00nan;0;0
24202;489;19;0;0;0;0;.00nan;0;0
24202;735;5;0;0;0;0;.00nan;0;0
24202;1056;19;68;33;3;30;.909;3600000;0
24202;2841;37;74;48;5;43;.896;3600000;0
23083;429;28;0;0;0;0;.00nan;0;0
23083;998;8;58;40;5;35;.875;3588000;0
23083;2266;8;0;0;0;0;.00nan;0;0
23083;2886;38;54;23;3;20;.870;3600000;0
24195;318;22;63;33;3;30;.909;3600000;0
24195;734;2;0;0;0;0;.00nan;0;0
24195;1036;22;0;0;0;0;.00nan;0;0
24195;1355;2;91;37;1;36;.973;3600000;0
23110;2016;14;0;0;0;0;.00nan;0;0
23110;2057;14;62;41;5;36;.878;3600000;0
23110;2174;18;0;0;0;0;.00nan;0;0
23110;2314;18;73;27;2;25;.926;3600000;0
23023;0;48;45;31;5;26;.839;3600000;0
23023;1149;12;0;0;0;0;.00nan;0;0
23023;1278;12;77;37;4;33;.892;3600000;0
23023;2947;29;0;0;0;0;.00nan;0;0
23055;737;23;0;0;0;0;.00nan;0;0
23055;2269;25;69;32;3;29;.906;3600000;0
23055;2375;23;58;31;4;27;.871;3552000;0
23055;2973;36;0;0;0;0;.00nan;0;0
23048;103;30;61;6;0;6;1.000;826000;0
23048;112;13;0;0;0;0;.00nan;0;0
23048;714;13;62;29;3;26;.897;3600000;0
23048;2549;30;45;37;6;31;.838;2774000;0
23035;783;11;86;27;1;26;.963;3600000;0
23035;1021;15;0;0;0;0;.00nan;0;0
23035;2751;50;61;28;3;25;.893;3583000;0
23035;2810;11;0;0;0;0;.00nan;0;0
23040;13;7;77;26;3;23;.885;3900000;0
23040;316;7;0;0;0;0;.00nan;0;0
23040;727;4;64;31;3;28;.903;3900000;0
23040;2846;41;0;0;0;0;.00nan;0;0
23049;487;27;91;48;4;44;.917;3600000;0
23049;1163;0;0;0;0;0;.00nan;0;0
23049;2557;27;0;0;0;0;.00nan;0;0
23049;2804;0;45;34;5;29;.853;3600000;0
24228;482;6;0;0;0;0;.00nan;0;0
24228;483;6;84;53;4;49;.925;3900000;0
24228;505;17;0;0;0;0;.00nan;0;0
24228;1333;17;75;41;4;37;.902;3900000;0
23042;419;20;64;40;4;36;.900;3541000;0
23042;707;20;0;0;0;0;.00nan;0;0
23042;1962;58;0;0;0;0;.00nan;0;0
23042;2800;1;49;19;3;16;.842;3600000;0
23062;734;2;49;28;4;24;.857;3513000;0
23062;783;11;92;36;2;34;.944;3600000;0
23062;1355;2;0;0;0;0;.00nan;0;0
23062;2810;11;0;0;0;0;.00nan;0;0
24215;103;30;0;0;0;0;.00nan;0;0
24215;1163;0;54;32;4;28;.875;3600000;0
24215;2549;30;27;40;7;33;.825;3600000;0
24215;2804;0;0;0;0;0;.00nan;0;0
23043;295;24;42;32;6;26;.813;3600000;0
23043;360;16;85;32;2;30;.938;3600000;0
23043;593;57;0;0;0;0;.00nan;0;0
23043;2687;16;0;0;0;0;.00nan;0;0
23041;0;48;96;36;1;35;.972;3600000;0
23041;711;3;63;35;4;31;.886;3600000;0
23041;1731;3;0;0;0;0;.00nan;0;0
23041;2947;29;0;0;0;0;.00nan;0;0
24214;1962;58;77;43;3;40;.930;3900000;0
24214;2174;18;0;0;0;0;.00nan;0;0
24214;2314;18;83;41;3;38;.927;3900000;0
24214;2800;1;0;0;0;0;.00nan;0;0
23044;13;7;37;32;6;26;.813;3600000;0
23044;112;13;61;26;3;23;.885;3600000;0
23044;316;7;0;0;0;0;.00nan;0;0
23044;714;13;0;0;0;0;.00nan;0;0
23054;727;4;94;36;1;35;.972;3600000;0
23054;737;23;98;47;2;45;.957;3575000;0
23054;2375;23;0;0;0;0;.00nan;0;0
23054;2846;41;0;0;0;0;.00nan;0;0
23052;735;5;36;31;6;25;.806;1758000;0
23052;1332;9;77;38;3;35;.921;3600000;0
23052;2841;37;50;23;3;20;.870;1842000;0
23052;2848;54;0;0;0;0;.00nan;0;0
23099;277;10;80;25;1;24;.960;3600000;0
23099;489;19;89;65;6;59;.908;3491000;0
23099;812;24;0;0;0;0;.00nan;0;0
23099;1056;19;48;0;0;0;.00nan;109000;0
23281;318;22;0;0;0;0;.00nan;0;0
23281;482;6;50;34;4;30;.882;3900000;0
23281;483;6;0;0;0;0;.00nan;0;0
23281;1036;22;86;44;4;40;.909;3900000;0
23050;998;8;79;30;2;28;.933;3567000;0
23050;1021;15;90;18;0;18;1.000;3600000;0
23050;2266;8;0;0;0;0;.00nan;0;0
23050;2751;50;0;0;0;0;.00nan;0;0
23059;487;27;100;37;1;36;.973;3600000;0
23059;2269;25;58;39;5;34;.872;3600000;0
23059;2557;27;0;0;0;0;.00nan;0;0
23059;2973;36;0;0;0;0;.00nan;0;0
23093;112;13;0;0;0;0;.00nan;0;0
23093;318;22;64;31;3;28;.903;3600000;0
23093;714;13;100;38;0;38;1.000;3600000;0
23093;1036;22;0;0;0;0;.00nan;0;0
23153;482;6;0;0;0;0;.00nan;0;0
23153;483;6;96;34;1;33;.971;3600000;0
23153;711;3;0;0;0;0;.00nan;0;0
23153;1731;3;52;29;4;25;.862;3600000;0
23183;277;10;0;0;0;0;.00nan;0;0
23183;710;26;0;0;0;0;.00nan;0;0
23183;812;24;65;14;1;13;.929;3600000;0
23183;1239;26;84;39;3;36;.923;3535000;0
23084;783;11;0;0;0;0;.00nan;0;0
23084;1332;9;0;0;0;0;.00nan;0;0
23084;2810;11;91;36;1;35;.972;3600000;0
23084;2848;54;82;39;2;37;.949;3600000;0
23116;360;16;0;0;0;0;.00nan;0;0
23116;2016;14;82;42;3;39;.929;3589000;0
23116;2057;14;0;0;0;0;.00nan;0;0
23116;2687;16;80;31;2;29;.935;3600000;0
23061;737;23;0;0;0;0;.00nan;0;0
23061;2174;18;71;35;3;32;.914;3600000;0
23061;2314;18;0;0;0;0;.00nan;0;0
23061;2375;23;58;39;5;34;.872;3595000;0
23069;998;8;0;0;0;0;.00nan;0;0
23069;1149;12;86;20;0;20;1.000;3055000;0
23069;1278;12;6;7;5;2;.286;545000;0
23069;2266;8;95;38;2;36;.947;3600000;0
23030;734;2;0;0;0;0;.00nan;0;0
23030;1355;2;93;40;2;38;.950;3600000;0
23030;2269;25;0;0;0;0;.00nan;0;0
23030;2973;36;38;30;5;25;.833;3600000;0
23065;103;30;93;34;2;32;.941;3600000;0
23065;295;24;0;0;0;0;.00nan;0;0
23065;593;57;49;28;4;24;.857;3516000;0
23065;2549;30;0;0;0;0;.00nan;0;0
23033;0;48;0;0;0;0;.00nan;0;0
23033;1406;21;0;0;0;0;.00nan;0;0
23033;1690;21;48;36;5;31;.861;3587000;0
23033;2947;29;74;38;3;35;.921;3600000;0
23056;727;4;0;0;0;0;.00nan;0;0
23056;735;5;42;33;5;28;.848;3600000;0
23056;2841;37;0;0;0;0;.00nan;0;0
23056;2846;41;81;30;2;28;.933;3600000;0
23051;487;27;0;0;0;0;.00nan;0;0
23051;489;19;0;0;0;0;.00nan;0;0
23051;1056;19;76;33;3;30;.909;3600000;0
23051;2557;27;63;37;4;33;.892;3550000;0
23070;505;17;29;28;6;22;.786;3600000;0
23070;1333;17;0;0;0;0;.00nan;0;0
23070;1406;21;87;37;2;35;.946;3600000;0
23070;1690;21;0;0;0;0;.00nan;0;0
23102;13;7;0;0;0;0;.00nan;0;0
23102;316;7;63;31;3;28;.903;3582000;0
23102;1962;58;0;0;0;0;.00nan;0;0
23102;2800;1;63;22;2;20;.909;3600000;0
23127;429;28;67;25;2;23;.920;3900000;0
23127;1163;0;100;37;2;35;.946;3900000;0
23127;2804;0;0;0;0;0;.00nan;0;0
23127;2886;38;0;0;0;0;.00nan;0;0
23134;419;20;55;32;4;28;.875;3553000;0
23134;707;20;0;0;0;0;.00nan;0;0
23134;710;26;85;38;3;35;.921;3600000;0
23134;1239;26;0;0;0;0;.00nan;0;0
23154;482;6;26;30;6;24;.800;2634000;0
23154;483;6;46;9;2;7;.778;966000;0
23154;711;3;94;34;1;33;.971;3600000;0
23154;1731;3;0;0;0;0;.00nan;0;0
23148;489;19;0;0;0;0;.00nan;0;0
23148;1056;19;100;36;1;35;.972;3600000;0
23148;1149;12;73;22;1;21;.955;2951000;0
23148;1278;12;20;9;4;5;.556;649000;0
23493;318;22;0;0;0;0;.00nan;0;0
23493;1036;22;72;29;2;27;.931;3555000;0
23493;2016;14;0;0;0;0;.00nan;0;0
23493;2057;14;100;46;1;45;.978;3600000;0
24219;487;27;53;34;5;29;.853;3600000;0
24219;783;11;90;38;2;36;.947;3600000;0
24219;2557;27;0;0;0;0;.00nan;0;0
24219;2810;11;0;0;0;0;.00nan;0;0
24237;998;8;94;62;4;58;.935;3546000;0
24237;1021;15;45;10;2;8;.800;3600000;0
24237;2266;8;0;0;0;0;.00nan;0;0
24237;2751;50;0;0;0;0;.00nan;0;0
23080;295;24;63;33;5;28;.848;3600000;0
23080;505;17;0;0;0;0;.00nan;0;0
23080;593;57;0;0;0;0;.00nan;0;0
23080;1333;17;97;39;2;37;.949;3600000;0
24244;734;2;0;0;0;0;.00nan;0;0
24244;1332;9;69;33;3;30;.909;3600000;0
24244;1355;2;64;35;4;31;.886;3546000;0
24244;2848;54;0;0;0;0;.00nan;0;0
23066;360;16;70;34;3;31;.912;3567000;0
23066;727;4;85;31;2;29;.935;3600000;0
23066;2687;16;0;0;0;0;.00nan;0;0
23066;2846;41;0;0;0;0;.00nan;0;0
23087;737;23;86;39;2;37;.949;3600000;0
23087;2174;18;0;0;0;0;.00nan;0;0
23087;2314;18;50;22;3;19;.864;3529000;0
23087;2375;23;0;0;0;0;.00nan;0;0
24236;13;7;65;37;4;33;.892;3783000;0
24236;316;7;0;0;0;0;.00nan;0;0
24236;482;6;0;0;0;0;.00nan;0;0
24236;483;6;67;43;5;38;.884;3783000;0
23047;0;48;60;31;4;27;.871;3600000;0
23047;1406;21;0;0;0;0;.00nan;0;0
23047;1690;21;50;30;5;25;.833;3590000;0
23047;2947;29;0;0;0;0;.00nan;0;0
23112;487;27;68;39;4;35;.897;3600000;0
23112;2016;14;91;30;1;29;.967;3600000;0
23112;2057;14;0;0;0;0;.00nan;0;0
23112;2557;27;0;0;0;0;.00nan;0;0
23085;0;48;0;0;0;0;.00nan;0;0
23085;112;13;0;0;0;0;.00nan;0;0
23085;714;13;80;42;4;38;.905;3600000;0
23085;2947;29;78;30;2;28;.933;3600000;0
23067;13;7;0;0;0;0;.00nan;0;0
23067;316;7;55;32;4;28;.875;3590000;0
23067;2269;25;62;29;3;26;.897;3600000;0
23067;2973;36;0;0;0;0;.00nan;0;0
23432;277;10;0;0;0;0;.00nan;0;0
23432;812;24;87;25;1;24;.960;3600000;0
23432;1962;58;70;41;4;37;.902;3600000;0
23432;2800;1;0;0;0;0;.00nan;0;0
23139;1021;15;92;18;0;18;1.000;3600000;0
23139;1163;0;77;31;2;29;.935;3567000;0
23139;2751;50;0;0;0;0;.00nan;0;0
23139;2804;0;0;0;0;0;.00nan;0;0
23194;295;24;65;29;3;26;.897;3600000;0
23194;505;17;37;33;6;27;.818;2429000;0
23194;593;57;0;0;0;0;.00nan;0;0
23194;1333;17;62;13;1;12;.923;1171000;0
23071;103;30;81;40;4;36;.900;3556000;0
23071;360;16;0;0;0;0;.00nan;0;0
23071;2549;30;0;0;0;0;.00nan;0;0
23071;2687;16;66;28;2;26;.929;3600000;0
23075;419;20;0;0;0;0;.00nan;0;0
23075;707;20;59;25;3;22;.880;3600000;0
23075;727;4;0;0;0;0;.00nan;0;0
23075;2846;41;45;23;4;19;.826;3550000;0
23621;318;22;25;12;4;8;.667;834000;0
23621;783;11;96;49;4;45;.918;3600000;0
23621;1036;22;54;24;3;21;.875;2766000;0
23621;2810;11;0;0;0;0;.00nan;0;0
23177;998;8;65;42;4;38;.905;3543000;0
23177;1149;12;70;27;3;24;.889;3600000;0
23177;1278;12;0;0;0;0;.00nan;0;0
23177;2266;8;0;0;0;0;.00nan;0;0
23105;429;28;65;41;5;36;.878;3812000;0
23105;1332;9;0;0;0;0;.00nan;0;0
23105;2848;54;33;30;6;24;.800;3812000;0
23105;2886;38;0;0;0;0;.00nan;0;0
23072;711;3;92;55;2;53;.964;3600000;0
23072;735;5;46;21;4;17;.810;3600000;0
23072;1731;3;0;0;0;0;.00nan;0;0
23072;2841;37;0;0;0;0;.00nan;0;0
23270;734;2;78;36;4;32;.889;3600000;0
23270;1355;2;0;0;0;0;.00nan;0;0
23270;2174;18;47;32;5;27;.844;2998000;0
23270;2314;18;57;4;0;4;1.000;563000;0
23107;489;19;0;0;0;0;.00nan;0;0
23107;737;23;0;0;0;0;.00nan;0;0
23107;1056;19;34;26;5;21;.808;3568000;0
23107;2375;23;75;36;4;32;.889;3600000;0
23150;489;19;35;27;6;21;.778;3123000;0
23150;710;26;73;39;4;35;.897;3600000;0
23150;1056;19;48;0;0;0;.00nan;419000;0
23150;1239;26;0;0;0;0;.00nan;0;0
23077;103;30;0;0;0;0;.00nan;0;0
23077;112;13;57;29;4;25;.862;3541000;0
23077;714;13;0;0;0;0;.00nan;0;0
23077;2549;30;67;26;2;24;.923;3600000;0
23140;318;22;0;0;0;0;.00nan;0;0
23140;1036;22;80;31;1;30;.968;3900000;0
23140;1163;0;0;0;0;0;.00nan;0;0
23140;2804;0;100;37;1;36;.973;3900000;0
23063;487;27;84;29;2;27;.931;3600000;0
23063;1021;15;59;24;3;21;.875;3544000;0
23063;1128;15;0;0;0;0;.00nan;0;0
23063;2557;27;0;0;0;0;.00nan;0;0
23111;268;1;0;0;0;0;.00nan;0;0
23111;360;16;27;7;3;4;.571;468000;0
23111;2687;16;91;23;0;23;1.000;3132000;0
23111;2800;1;58;29;4;25;.862;3600000;0
23114;13;7;0;0;0;0;.00nan;0;0
23114;316;7;86;31;2;29;.935;3600000;0
23114;1149;12;26;26;6;20;.769;3267000;0
23114;1278;12;48;0;0;0;.00nan;333000;0
23211;295;24;0;0;0;0;.00nan;0;0
23211;419;20;0;0;0;0;.00nan;0;0
23211;593;57;56;30;4;26;.867;3566000;0
23211;707;20;62;23;3;20;.870;3600000;0
23142;505;17;32;17;4;13;.765;1050000;0
23142;1333;17;64;11;0;11;1.000;2550000;0
23142;2016;14;100;43;1;42;.977;3600000;0
23142;2057;14;0;0;0;0;.00nan;0;0
23081;710;26;0;0;0;0;.00nan;0;0
23081;1239;26;81;42;3;39;.929;3600000;0
23081;1406;21;76;32;2;30;.938;3600000;0
23081;1690;21;0;0;0;0;.00nan;0;0
23088;0;48;90;26;1;25;.962;3600000;0
23088;1052;9;0;0;0;0;.00nan;0;0
23088;1332;9;83;46;3;43;.935;3576000;0
23088;2947;29;0;0;0;0;.00nan;0;0
23257;277;10;0;0;0;0;.00nan;0;0
23257;783;11;92;50;1;49;.980;3566000;0
23257;812;24;90;19;0;19;1.000;3600000;0
23257;2810;11;0;0;0;0;.00nan;0;0
23158;711;3;100;48;3;45;.938;3600000;0
23158;734;2;88;51;4;47;.922;3600000;0
23158;1355;2;0;0;0;0;.00nan;0;0
23158;1731;3;0;0;0;0;.00nan;0;0
23058;429;28;93;35;2;33;.943;3600000;0
23058;735;5;75;35;3;32;.914;3600000;0
23058;1061;28;0;0;0;0;.00nan;0;0
23058;1361;5;0;0;0;0;.00nan;0;0
23078;727;4;69;19;2;17;.895;3600000;0
23078;737;23;78;44;4;40;.909;3564000;0
23078;1335;4;0;0;0;0;.00nan;0;0
23078;2375;23;0;0;0;0;.00nan;0;0
23143;734;2;0;0;0;0;.00nan;0;0
23143;1021;15;0;0;0;0;.00nan;0;0
23143;1128;15;76;33;3;30;.909;3600000;0
23143;1355;2;79;31;2;29;.935;3600000;0
23145;268;1;95;40;2;38;.950;3600000;0
23145;489;19;0;0;0;0;.00nan;0;0
23145;1056;19;49;31;5;26;.839;3600000;0
23145;2800;1;0;0;0;0;.00nan;0;0
23060;735;5;0;0;0;0;.00nan;0;0
23060;1361;5;58;23;3;20;.870;3600000;0
23060;2174;18;53;3;0;3;1.000;389000;0
23060;2314;18;39;37;7;30;.811;3211000;0
23100;103;30;89;31;1;30;.968;3600000;0
23100;1221;25;62;28;3;25;.893;3548000;0
23100;2269;25;0;0;0;0;.00nan;0;0
23100;2549;30;0;0;0;0;.00nan;0;0
23074;429;28;0;0;0;0;.00nan;0;0
23074;1061;28;100;25;0;25;1.000;3600000;0
23074;1406;21;65;17;1;16;.941;1578000;0
23074;1690;21;29;36;7;29;.806;2022000;0
23182;783;11;0;0;0;0;.00nan;0;0
23182;1163;0;61;33;3;30;.909;3600000;0
23182;2804;0;0;0;0;0;.00nan;0;0
23182;2810;11;100;23;0;23;1.000;3600000;0
23169;295;24;40;23;4;19;.826;3562000;0
23169;419;20;100;58;2;56;.966;3600000;0
23169;593;57;0;0;0;0;.00nan;0;0
23169;707;20;0;0;0;0;.00nan;0;0
23086;112;13;0;0;0;0;.00nan;0;0
23086;505;17;90;37;2;35;.946;3583000;0
23086;714;13;88;30;1;29;.967;3600000;0
23086;1333;17;0;0;0;0;.00nan;0;0
23209;277;10;0;0;0;0;.00nan;0;0
23209;711;3;0;0;0;0;.00nan;0;0
23209;812;24;60;26;3;23;.885;3563000;0
23209;1731;3;96;42;2;40;.952;3600000;0
23113;1052;9;0;0;0;0;.00nan;0;0
23113;1332;9;89;47;3;44;.936;3600000;0
23113;2016;14;58;35;5;30;.857;3596000;0
23113;2057;14;0;0;0;0;.00nan;0;0
23091;13;7;67;28;2;26;.929;3600000;0
23091;316;7;0;0;0;0;.00nan;0;0
23091;998;8;28;33;7;26;.788;3600000;0
23091;2266;8;0;0;0;0;.00nan;0;0
23988;318;22;0;0;0;0;.00nan;0;0
23988;489;19;50;39;6;33;.846;3900000;0
23988;1036;22;52;40;6;34;.850;3900000;0
23988;1056;19;0;0;0;0;.00nan;0;0
23122;1149;12;0;0;0;0;.00nan;0;0
23122;1221;25;65;12;0;12;1.000;796000;0
23122;1278;12;68;30;3;27;.900;3600000;0
23122;2269;25;38;31;6;25;.806;2804000;0
23124;482;6;74;26;2;24;.923;3600000;0
23124;483;6;0;0;0;0;.00nan;0;0
23124;487;27;66;41;5;36;.878;3600000;0
23124;2557;27;0;0;0;0;.00nan;0;0
24280;112;13;65;36;4;32;.889;3576000;0
24280;360;16;65;25;3;22;.880;3600000;0
24280;714;13;0;0;0;0;.00nan;0;0
24280;2687;16;0;0;0;0;.00nan;0;0
24247;419;20;60;36;4;32;.889;3600000;0
24247;707;20;0;0;0;0;.00nan;0;0
24247;2174;18;0;0;0;0;.00nan;0;0
24247;2314;18;59;25;3;22;.880;3600000;0
24181;0;48;46;26;4;22;.846;3600000;0
24181;711;3;71;31;3;28;.903;3600000;0
24181;1731;3;0;0;0;0;.00nan;0;0
24181;2947;29;0;0;0;0;.00nan;0;0
24065;268;1;0;0;0;0;.00nan;0;0
24065;482;6;0;0;0;0;.00nan;0;0
24065;483;6;57;26;3;23;.885;3600000;0
24065;2800;1;82;43;5;38;.884;3565000;0
23205;710;26;81;29;2;27;.931;3600000;0
23205;998;8;0;0;0;0;.00nan;0;0
23205;1239;26;0;0;0;0;.00nan;0;0
23205;2266;8;98;52;4;48;.923;3588000;0
23131;360;16;39;19;4;15;.789;1586000;0
23131;727;4;66;27;3;24;.889;3600000;0
23131;1335;4;0;0;0;0;.00nan;0;0
23131;2687;16;46;34;6;28;.824;2014000;0
23129;1021;15;59;18;2;16;.889;3600000;0
23129;1128;15;0;0;0;0;.00nan;0;0
23129;1221;25;53;44;6;38;.864;3393000;0
23129;2269;25;52;4;0;4;1.000;207000;0
23173;268;1;80;34;3;31;.912;3544000;0
23173;1163;0;86;33;2;31;.939;3600000;0
23173;2800;1;0;0;0;0;.00nan;0;0
23173;2804;0;0;0;0;0;.00nan;0;0
23094;103;30;100;39;1;38;.974;3600000;0
23094;505;17;0;0;0;0;.00nan;0;0
23094;1333;17;30;35;7;28;.800;3600000;0
23094;2549;30;0;0;0;0;.00nan;0;0
23163;295;24;85;33;2;31;.939;3600000;0
23163;593;57;0;0;0;0;.00nan;0;0
23163;1052;9;76;36;3;33;.917;3548000;0
23163;1332;9;0;0;0;0;.00nan;0;0
23089;318;22;80;16;0;16;1.000;2682000;0
23089;735;5;95;34;1;33;.971;3600000;0
23089;1036;22;43;24;4;20;.833;918000;0
23089;1361;5;0;0;0;0;.00nan;0;0
23104;112;13;43;32;5;27;.844;3600000;0
23104;487;27;62;25;2;23;.920;3600000;0
23104;714;13;0;0;0;0;.00nan;0;0
23104;2557;27;0;0;0;0;.00nan;0;0
23180;734;2;47;26;4;22;.846;3600000;0
23180;737;23;89;30;1;29;.967;3600000;0
23180;1355;2;0;0;0;0;.00nan;0;0
23180;2375;23;0;0;0;0;.00nan;0;0
23125;103;30;0;0;0;0;.00nan;0;0
23125;112;13;0;0;0;0;.00nan;0;0
23125;714;13;70;40;4;36;.900;3545000;0
23125;2549;30;57;26;3;23;.885;3600000;0
23108;318;22;57;43;6;37;.860;3600000;0
23108;727;4;0;0;0;0;.00nan;0;0
23108;1036;22;0;0;0;0;.00nan;0;0
23108;1335;4;87;32;1;31;.969;3600000;0
23633;429;28;0;0;0;0;.00nan;0;0
23633;489;19;0;0;0;0;.00nan;0;0
23633;1056;19;60;28;3;25;.893;3600000;0
23633;1061;28;70;40;4;36;.900;3564000;0
23126;360;16;76;33;3;30;.909;3617000;0
23126;735;5;0;0;0;0;.00nan;0;0
23126;1361;5;47;28;4;24;.857;3617000;0
23126;2687;16;0;0;0;0;.00nan;0;0
23200;711;3;85;37;2;35;.946;3600000;0
23200;1731;3;0;0;0;0;.00nan;0;0
23200;2016;14;0;0;0;0;.00nan;0;0
23200;2057;14;75;38;3;35;.921;3550000;0
23106;419;20;40;33;6;27;.818;3600000;0
23106;505;17;85;34;3;31;.912;3600000;0
23106;707;20;0;0;0;0;.00nan;0;0
23106;1333;17;0;0;0;0;.00nan;0;0
23130;482;6;0;0;0;0;.00nan;0;0
23130;483;6;74;30;2;28;.933;3900000;0
23130;1221;25;0;0;0;0;.00nan;0;0
23130;2269;25;63;28;2;26;.929;3900000;0
23141;1021;15;0;0;0;0;.00nan;0;0
23141;1052;9;0;0;0;0;.00nan;0;0
23141;1128;15;51;20;3;17;.850;3600000;0
23141;1332;9;100;34;0;34;1.000;3600000;0
23254;710;26;0;0;0;0;.00nan;0;0
23254;783;11;0;0;0;0;.00nan;0;0
23254;1239;26;78;37;4;33;.892;3546000;0
23254;2810;11;84;34;2;32;.941;3600000;0
23109;13;7;72;32;3;29;.906;3900000;0
23109;316;7;0;0;0;0;.00nan;0;0
23109;1406;21;59;25;3;22;.880;3900000;0
23109;1690;21;0;0;0;0;.00nan;0;0
23123;295;24;0;0;0;0;.00nan;0;0
23123;593;57;76;42;4;38;.905;3900000;0
23123;1149;12;0;0;0;0;.00nan;0;0
23123;1278;12;51;25;4;21;.840;3900000;0
23117;13;7;0;0;0;0;.00nan;0;0
23117;316;7;68;39;4;35;.897;3600000;0
23117;1163;0;25;24;6;18;.750;2798000;0
23117;2804;0;50;2;0;2;1.000;750000;0
23295;710;26;70;44;4;40;.909;3583000;0
23295;734;2;0;0;0;0;.00nan;0;0
23295;1239;26;0;0;0;0;.00nan;0;0
23295;1355;2;70;35;3;32;.914;3600000;0
23090;0;48;78;41;3;38;.927;3600000;0
23090;277;10;0;0;0;0;.00nan;0;0
23090;812;24;100;28;0;28;1.000;3600000;0
23090;2947;29;0;0;0;0;.00nan;0;0
23128;487;27;0;0;0;0;.00nan;0;0
23128;1149;12;54;32;4;28;.875;3553000;0
23128;1278;12;0;0;0;0;.00nan;0;0
23128;2557;27;80;34;2;32;.941;3600000;0
23097;112;13;98;45;4;41;.911;3900000;0
23097;277;10;0;0;0;0;.00nan;0;0
23097;714;13;0;0;0;0;.00nan;0;0
23097;812;24;38;20;4;16;.800;3900000;0
23121;103;30;63;21;2;19;.905;3600000;0
23121;487;27;48;37;6;31;.838;2117000;0
23121;2549;30;0;0;0;0;.00nan;0;0
23121;2557;27;65;28;3;25;.893;1483000;0
23098;1406;21;75;25;2;23;.920;3600000;0
23098;1690;21;0;0;0;0;.00nan;0;0
23098;2174;18;0;0;0;0;.00nan;0;0
23098;2314;18;44;20;3;17;.850;3588000;0
23147;419;20;52;37;5;32;.865;3600000;0
23147;707;20;0;0;0;0;.00nan;0;0
23147;737;23;86;22;1;21;.955;3600000;0
23147;2375;23;0;0;0;0;.00nan;0;0
23290;482;6;83;38;2;36;.947;3600000;0
23290;483;6;0;0;0;0;.00nan;0;0
23290;489;19;0;0;0;0;.00nan;0;0
23290;1056;19;62;32;4;28;.875;3593000;0
23146;727;4;77;33;3;30;.909;3600000;0
23146;998;8;100;36;0;36;1.000;3600000;0
23146;1335;4;0;0;0;0;.00nan;0;0
23146;2266;8;0;0;0;0;.00nan;0;0
23206;295;24;94;29;1;28;.966;3600000;0
23206;593;57;0;0;0;0;.00nan;0;0
23206;2016;14;54;39;4;35;.897;3600000;0
23206;2057;14;0;0;0;0;.00nan;0;0
23202;318;22;0;0;0;0;.00nan;0;0
23202;1036;22;100;24;0;24;1.000;3600000;0
23202;1163;0;0;0;0;0;.00nan;0;0
23202;2804;0;84;40;3;37;.925;3600000;0
23149;783;11;85;53;5;48;.906;3844000;0
23149;1052;9;0;0;0;0;.00nan;0;0
23149;1332;9;67;39;4;35;.897;3844000;0
23149;2810;11;0;0;0;0;.00nan;0;0
23151;419;20;0;0;0;0;.00nan;0;0
23151;707;20;81;42;3;39;.929;3900000;0
23151;737;23;0;0;0;0;.00nan;0;0
23151;2375;23;66;35;3;32;.914;3900000;0
23174;1021;15;46;28;4;24;.857;3543000;0
23174;1128;15;0;0;0;0;.00nan;0;0
23174;2174;18;58;22;3;19;.864;3600000;0
23174;2314;18;0;0;0;0;.00nan;0;0
23133;360;16;0;0;0;0;.00nan;0;0
23133;1221;25;74;30;3;27;.900;3600000;0
23133;2269;25;0;0;0;0;.00nan;0;0
23133;2687;16;56;32;4;28;.875;3596000;0
23835;489;19;73;41;4;37;.902;3600000;0
23835;711;3;74;34;3;31;.912;3600000;0
23835;1056;19;0;0;0;0;.00nan;0;0
23835;1731;3;0;0;0;0;.00nan;0;0
24263;318;22;0;0;0;0;.00nan;0;0
24263;710;26;60;20;2;18;.900;1254000;0
24263;1036;22;56;24;3;21;.875;3600000;0
24263;1239;26;32;31;6;25;.806;2346000;0
23161;429;28;23;10;4;6;.600;1116000;0
23161;1061;28;22;22;5;17;.773;2484000;0
23161;1149;12;0;0;0;0;.00nan;0;0
23161;1278;12;100;26;0;26;1.000;3600000;0
24234;13;7;0;0;0;0;.00nan;0;0
24234;103;30;0;0;0;0;.00nan;0;0
24234;316;7;64;30;4;26;.867;3600000;0
24234;2549;30;76;32;3;29;.906;3600000;0
23949;112;13;0;0;0;0;.00nan;0;0
23949;714;13;60;34;4;30;.882;3600000;0
23949;1052;9;46;35;6;29;.829;3584000;0
23949;1332;9;0;0;0;0;.00nan;0;0
23779;295;24;0;0;0;0;.00nan;0;0
23779;593;57;80;28;3;25;.893;3600000;0
23779;734;2;77;50;5;45;.900;3600000;0
23779;1355;2;0;0;0;0;.00nan;0;0
23266;482;6;0;0;0;0;.00nan;0;0
23266;483;6;99;54;2;52;.963;3600000;0
23266;783;11;0;0;0;0;.00nan;0;0
23266;2810;11;87;39;3;36;.923;3542000;0
23451;735;5;83;30;2;28;.933;3600000;0
23451;1021;15;51;10;1;9;.900;1240000;0
23451;1128;15;55;28;4;24;.857;2360000;0
23451;1361;5;0;0;0;0;.00nan;0;0
23233;998;8;86;42;3;39;.929;3579000;0
23233;2016;14;0;0;0;0;.00nan;0;0
23233;2057;14;95;32;1;31;.969;3600000;0
23233;2266;8;0;0;0;0;.00nan;0;0
24256;727;4;77;30;2;28;.933;3600000;0
24256;1149;12;53;2;0;2;1.000;464000;0
24256;1278;12;47;42;7;35;.833;3136000;0
24256;1335;4;0;0;0;0;.00nan;0;0
23120;505;17;48;34;5;29;.853;3542000;0
23120;1333;17;0;0;0;0;.00nan;0;0
23120;1406;21;61;33;4;29;.879;3600000;0
23120;1690;21;0;0;0;0;.00nan;0;0
23467;268;1;0;0;0;0;.00nan;0;0
23467;734;2;0;0;0;0;.00nan;0;0
23467;1355;2;82;26;1;25;.962;3600000;0
23467;2800;1;71;49;5;44;.898;3600000;0
23115;0;48;0;0;0;0;.00nan;0;0
23115;13;7;26;12;4;8;.667;875000;0
23115;316;7;53;23;3;20;.870;2725000;0
23115;2947;29;46;26;4;22;.846;3600000;0
23297;429;28;0;0;0;0;.00nan;0;0
23297;1061;28;82;32;1;31;.969;3600000;0
23297;2174;18;0;0;0;0;.00nan;0;0
23297;2314;18;49;30;4;26;.867;3600000;0
24211;487;27;66;50;6;44;.880;2825000;0
24211;505;17;0;0;0;0;.00nan;0;0
24211;1333;17;45;28;5;23;.821;3600000;0
24211;2557;27;43;4;1;3;.750;755000;0
23237;711;3;68;38;4;34;.895;3872000;0
23237;998;8;0;0;0;0;.00nan;0;0
23237;1731;3;0;0;0;0;.00nan;0;0
23237;2266;8;76;44;3;41;.932;3883000;0
23251;268;1;84;32;2;30;.938;3600000;0
23251;710;26;53;31;4;27;.871;3577000;0
23251;1239;26;0;0;0;0;.00nan;0;0
23251;2800;1;0;0;0;0;.00nan;0;0
23101;0;48;81;40;3;37;.925;3519000;0
23101;277;10;0;0;0;0;.00nan;0;0
23101;812;24;84;25;1;24;.960;3600000;0
23101;2947;29;0;0;0;0;.00nan;0;0
24271;419;20;91;25;0;25;1.000;3600000;0
24271;707;20;0;0;0;0;.00nan;0;0
24271;1406;21;0;0;0;0;.00nan;0;0
24271;1690;21;71;32;3;29;.906;3600000;0
23325;734;2;83;34;2;32;.941;3564000;0
23325;1355;2;0;0;0;0;.00nan;0;0
23325;2174;18;72;22;1;21;.955;3600000;0
23325;2314;18;0;0;0;0;.00nan;0;0
23322;711;3;0;0;0;0;.00nan;0;0
23322;783;11;80;43;5;38;.884;3900000;0
23322;1731;3;32;20;5;15;.750;3900000;0
23322;2810;11;0;0;0;0;.00nan;0;0
23138;103;30;95;45;2;43;.956;3900000;0
23138;737;23;92;40;2;38;.950;3900000;0
23138;2375;23;0;0;0;0;.00nan;0;0
23138;2549;30;0;0;0;0;.00nan;0;0
23198;360;16;100;28;0;28;1.000;3600000;0
23198;2016;14;72;60;7;53;.883;3534000;0
23198;2057;14;49;1;0;1;1.000;66000;0
23198;2687;16;0;0;0;0;.00nan;0;0
23275;295;24;61;36;5;31;.861;3600000;0
23275;482;6;64;24;2;22;.917;3600000;0
23275;483;6;0;0;0;0;.00nan;0;0
23275;593;57;0;0;0;0;.00nan;0;0
23162;429;28;94;38;1;37;.974;3600000;0
23162;1061;28;0;0;0;0;.00nan;0;0
23162;1221;25;80;40;3;37;.925;3533000;0
23162;2269;25;0;0;0;0;.00nan;0;0
23119;277;10;77;26;1;25;.962;3600000;0
23119;727;4;64;40;5;35;.875;3600000;0
23119;812;24;0;0;0;0;.00nan;0;0
23119;1335;4;0;0;0;0;.00nan;0;0
23192;419;20;94;54;3;51;.944;3673000;0
23192;707;20;0;0;0;0;.00nan;0;0
23192;735;5;83;36;2;34;.944;3673000;0
23192;1361;5;0;0;0;0;.00nan;0;0
23152;112;13;96;42;2;40;.952;3556000;0
23152;318;22;0;0;0;0;.00nan;0;0
23152;714;13;0;0;0;0;.00nan;0;0
23152;1036;22;76;25;1;24;.960;3600000;0
23321;734;2;0;0;0;0;.00nan;0;0
23321;998;8;78;38;3;35;.921;3600000;0
23321;1355;2;72;39;4;35;.897;3548000;0
23321;2266;8;0;0;0;0;.00nan;0;0
24272;268;1;0;0;0;0;.00nan;0;0
24272;783;11;50;0;0;0;.00nan;11000;0
24272;2800;1;100;26;0;26;1.000;3600000;0
24272;2810;11;51;38;6;32;.842;3589000;0
24258;489;19;0;0;0;0;.00nan;0;0
24258;735;5;0;0;0;0;.00nan;0;0
24258;1056;19;89;29;1;28;.966;3600000;0
24258;1361;5;85;33;2;31;.939;3558000;0
23159;487;27;74;23;1;22;.957;3600000;0
23159;710;26;98;53;3;50;.943;3543000;0
23159;1239;26;0;0;0;0;.00nan;0;0
23159;2557;27;0;0;0;0;.00nan;0;0
23137;103;30;0;0;0;0;.00nan;0;0
23137;505;17;74;37;3;34;.919;3536000;0
23137;1333;17;0;0;0;0;.00nan;0;0
23137;2549;30;67;26;2;24;.923;3600000;0
23135;1052;9;0;0;0;0;.00nan;0;0
23135;1221;25;0;0;0;0;.00nan;0;0
23135;1332;9;73;28;2;26;.929;3900000;0
23135;2269;25;98;37;2;35;.946;3900000;0
23144;13;7;0;0;0;0;.00nan;0;0
23144;316;7;54;33;5;28;.848;3600000;0
23144;1163;0;100;30;0;30;1.000;3600000;0
23144;2804;0;0;0;0;0;.00nan;0;0
23302;318;22;0;0;0;0;.00nan;0;0
23302;1021;15;26;31;6;25;.806;3600000;0
23302;1036;22;89;41;3;38;.927;3600000;0
23302;1128;15;0;0;0;0;.00nan;0;0
23176;727;4;0;0;0;0;.00nan;0;0
23176;1335;4;76;30;2;28;.933;3600000;0
23176;1406;21;58;47;6;41;.872;3524000;0
23176;1690;21;50;1;0;1;1.000;76000;0
23213;295;24;0;0;0;0;.00nan;0;0
23213;593;57;72;38;3;35;.921;3537000;0
23213;1149;12;0;0;0;0;.00nan;0;0
23213;1278;12;79;24;1;23;.958;3600000;0
23201;0;48;90;33;1;32;.970;3600000;0
23201;482;6;0;0;0;0;.00nan;0;0
23201;483;6;91;44;3;41;.932;3594000;0
23201;2947;29;0;0;0;0;.00nan;0;0
23165;487;27;0;0;0;0;.00nan;0;0
23165;737;23;75;31;3;28;.903;3879000;0
23165;2375;23;0;0;0;0;.00nan;0;0
23165;2557;27;62;33;4;29;.879;3879000;0
23136;429;28;62;26;3;23;.885;3784000;0
23136;505;17;0;0;0;0;.00nan;0;0
23136;1061;28;0;0;0;0;.00nan;0;0
23136;1333;17;59;34;4;30;.882;3784000;0
24185;277;10;0;0;0;0;.00nan;0;0
24185;711;3;84;29;1;28;.966;3600000;0
24185;812;24;84;26;2;24;.923;3558000;0
24185;1731;3;0;0;0;0;.00nan;0;0
23160;112;13;0;0;0;0;.00nan;0;0
23160;714;13;82;25;1;24;.960;3562000;0
23160;1163;0;99;28;0;28;1.000;3600000;0
23160;2804;0;0;0;0;0;.00nan;0;0
23157;277;10;44;27;5;22;.815;3762000;0
23157;360;16;62;33;4;29;.879;3198000;0
23157;691;10;0;0;0;0;.00nan;0;0
23157;2687;16;59;5;0;5;1.000;564000;0
23242;295;24;75;22;1;21;.955;3600000;0
23242;489;19;95;38;2;36;.947;3557000;0
23242;812;24;0;0;0;0;.00nan;0;0
23242;1056;19;0;0;0;0;.00nan;0;0
23168;735;5;100;43;0;43;1.000;3600000;0
23168;1052;9;97;45;1;44;.978;3543000;0
23168;1332;9;0;0;0;0;.00nan;0;0
23168;1361;5;0;0;0;0;.00nan;0;0
23191;1406;21;69;29;3;26;.897;3600000;0
23191;1690;21;0;0;0;0;.00nan;0;0
23191;2016;14;0;0;0;0;.00nan;0;0
23191;2057;14;56;41;5;36;.878;3514000;0
24233;318;22;0;0;0;0;.00nan;0;0
24233;429;28;0;0;0;0;.00nan;0;0
24233;1036;22;81;32;2;30;.938;3600000;0
24233;1061;28;64;40;4;36;.900;3564000;0
23228;783;11;0;0;0;0;.00nan;0;0
23228;1149;12;0;0;0;0;.00nan;0;0
23228;1278;12;87;31;1;30;.968;3600000;0
23228;2810;11;72;33;3;30;.909;3537000;0
23218;482;6;98;48;3;45;.938;3584000;0
23218;483;6;0;0;0;0;.00nan;0;0
23218;1021;15;70;21;2;19;.905;3600000;0
23218;1128;15;0;0;0;0;.00nan;0;0
23155;0;48;99;31;1;30;.968;3600000;0
23155;2174;18;87;36;3;33;.917;3564000;0
23155;2314;18;0;0;0;0;.00nan;0;0
23155;2947;29;0;0;0;0;.00nan;0;0
23118;13;7;58;30;4;26;.867;3600000;0
23118;268;1;0;0;0;0;.00nan;0;0
23118;316;7;0;0;0;0;.00nan;0;0
23118;2800;1;96;23;0;23;1.000;3600000;0
23223;419;20;0;0;0;0;.00nan;0;0
23223;707;20;90;30;1;29;.967;3600000;0
23223;710;26;0;0;0;0;.00nan;0;0
23223;1239;26;75;36;3;33;.917;3521000;0
24227;295;24;0;0;0;0;.00nan;0;0
24227;812;24;84;47;5;42;.894;3600000;0
24227;1163;0;46;38;6;32;.842;3556000;0
24227;2804;0;0;0;0;0;.00nan;0;0
24217;112;13;65;35;4;31;.886;3600000;0
24217;505;17;31;26;6;20;.769;3516000;0
24217;714;13;0;0;0;0;.00nan;0;0
24217;1333;17;0;0;0;0;.00nan;0;0
23170;487;27;100;33;0;33;1.000;3600000;0
23170;1221;25;62;32;4;28;.875;3600000;0
23170;2269;25;0;0;0;0;.00nan;0;0
23170;2557;27;0;0;0;0;.00nan;0;0
23629;711;3;62;32;4;28;.875;3573000;0
23629;998;8;93;41;2;39;.951;3600000;0
23629;1731;3;0;0;0;0;.00nan;0;0
23629;2266;8;0;0;0;0;.00nan;0;0
23156;13;7;0;0;0;0;.00nan;0;0
23156;316;7;50;18;3;15;.833;3600000;0
23156;419;20;84;61;6;55;.902;3600000;0
23156;707;20;0;0;0;0;.00nan;0;0
23336;318;22;0;0;0;0;.00nan;0;0
23336;1036;22;50;26;4;22;.846;3522000;0
23336;2174;18;0;0;0;0;.00nan;0;0
23336;2314;18;65;26;2;24;.923;3600000;0
23172;268;1;50;7;1;6;.857;795000;0
23172;1052;9;0;0;0;0;.00nan;0;0
23172;1332;9;57;29;3;26;.897;3600000;0
23172;2800;1;45;44;7;37;.841;2805000;0
23164;360;16;0;0;0;0;.00nan;0;0
23164;737;23;78;29;2;27;.931;3576000;0
23164;2375;23;0;0;0;0;.00nan;0;0
23164;2687;16;76;24;1;23;.958;3600000;0
23179;505;17;0;0;0;0;.00nan;0;0
23179;783;11;71;42;5;37;.881;3600000;0
23179;1333;17;87;24;1;23;.958;3600000;0
23179;2810;11;0;0;0;0;.00nan;0;0
23221;1021;15;59;32;5;27;.844;3600000;0
23221;1128;15;0;0;0;0;.00nan;0;0
23221;1163;0;0;0;0;0;.00nan;0;0
23221;2804;0;96;39;2;37;.949;3600000;0
23190;727;4;94;45;2;43;.956;3600000;0
23190;734;2;0;0;0;0;.00nan;0;0
23190;1335;4;0;0;0;0;.00nan;0;0
23190;1355;2;92;41;3;38;.927;3587000;0
23843;711;3;89;42;3;39;.929;3594000;0
23843;735;5;77;31;2;29;.935;3600000;0
23843;1361;5;0;0;0;0;.00nan;0;0
23843;1731;3;0;0;0;0;.00nan;0;0
23167;0;48;0;0;0;0;.00nan;0;0
23167;112;13;0;0;0;0;.00nan;0;0
23167;714;13;63;31;4;27;.871;3600000;0
23167;2947;29;74;24;2;22;.917;3600000;0
23247;277;10;0;0;0;0;.00nan;0;0
23247;691;10;76;20;1;19;.950;3786000;0
23247;1149;12;0;0;0;0;.00nan;0;0
23247;1278;12;84;32;2;30;.938;3787000;0
23249;710;26;77;28;2;26;.929;3551000;0
23249;1239;26;0;0;0;0;.00nan;0;0
23249;2016;14;99;40;1;39;.975;3600000;0
23249;2057;14;0;0;0;0;.00nan;0;0
23210;489;19;76;26;1;25;.962;3600000;0
23210;1056;19;0;0;0;0;.00nan;0;0
23210;1406;21;92;39;2;37;.949;3600000;0
23210;1690;21;0;0;0;0;.00nan;0;0
23396;268;1;0;0;0;0;.00nan;0;0
23396;998;8;64;32;3;29;.906;3591000;0
23396;2266;8;0;0;0;0;.00nan;0;0
23396;2800;1;82;37;2;35;.946;3600000;0
23132;103;30;68;30;3;27;.900;3600000;0
23132;429;28;0;0;0;0;.00nan;0;0
23132;1061;28;95;20;0;20;1.000;3600000;0
23132;2549;30;0;0;0;0;.00nan;0;0
24269;360;16;71;37;3;34;.919;3600000;0
24269;1052;9;62;21;2;19;.905;3600000;0
24269;1332;9;0;0;0;0;.00nan;0;0
24269;2687;16;0;0;0;0;.00nan;0;0
23296;489;19;0;0;0;0;.00nan;0;0
23296;1056;19;52;39;5;34;.872;3551000;0
23296;1406;21;69;31;4;27;.871;3600000;0
23296;1690;21;0;0;0;0;.00nan;0;0
23265;13;7;87;37;2;35;.946;3900000;0
23265;316;7;0;0;0;0;.00nan;0;0
23265;2174;18;0;0;0;0;.00nan;0;0
23265;2314;18;76;34;2;32;.941;3900000;0
23181;112;13;57;24;3;21;.875;3547000;0
23181;505;17;91;36;2;34;.944;3600000;0
23181;714;13;0;0;0;0;.00nan;0;0
23181;1333;17;0;0;0;0;.00nan;0;0
23261;710;26;0;0;0;0;.00nan;0;0
23261;1149;12;0;0;0;0;.00nan;0;0
23261;1239;26;98;54;3;51;.944;3559000;0
23261;1278;12;59;18;2;16;.889;3600000;0
23510;711;3;38;29;6;23;.793;2884000;0
23510;734;2;0;0;0;0;.00nan;0;0
23510;1355;2;57;30;4;26;.867;3600000;0
23510;1731;3;69;11;0;11;1.000;693000;0
23236;783;11;85;35;2;33;.943;3600000;0
23236;1163;0;97;45;3;42;.933;3551000;0
23236;2804;0;0;0;0;0;.00nan;0;0
23236;2810;11;0;0;0;0;.00nan;0;0
23216;295;24;78;48;4;44;.917;3600000;0
23216;360;16;0;0;0;0;.00nan;0;0
23216;812;24;0;0;0;0;.00nan;0;0
23216;2687;16;33;38;7;31;.816;3600000;0
23214;0;48;82;20;1;19;.950;3600000;0
23214;487;27;64;27;3;24;.889;3576000;0
23214;2557;27;0;0;0;0;.00nan;0;0
23214;2947;29;0;0;0;0;.00nan;0;0
23204;727;4;79;25;1;24;.960;3600000;0
23204;735;5;88;45;3;42;.933;3546000;0
23204;1335;4;0;0;0;0;.00nan;0;0
23204;1361;5;0;0;0;0;.00nan;0;0
23224;268;1;0;0;0;0;.00nan;0;0
23224;727;4;0;0;0;0;.00nan;0;0
23224;1335;4;62;27;3;24;.889;3570000;0
23224;2800;1;81;34;2;32;.941;3600000;0
23171;112;13;0;0;0;0;.00nan;0;0
23171;714;13;89;42;3;39;.929;3600000;0
23171;998;8;52;16;2;14;.875;3600000;0
23171;2266;8;0;0;0;0;.00nan;0;0
24274;277;10;0;0;0;0;.00nan;0;0
24274;691;10;57;19;2;17;.895;3600000;0
24274;711;3;54;3;0;3;1.000;234000;0
24274;1731;3;61;49;6;43;.878;3366000;0
23229;13;7;0;0;0;0;.00nan;0;0
23229;316;7;75;44;4;40;.909;3539000;0
23229;489;19;84;33;2;31;.939;3600000;0
23229;1056;19;0;0;0;0;.00nan;0;0
23327;783;11;0;0;0;0;.00nan;0;0
23327;1021;15;65;29;3;26;.897;3900000;0
23327;1128;15;0;0;0;0;.00nan;0;0
23327;2810;11;96;47;3;44;.936;3900000;0
23208;318;22;0;0;0;0;.00nan;0;0
23208;1036;22;94;47;3;44;.936;3600000;0
23208;1221;25;55;1;0;1;1.000;274000;0
23208;2269;25;38;35;6;29;.829;3326000;0
23255;710;26;51;31;4;27;.871;3600000;0
23255;1163;0;0;0;0;0;.00nan;0;0
23255;1239;26;0;0;0;0;.00nan;0;0
23255;2804;0;100;43;0;43;1.000;3600000;0
23196;482;6;0;0;0;0;.00nan;0;0
23196;483;6;100;42;0;42;1.000;3600000;0
23196;505;17;0;0;0;0;.00nan;0;0
23196;1333;17;80;27;2;25;.926;3577000;0
24249;735;5;0;0;0;0;.00nan;0;0
24249;1149;12;91;43;3;40;.930;3600000;0
24249;1278;12;0;0;0;0;.00nan;0;0
24249;1361;5;60;38;5;33;.868;3554000;0
23195;103;30;75;39;3;36;.923;3584000;0
23195;2174;18;93;35;1;34;.971;3600000;0
23195;2314;18;0;0;0;0;.00nan;0;0
23195;2549;30;0;0;0;0;.00nan;0;0
23566;487;27;0;0;0;0;.00nan;0;0
23566;734;2;58;21;2;19;.905;3600000;0
23566;1355;2;0;0;0;0;.00nan;0;0
23566;2557;27;98;55;3;52;.945;3563000;0
23188;737;23;53;39;6;33;.846;3325000;0
23188;2016;14;0;0;0;0;.00nan;0;0
23188;2057;14;100;52;1;51;.981;3600000;0
23188;2375;23;50;1;0;1;1.000;275000;0
23193;429;28;0;0;0;0;.00nan;0;0
23193;1052;9;62;24;2;22;.917;3600000;0
23193;1061;28;43;35;6;29;.829;3600000;0
23193;1332;9;0;0;0;0;.00nan;0;0
23166;295;24;100;43;1;42;.977;3600000;0
23166;737;23;0;0;0;0;.00nan;0;0
23166;812;24;0;0;0;0;.00nan;0;0
23166;2375;23;52;23;3;20;.870;3525000;0
23215;0;48;0;0;0;0;.00nan;0;0
23215;318;22;94;31;1;30;.968;3900000;0
23215;1036;22;0;0;0;0;.00nan;0;0
23215;2947;29;85;28;1;27;.964;3900000;0
24252;112;13;98;57;3;54;.947;3600000;0
24252;429;28;0;0;0;0;.00nan;0;0
24252;714;13;0;0;0;0;.00nan;0;0
24252;1061;28;87;16;0;16;1.000;3600000;0
23333;482;6;0;0;0;0;.00nan;0;0
23333;483;6;88;53;2;51;.962;3900000;0
23333;1021;15;56;21;2;19;.905;3900000;0
23333;1128;15;0;0;0;0;.00nan;0;0
23185;103;30;77;25;1;24;.960;3600000;0
23185;711;3;8;17;6;11;.647;1092000;0
23185;1731;3;33;28;5;23;.821;2508000;0
23185;2549;30;0;0;0;0;.00nan;0;0
23580;277;10;0;0;0;0;.00nan;0;0
23580;691;10;60;19;2;17;.895;3570000;0
23580;734;2;0;0;0;0;.00nan;0;0
23580;1355;2;94;39;1;38;.974;3600000;0
23425;489;19;0;0;0;0;.00nan;0;0
23425;1056;19;65;23;2;21;.913;3600000;0
23425;1149;12;72;39;3;36;.923;3554000;0
23425;1278;12;0;0;0;0;.00nan;0;0
23404;783;11;83;25;2;23;.920;3600000;0
23404;1406;21;43;38;6;32;.842;3532000;0
23404;1690;21;48;0;0;0;.00nan;68000;0
23404;2810;11;0;0;0;0;.00nan;0;0
23243;13;7;89;31;1;30;.968;3600000;0
23243;316;7;0;0;0;0;.00nan;0;0
23243;2016;14;62;28;3;25;.893;3523000;0
23243;2057;14;0;0;0;0;.00nan;0;0
23246;295;24;0;0;0;0;.00nan;0;0
23246;419;20;92;42;2;40;.952;3578000;0
23246;707;20;0;0;0;0;.00nan;0;0
23246;812;24;97;37;1;36;.973;3600000;0
23199;268;1;0;0;0;0;.00nan;0;0
23199;1221;25;53;43;7;36;.837;3183000;0
23199;2269;25;58;5;0;5;1.000;417000;0
23199;2800;1;55;26;4;22;.846;3600000;0
23203;0;48;93;33;1;32;.970;3600000;0
23203;998;8;74;33;3;30;.909;3600000;0
23203;2266;8;0;0;0;0;.00nan;0;0
23203;2947;29;0;0;0;0;.00nan;0;0
23337;1021;15;0;0;0;0;.00nan;0;0
23337;1128;15;82;31;2;29;.935;3600000;0
23337;2174;18;51;29;5;24;.828;3600000;0
23337;2314;18;0;0;0;0;.00nan;0;0
23222;103;30;0;0;0;0;.00nan;0;0
23222;505;17;72;39;4;35;.897;3600000;0
23222;1333;17;0;0;0;0;.00nan;0;0
23222;2549;30;80;24;1;23;.958;3600000;0
23448;277;10;84;24;1;23;.958;3600000;0
23448;691;10;0;0;0;0;.00nan;0;0
23448;711;3;63;39;4;35;.897;3600000;0
23448;1731;3;0;0;0;0;.00nan;0;0
23293;710;26;0;0;0;0;.00nan;0;0
23293;1149;12;0;0;0;0;.00nan;0;0
23293;1239;26;64;35;4;31;.886;3900000;0
23293;1278;12;74;44;4;40;.909;3900000;0
23187;360;16;87;18;0;18;1.000;3600000;0
23187;1052;9;59;34;3;31;.912;3600000;0
23187;1332;9;0;0;0;0;.00nan;0;0
23187;2687;16;0;0;0;0;.00nan;0;0
23334;482;6;65;41;5;36;.878;3600000;0
23334;483;6;0;0;0;0;.00nan;0;0
23334;1406;21;100;34;1;33;.971;3600000;0
23334;1690;21;0;0;0;0;.00nan;0;0
24261;318;22;0;0;0;0;.00nan;0;0
24261;783;11;0;0;0;0;.00nan;0;0
24261;1036;22;67;23;2;21;.913;3600000;0
24261;2810;11;77;43;4;39;.907;3528000;0
23271;735;5;62;32;4;28;.875;3600000;0
23271;1163;0;0;0;0;0;.00nan;0;0
23271;1361;5;0;0;0;0;.00nan;0;0
23271;2804;0;96;38;2;36;.947;3600000;0
23311;487;27;75;27;2;25;.926;3583000;0
23311;735;5;0;0;0;0;.00nan;0;0
23311;1361;5;72;20;1;19;.950;3600000;0
23311;2557;27;0;0;0;0;.00nan;0;0
24275;0;48;0;0;0;0;.00nan;0;0
24275;710;26;32;12;3;9;.750;418000;0
24275;1239;26;86;46;3;43;.935;3182000;0
24275;2947;29;100;24;0;24;1.000;3600000;0
23240;419;20;69;42;5;37;.881;3600000;0
23240;707;20;0;0;0;0;.00nan;0;0
23240;998;8;14;21;6;15;.714;3549000;0
23240;2266;8;0;0;0;0;.00nan;0;0
23184;112;13;62;46;6;40;.870;3359000;0
23184;268;1;0;0;0;0;.00nan;0;0
23184;714;13;51;3;0;3;1.000;241000;0
23184;2800;1;60;23;2;21;.913;3600000;0
23175;727;4;61;23;2;21;.913;3600000;0
23175;1221;25;16;12;5;7;.583;1058000;0
23175;1335;4;0;0;0;0;.00nan;0;0
23175;2269;25;28;28;6;22;.786;2542000;0
23252;429;28;0;0;0;0;.00nan;0;0
23252;1061;28;100;40;1;39;.975;3600000;0
23252;2016;14;0;0;0;0;.00nan;0;0
23252;2057;14;81;32;2;30;.938;3552000;0
23189;737;23;0;0;0;0;.00nan;0;0
23189;1052;9;0;0;0;0;.00nan;0;0
23189;1332;9;81;43;3;40;.930;3600000;0
23189;2375;23;91;21;0;21;1.000;3600000;0
23603;277;10;0;0;0;0;.00nan;0;0
23603;489;19;0;0;0;0;.00nan;0;0
23603;691;10;61;22;2;20;.909;3900000;0
23603;1056;19;67;26;2;24;.923;3900000;0
23264;318;22;54;1;0;1;1.000;287000;0
23264;360;16;81;27;2;25;.926;3600000;0
23264;1036;22;37;39;7;32;.821;3313000;0
23264;2687;16;0;0;0;0;.00nan;0;0
23268;419;20;0;0;0;0;.00nan;0;0
23268;429;28;98;36;1;35;.972;3568000;0
23268;707;20;100;47;0;47;1.000;3600000;0
23268;1061;28;0;0;0;0;.00nan;0;0
23405;295;24;56;42;6;36;.857;3600000;0
23405;482;6;0;0;0;0;.00nan;0;0
23405;483;6;54;36;5;31;.861;3600000;0
23405;812;24;0;0;0;0;.00nan;0;0
24250;318;22;94;40;3;37;.925;3568000;0
24250;998;8;74;32;2;30;.938;3600000;0
24250;1036;22;0;0;0;0;.00nan;0;0
24250;2266;8;0;0;0;0;.00nan;0;0
23351;734;2;0;0;0;0;.00nan;0;0
23351;1355;2;64;43;4;39;.907;3600000;0
23351;2016;14;0;0;0;0;.00nan;0;0
23351;2057;14;30;22;5;17;.773;3590000;0
23197;737;23;0;0;0;0;.00nan;0;0
23197;1163;0;79;38;4;34;.895;3600000;0
23197;2375;23;90;35;1;34;.971;3600000;0
23197;2804;0;0;0;0;0;.00nan;0;0
23226;0;48;0;0;0;0;.00nan;0;0
23226;487;27;90;43;3;40;.930;3600000;0
23226;2557;27;0;0;0;0;.00nan;0;0
23226;2947;29;77;43;4;39;.907;3591000;0
23262;268;1;0;0;0;0;.00nan;0;0
23262;1406;21;87;34;2;32;.941;3582000;0
23262;1690;21;0;0;0;0;.00nan;0;0
23262;2800;1;99;47;1;46;.979;3600000;0
23624;783;11;76;35;3;32;.914;3512000;0
23624;1149;12;71;25;1;24;.960;3600000;0
23624;1278;12;0;0;0;0;.00nan;0;0
23624;2810;11;0;0;0;0;.00nan;0;0
23225;103;30;37;27;5;22;.815;3553000;0
23225;711;3;0;0;0;0;.00nan;0;0
23225;1731;3;80;32;3;29;.906;3600000;0
23225;2549;30;0;0;0;0;.00nan;0;0
23235;0;48;81;41;3;38;.927;3529000;0
23235;489;19;58;16;1;15;.938;3600000;0
23235;1056;19;0;0;0;0;.00nan;0;0
23235;2947;29;0;0;0;0;.00nan;0;0
23354;295;24;52;2;0;2;1.000;535000;0
23354;419;20;0;0;0;0;.00nan;0;0
23354;707;20;61;37;5;32;.865;3600000;0
23354;812;24;26;25;6;19;.760;3043000;0
23278;13;7;0;0;0;0;.00nan;0;0
23278;316;7;99;31;1;30;.968;3600000;0
23278;487;27;0;0;0;0;.00nan;0;0
23278;2557;27;78;39;3;36;.923;3558000;0
23346;735;5;68;30;3;27;.900;3552000;0
23346;1361;5;0;0;0;0;.00nan;0;0
23346;1406;21;0;0;0;0;.00nan;0;0
23346;1690;21;91;33;2;31;.939;3600000;0
23279;268;1;50;42;5;37;.881;3600000;0
23279;360;16;47;37;6;31;.838;3544000;0
23279;2687;16;0;0;0;0;.00nan;0;0
23279;2800;1;0;0;0;0;.00nan;0;0
23231;103;30;0;0;0;0;.00nan;0;0
23231;737;23;90;34;2;32;.941;3600000;0
23231;2375;23;0;0;0;0;.00nan;0;0
23231;2549;30;63;27;3;24;.889;3589000;0
23352;482;6;71;32;3;29;.906;3600000;0
23352;483;6;0;0;0;0;.00nan;0;0
23352;1149;12;65;12;0;12;1.000;1501000;0
23352;1278;12;42;32;6;26;.813;2099000;0
23282;429;28;0;0;0;0;.00nan;0;0
23282;1052;9;95;36;1;35;.972;3600000;0
23282;1061;28;93;37;2;35;.946;3580000;0
23282;1332;9;0;0;0;0;.00nan;0;0
23241;727;4;74;38;4;34;.895;3647000;0
23241;1163;0;0;0;0;0;.00nan;0;0
23241;1335;4;0;0;0;0;.00nan;0;0
23241;2804;0;68;37;5;32;.865;3647000;0
23207;112;13;89;31;1;30;.968;3600000;0
23207;714;13;0;0;0;0;.00nan;0;0
23207;734;2;67;27;2;25;.926;3566000;0
23207;1355;2;0;0;0;0;.00nan;0;0
23219;505;17;84;36;2;34;.944;3600000;0
23219;1221;25;76;33;3;30;.909;3600000;0
23219;1333;17;0;0;0;0;.00nan;0;0
23219;2973;36;0;0;0;0;.00nan;0;0
23324;710;26;0;0;0;0;.00nan;0;0
23324;711;3;58;26;4;22;.846;3600000;0
23324;1239;26;90;34;2;32;.941;3600000;0
23324;1731;3;0;0;0;0;.00nan;0;0
23256;277;10;0;0;0;0;.00nan;0;0
23256;691;10;67;20;1;19;.950;3600000;0
23256;1221;25;0;0;0;0;.00nan;0;0
23256;2973;36;45;35;6;29;.829;3600000;0
23212;13;7;70;30;3;27;.900;3600000;0
23212;112;13;0;0;0;0;.00nan;0;0
23212;316;7;0;0;0;0;.00nan;0;0
23212;714;13;26;20;5;15;.750;3575000;0
23259;710;26;90;39;3;36;.923;3900000;0
23259;1052;9;0;0;0;0;.00nan;0;0
23259;1239;26;0;0;0;0;.00nan;0;0
23259;1332;9;63;28;3;25;.893;3900000;0
23227;727;4;0;0;0;0;.00nan;0;0
23227;783;11;51;20;3;17;.850;3600000;0
23227;1335;4;100;32;0;32;1.000;3600000;0
23227;2810;11;0;0;0;0;.00nan;0;0
23272;360;16;63;34;3;31;.912;3900000;0
23272;735;5;0;0;0;0;.00nan;0;0
23272;1361;5;68;30;3;27;.900;3900000;0
23272;2687;16;0;0;0;0;.00nan;0;0
23371;489;19;0;0;0;0;.00nan;0;0
23371;1056;19;54;33;5;28;.848;3600000;0
23371;2314;18;0;0;0;0;.00nan;0;0
23371;5791;59;85;34;2;32;.941;3600000;0
23964;0;48;0;0;0;0;.00nan;0;0
23964;268;1;43;36;6;30;.833;2708000;0
23964;2800;1;33;16;4;12;.750;892000;0
23964;2947;29;65;21;3;18;.857;3600000;0
23751;318;22;0;0;0;0;.00nan;0;0
23751;1036;22;60;30;4;26;.867;3600000;0
23751;1149;12;0;0;0;0;.00nan;0;0
23751;1278;12;73;32;3;29;.906;3600000;0
23258;103;30;78;21;2;19;.905;3900000;0
23258;277;10;91;44;2;42;.955;3900000;0
23258;691;10;0;0;0;0;.00nan;0;0
23258;2549;30;0;0;0;0;.00nan;0;0
23263;419;20;0;0;0;0;.00nan;0;0
23263;707;20;82;34;2;32;.941;3600000;0
23263;998;8;65;28;3;25;.893;3550000;0
23263;2266;8;0;0;0;0;.00nan;0;0
23398;734;2;0;0;0;0;.00nan;0;0
23398;1021;15;59;31;4;27;.871;3600000;0
23398;1128;15;0;0;0;0;.00nan;0;0
23398;1355;2;66;35;5;30;.857;3544000;0
24172;295;24;0;0;0;0;.00nan;0;0
24172;711;3;57;46;6;40;.870;3237000;0
24172;812;24;72;26;2;24;.923;3600000;0
24172;1731;3;53;3;0;3;1.000;363000;0
23387;268;1;0;0;0;0;.00nan;0;0
23387;1149;12;48;27;4;23;.852;3900000;0
23387;1278;12;0;0;0;0;.00nan;0;0
23387;2800;1;97;53;4;49;.925;3900000;0
23230;505;17;0;0;0;0;.00nan;0;0
23230;1333;17;91;25;1;24;.960;3600000;0
23230;2016;14;63;29;3;26;.897;3600000;0
23230;2057;14;0;0;0;0;.00nan;0;0
24284;360;16;80;41;4;37;.902;3543000;0
24284;783;11;0;0;0;0;.00nan;0;0
24284;2687;16;0;0;0;0;.00nan;0;0
24284;2810;11;68;24;2;22;.917;3600000;0
23277;1052;9;97;44;2;42;.955;3522000;0
23277;1221;25;100;37;0;37;1.000;3600000;0
23277;1332;9;0;0;0;0;.00nan;0;0
23277;2973;36;0;0;0;0;.00nan;0;0
23305;318;22;85;48;3;45;.938;3600000;0
23305;419;20;73;46;5;41;.891;3533000;0
23305;707;20;0;0;0;0;.00nan;0;0
23305;1036;22;0;0;0;0;.00nan;0;0
23267;727;4;0;0;0;0;.00nan;0;0
23267;1163;0;63;31;3;28;.903;3819000;0
23267;1335;4;94;36;2;34;.944;3819000;0
23267;2804;0;0;0;0;0;.00nan;0;0
23365;295;24;65;36;4;32;.889;3900000;0
23365;812;24;0;0;0;0;.00nan;0;0
23365;1406;21;67;38;4;34;.895;3900000;0
23365;1690;21;0;0;0;0;.00nan;0;0
23515;487;27;62;26;4;22;.846;3600000;0
23515;2314;18;45;30;5;25;.833;3553000;0
23515;2557;27;0;0;0;0;.00nan;0;0
23515;5791;59;0;0;0;0;.00nan;0;0
24266;734;2;68;32;3;29;.906;3574000;0
24266;735;5;69;27;2;25;.926;3600000;0
24266;1355;2;0;0;0;0;.00nan;0;0
24266;1361;5;0;0;0;0;.00nan;0;0
24259;13;7;0;0;0;0;.00nan;0;0
24259;316;7;63;30;3;27;.900;3600000;0
24259;482;6;0;0;0;0;.00nan;0;0
24259;483;6;82;39;4;35;.897;3571000;0
24268;103;30;0;0;0;0;.00nan;0;0
24268;489;19;95;36;2;34;.944;3900000;0
24268;1056;19;0;0;0;0;.00nan;0;0
24268;2549;30;94;38;2;36;.947;3900000;0
23287;429;28;0;0;0;0;.00nan;0;0
23287;998;8;0;0;0;0;.00nan;0;0
23287;1061;28;78;24;1;23;.958;3600000;0
23287;2266;8;82;38;3;35;.921;3570000;0
24221;487;27;0;0;0;0;.00nan;0;0
24221;1021;15;74;27;2;25;.926;3900000;0
24221;1128;15;0;0;0;0;.00nan;0;0
24221;2557;27;65;25;2;23;.920;3900000;0
23309;13;7;55;30;4;26;.867;3544000;0
23309;316;7;0;0;0;0;.00nan;0;0
23309;429;28;57;23;3;20;.870;3600000;0
23309;1061;28;0;0;0;0;.00nan;0;0
23232;737;23;0;0;0;0;.00nan;0;0
23232;2016;14;0;0;0;0;.00nan;0;0
23232;2057;14;75;35;3;32;.914;3600000;0
23232;2375;23;64;32;4;28;.875;3553000;0
23285;277;10;0;0;0;0;.00nan;0;0
23285;691;10;73;20;1;19;.950;3600000;0
23285;727;4;87;48;4;44;.917;3600000;0
23285;1335;4;0;0;0;0;.00nan;0;0
23220;112;13;32;19;5;14;.737;3600000;0
23220;711;3;0;0;0;0;.00nan;0;0
23220;714;13;0;0;0;0;.00nan;0;0
23220;1731;3;93;41;2;39;.951;3600000;0
23273;360;16;0;0;0;0;.00nan;0;0
23273;710;26;0;0;0;0;.00nan;0;0
23273;1239;26;50;38;5;33;.868;3558000;0
23273;2687;16;60;33;4;29;.879;3600000;0
23740;783;11;94;40;2;38;.950;3840000;0
23740;2314;18;79;39;3;36;.923;3840000;0
23740;2810;11;0;0;0;0;.00nan;0;0
23740;5791;59;0;0;0;0;.00nan;0;0
23217;0;48;84;35;3;32;.914;3556000;0
23217;505;17;62;21;2;19;.905;3600000;0
23217;1333;17;0;0;0;0;.00nan;0;0
23217;2947;29;0;0;0;0;.00nan;0;0
24278;277;10;46;30;6;24;.800;3600000;0
24278;419;20;0;0;0;0;.00nan;0;0
24278;691;10;0;0;0;0;.00nan;0;0
24278;707;20;100;39;1;38;.974;3600000;0
23356;489;19;78;21;1;20;.952;3600000;0
23356;998;8;86;56;5;51;.911;3600000;0
23356;1056;19;0;0;0;0;.00nan;0;0
23356;2266;8;0;0;0;0;.00nan;0;0
23409;318;22;0;0;0;0;.00nan;0;0
23409;735;5;66;30;3;27;.900;3639000;0
23409;1036;22;69;37;4;33;.892;3639000;0
23409;1361;5;0;0;0;0;.00nan;0;0
24232;711;3;0;0;0;0;.00nan;0;0
24232;1021;15;78;27;2;25;.926;3600000;0
24232;1128;15;0;0;0;0;.00nan;0;0
24232;1731;3;67;35;3;32;.914;3600000;0
23424;482;6;0;0;0;0;.00nan;0;0
23424;483;6;55;35;5;30;.857;3900000;0
23424;1406;21;62;37;5;32;.865;3900000;0
23424;1690;21;0;0;0;0;.00nan;0;0
23430;268;1;0;0;0;0;.00nan;0;0
23430;419;20;78;34;3;31;.912;3542000;0
23430;707;20;0;0;0;0;.00nan;0;0
23430;2800;1;100;35;1;34;.971;3600000;0
23630;295;24;62;16;1;15;.938;3600000;0
23630;783;11;0;0;0;0;.00nan;0;0
23630;812;24;0;0;0;0;.00nan;0;0
23630;2810;11;97;50;4;46;.920;3600000;0
23239;0;48;0;0;0;0;.00nan;0;0
23239;487;27;72;38;4;34;.895;3543000;0
23239;2557;27;0;0;0;0;.00nan;0;0
23239;2947;29;94;43;3;40;.930;3600000;0
24276;360;16;95;39;1;38;.974;3900000;0
24276;734;2;0;0;0;0;.00nan;0;0
24276;1355;2;100;35;1;34;.971;3847000;0
24276;2687;16;0;0;0;0;.00nan;0;0
23367;710;26;0;0;0;0;.00nan;0;0
23367;735;5;0;0;0;0;.00nan;0;0
23367;1239;26;77;26;2;24;.923;3600000;0
23367;1361;5;51;23;3;20;.870;3543000;0
23452;13;7;0;0;0;0;.00nan;0;0
23452;316;7;70;38;4;34;.895;3577000;0
23452;489;19;0;0;0;0;.00nan;0;0
23452;1056;19;61;25;3;22;.880;3600000;0
23466;268;1;68;36;3;33;.917;3564000;0
23466;2314;18;0;0;0;0;.00nan;0;0
23466;2800;1;0;0;0;0;.00nan;0;0
23466;5791;59;73;32;2;30;.938;3600000;0
23248;13;7;45;29;5;24;.828;3546000;0
23248;112;13;76;37;4;33;.892;3600000;0
23248;316;7;0;0;0;0;.00nan;0;0
23248;714;13;0;0;0;0;.00nan;0;0
23245;318;22;0;0;0;0;.00nan;0;0
23245;737;23;92;47;3;44;.936;3599000;0
23245;1036;22;65;22;1;21;.955;3600000;0
23245;2375;23;0;0;0;0;.00nan;0;0
24255;482;6;60;42;6;36;.857;3501000;0
24255;483;6;50;1;0;1;1.000;99000;0
24255;1149;12;0;0;0;0;.00nan;0;0
24255;1278;12;70;37;3;34;.919;3600000;0
23304;429;28;0;0;0;0;.00nan;0;0
23304;727;4;0;0;0;0;.00nan;0;0
23304;1061;28;51;33;4;29;.879;3553000;0
23304;1335;4;66;27;3;24;.889;3600000;0
23291;360;16;0;0;0;0;.00nan;0;0
23291;2016;14;0;0;0;0;.00nan;0;0
23291;2057;14;74;35;4;31;.886;3600000;0
23291;2687;16;86;39;3;36;.923;3600000;0
23364;103;30;91;29;1;28;.966;3600000;0
23364;734;2;73;34;2;32;.941;3600000;0
23364;1355;2;0;0;0;0;.00nan;0;0
23364;2549;30;0;0;0;0;.00nan;0;0
23318;277;10;0;0;0;0;.00nan;0;0
23318;487;27;0;0;0;0;.00nan;0;0
23318;691;10;85;21;1;20;.952;3600000;0
23318;2557;27;78;46;4;42;.913;3600000;0
23269;1163;0;0;0;0;0;.00nan;0;0
23269;1221;25;78;43;4;39;.907;3577000;0
23269;2269;25;0;0;0;0;.00nan;0;0
23269;2804;0;57;21;3;18;.857;3600000;0
23283;998;8;96;36;1;35;.972;3600000;0
23283;1052;9;0;0;0;0;.00nan;0;0
23283;1332;9;75;25;2;23;.920;3555000;0
23283;2266;8;0;0;0;0;.00nan;0;0
23250;112;13;0;0;0;0;.00nan;0;0
23250;714;13;55;37;5;32;.865;3600000;0
23250;727;4;89;48;3;45;.938;3600000;0
23250;1335;4;0;0;0;0;.00nan;0;0
23238;0;48;86;34;2;32;.941;3600000;0
23238;419;20;0;0;0;0;.00nan;0;0
23238;707;20;65;28;3;25;.893;3578000;0
23238;2947;29;0;0;0;0;.00nan;0;0
23611;295;24;91;32;1;31;.969;3900000;0
23611;783;11;88;47;1;46;.979;3900000;0
23611;812;24;0;0;0;0;.00nan;0;0
23611;2810;11;0;0;0;0;.00nan;0;0
23234;505;17;97;38;1;37;.974;3600000;0
23234;711;3;81;39;3;36;.923;3550000;0
23234;1333;17;0;0;0;0;.00nan;0;0
23234;1731;3;0;0;0;0;.00nan;0;0
23378;103;30;0;0;0;0;.00nan;0;0
23378;710;26;76;32;2;30;.938;3558000;0
23378;1239;26;0;0;0;0;.00nan;0;0
23378;2549;30;86;33;1;32;.970;3600000;0
23330;711;3;78;33;2;31;.939;3322000;0
23330;1149;12;0;0;0;0;.00nan;0;0
23330;1278;12;87;34;3;31;.912;3600000;0
23330;1731;3;28;7;3;4;.571;222000;0
23303;0;48;0;0;0;0;.00nan;0;0
23303;998;8;0;0;0;0;.00nan;0;0
23303;2266;8;93;52;3;49;.942;3600000;0
23303;2947;29;41;25;4;21;.840;3547000;0
23244;419;20;66;29;3;26;.897;3588000;0
23244;505;17;0;0;0;0;.00nan;0;0
23244;707;20;0;0;0;0;.00nan;0;0
23244;1333;17;80;22;1;21;.955;3600000;0
23276;1163;0;82;45;4;41;.911;3550000;0
23276;1221;25;62;18;2;16;.889;3600000;0
23276;2269;25;0;0;0;0;.00nan;0;0
23276;2804;0;0;0;0;0;.00nan;0;0
23253;318;22;0;0;0;0;.00nan;0;0
23253;737;23;66;32;4;28;.875;3644000;0
23253;1036;22;73;28;3;25;.893;3636000;0
23253;2375;23;0;0;0;0;.00nan;0;0
23481;295;24;0;0;0;0;.00nan;0;0
23481;482;6;80;36;3;33;.917;3557000;0
23481;483;6;0;0;0;0;.00nan;0;0
23481;812;24;75;22;1;21;.955;3600000;0
23284;360;16;73;36;2;34;.944;3600000;0
23284;2314;18;59;24;3;21;.875;3543000;0
23284;2687;16;0;0;0;0;.00nan;0;0
23284;5791;59;0;0;0;0;.00nan;0;0
23459;735;5;66;25;2;23;.920;3600000;0
23459;1021;15;68;37;4;33;.892;3600000;0
23459;1128;15;0;0;0;0;.00nan;0;0
23459;1361;5;0;0;0;0;.00nan;0;0
23299;429;28;0;0;0;0;.00nan;0;0
23299;1061;28;60;18;2;16;.889;3600000;0
23299;2016;14;50;1;0;1;1.000;330000;0
23299;2057;14;36;35;6;29;.829;3270000;0
23342;1052;9;0;0;0;0;.00nan;0;0
23342;1221;25;0;0;0;0;.00nan;0;0
23342;1332;9;87;39;3;36;.923;3900000;0
23342;2269;25;73;33;3;30;.909;3900000;0
23498;734;2;0;0;0;0;.00nan;0;0
23498;1355;2;99;37;1;36;.973;3600000;0
23498;1406;21;75;32;2;30;.938;3567000;0
23498;1690;21;0;0;0;0;.00nan;0;0
23578;489;19;43;35;6;29;.829;3600000;0
23578;783;11;43;41;7;34;.829;3550000;0
23578;1056;19;0;0;0;0;.00nan;0;0
23578;2810;11;0;0;0;0;.00nan;0;0
23286;727;4;73;31;2;29;.935;3600000;0
23286;737;23;0;0;0;0;.00nan;0;0
23286;1335;4;0;0;0;0;.00nan;0;0
23286;2375;23;92;44;3;41;.932;3547000;0
23280;1021;15;0;0;0;0;.00nan;0;0
23280;1128;15;84;30;2;28;.933;3600000;0
23280;1163;0;0;0;0;0;.00nan;0;0
23280;2804;0;70;31;3;28;.903;3595000;0
23260;112;13;100;36;1;35;.972;3900000;0
23260;277;10;0;0;0;0;.00nan;0;0
23260;691;10;71;23;1;22;.957;3900000;0
23260;714;13;0;0;0;0;.00nan;0;0
23353;103;30;90;38;2;36;.947;3581000;0
23353;1149;12;80;27;1;26;.963;3600000;0
23353;1278;12;0;0;0;0;.00nan;0;0
23353;2549;30;0;0;0;0;.00nan;0;0
23274;505;17;84;36;2;34;.944;3576000;0
23274;735;5;100;36;1;35;.972;3600000;0
23274;1333;17;0;0;0;0;.00nan;0;0
23274;1361;5;0;0;0;0;.00nan;0;0
23508;13;7;0;0;0;0;.00nan;0;0
23508;316;7;65;31;3;28;.903;3600000;0
23508;1406;21;0;0;0;0;.00nan;0;0
23508;1690;21;100;32;1;31;.969;3600000;0
23511;482;6;0;0;0;0;.00nan;0;0
23511;483;6;85;38;2;36;.947;3600000;0
23511;734;2;68;34;3;31;.912;3569000;0
23511;1355;2;0;0;0;0;.00nan;0;0
23292;277;10;66;25;2;23;.920;3600000;0
23292;318;22;50;1;0;1;1.000;681000;0
23292;691;10;0;0;0;0;.00nan;0;0
23292;1036;22;47;39;6;33;.846;2919000;0
24204;295;24;54;25;3;22;.880;3600000;0
24204;711;3;50;1;0;1;1.000;169000;0
24204;812;24;0;0;0;0;.00nan;0;0
24204;1731;3;50;51;7;44;.863;3431000;0
23326;1052;9;63;33;4;29;.879;3600000;0
23326;1332;9;0;0;0;0;.00nan;0;0
23326;2016;14;0;0;0;0;.00nan;0;0
23326;2057;14;74;22;1;21;.955;3600000;0
23320;360;16;86;50;4;46;.920;3600000;0
23320;2314;18;69;20;1;19;.950;3600000;0
23320;2687;16;0;0;0;0;.00nan;0;0
23320;5791;59;0;0;0;0;.00nan;0;0
24282;112;13;0;0;0;0;.00nan;0;0
24282;419;20;89;45;2;43;.956;3575000;0
24282;707;20;0;0;0;0;.00nan;0;0
24282;714;13;76;25;1;24;.960;3600000;0
23319;487;27;83;36;2;34;.944;3600000;0
23319;998;8;89;43;3;40;.930;3554000;0
23319;2266;8;0;0;0;0;.00nan;0;0
23319;2557;27;0;0;0;0;.00nan;0;0
23478;489;19;0;0;0;0;.00nan;0;0
23478;1056;19;77;30;2;28;.933;3551000;0
23478;1149;12;100;33;0;33;1.000;3600000;0
23478;1278;12;0;0;0;0;.00nan;0;0
24267;783;11;0;0;0;0;.00nan;0;0
24267;1221;25;79;18;1;17;.944;3600000;0
24267;2269;25;0;0;0;0;.00nan;0;0
24267;2810;11;95;46;3;43;.935;3569000;0
23310;429;28;0;0;0;0;.00nan;0;0
23310;710;26;0;0;0;0;.00nan;0;0
23310;1061;28;68;26;3;23;.885;3863000;0
23310;1239;26;76;43;4;39;.907;3863000;0
23581;268;1;0;0;0;0;.00nan;0;0
23581;1021;15;100;25;0;25;1.000;3600000;0
23581;1128;15;0;0;0;0;.00nan;0;0
23581;2800;1;53;30;4;26;.867;3600000;0
24238;487;27;0;0;0;0;.00nan;0;0
24238;2016;14;61;41;4;37;.902;3538000;0
24238;2057;14;0;0;0;0;.00nan;0;0
24238;2557;27;73;27;3;24;.889;3600000;0
23594;482;6;0;0;0;0;.00nan;0;0
23594;483;6;87;33;1;32;.970;3600000;0
23594;489;19;57;30;3;27;.900;3517000;0
23594;1056;19;0;0;0;0;.00nan;0;0
23329;318;22;0;0;0;0;.00nan;0;0
23329;429;28;43;31;6;25;.806;3600000;0
23329;1036;22;85;40;3;37;.925;3600000;0
23329;1061;28;0;0;0;0;.00nan;0;0
23431;103;30;85;31;1;30;.968;3600000;0
23431;711;3;0;0;0;0;.00nan;0;0
23431;1731;3;91;44;2;42;.955;3567000;0
23431;2549;30;0;0;0;0;.00nan;0;0
23374;419;20;95;33;1;32;.970;3600000;0
23374;707;20;0;0;0;0;.00nan;0;0
23374;735;5;50;1;0;1;1.000;449000;0
23374;1361;5;26;42;8;34;.810;3151000;0
23788;1406;21;99;36;1;35;.972;3600000;0
23788;1690;21;0;0;0;0;.00nan;0;0
23788;2174;18;0;0;0;0;.00nan;0;0
23788;2314;18;47;27;4;23;.852;3600000;0
23317;112;13;58;42;6;36;.857;3600000;0
23317;295;24;48;32;5;27;.844;3600000;0
23317;714;13;0;0;0;0;.00nan;0;0
23317;812;24;0;0;0;0;.00nan;0;0
23300;505;17;66;33;4;29;.879;3600000;0
23300;998;8;98;35;1;34;.971;3600000;0
23300;1333;17;0;0;0;0;.00nan;0;0
23300;2266;8;0;0;0;0;.00nan;0;0
23289;1052;9;0;0;0;0;.00nan;0;0
23289;1163;0;94;33;1;32;.970;3561000;0
23289;1332;9;100;39;0;39;1.000;3600000;0
23289;2804;0;0;0;0;0;.00nan;0;0
23316;487;27;53;34;6;28;.824;2574000;0
23316;505;17;0;0;0;0;.00nan;0;0
23316;1333;17;81;27;1;26;.963;3600000;0
23316;2557;27;41;10;2;8;.800;1026000;0
23298;13;7;85;55;5;50;.909;3596000;0
23298;277;10;0;0;0;0;.00nan;0;0
23298;316;7;0;0;0;0;.00nan;0;0
23298;691;10;50;20;3;17;.850;3600000;0
23313;0;48;73;40;3;37;.925;3600000;0
23313;1221;25;73;39;4;35;.897;3596000;0
23313;2269;25;0;0;0;0;.00nan;0;0
23313;2947;29;0;0;0;0;.00nan;0;0
23312;360;16;59;28;3;25;.893;3574000;0
23312;1163;0;0;0;0;0;.00nan;0;0
23312;2687;16;0;0;0;0;.00nan;0;0
23312;2804;0;82;28;2;26;.929;3600000;0
23484;295;24;0;0;0;0;.00nan;0;0
23484;318;22;66;33;4;29;.879;3560000;0
23484;812;24;91;40;3;37;.925;3600000;0
23484;1036;22;0;0;0;0;.00nan;0;0
23859;734;2;0;0;0;0;.00nan;0;0
23859;783;11;56;34;5;29;.853;2341000;0
23859;1355;2;81;31;2;29;.935;3600000;0
23859;2810;11;66;10;0;10;1.000;1259000;0
23341;727;4;0;0;0;0;.00nan;0;0
23341;1052;9;55;3;0;3;1.000;76000;0
23341;1332;9;44;46;7;39;.848;3524000;0
23341;1335;4;73;26;2;24;.923;3600000;0
23505;268;1;0;0;0;0;.00nan;0;0
23505;2174;18;97;35;1;34;.971;3600000;0
23505;2314;18;0;0;0;0;.00nan;0;0
23505;2800;1;84;37;3;34;.919;3553000;0
23294;710;26;0;0;0;0;.00nan;0;0
23294;737;23;89;34;2;32;.941;3900000;0
23294;1239;26;96;35;2;33;.943;3900000;0
23294;2375;23;0;0;0;0;.00nan;0;0
23381;998;8;97;37;1;36;.973;2549000;0
23381;2016;14;0;0;0;0;.00nan;0;0
23381;2057;14;53;25;3;22;.880;3600000;0
23381;2266;8;28;14;4;10;.714;965000;0
23323;112;13;0;0;0;0;.00nan;0;0
23323;714;13;100;58;2;56;.966;3900000;0
23323;1149;12;73;27;2;25;.926;3900000;0
23323;1278;12;0;0;0;0;.00nan;0;0
23420;103;30;0;0;0;0;.00nan;0;0
23420;1021;15;97;34;1;33;.971;3900000;0
23420;1128;15;0;0;0;0;.00nan;0;0
23420;2549;30;91;30;1;29;.967;3900000;0
23314;13;7;0;0;0;0;.00nan;0;0
23314;316;7;52;34;4;30;.882;3599000;0
23314;429;28;0;0;0;0;.00nan;0;0
23314;1061;28;61;29;3;26;.897;3600000;0
23308;277;10;68;17;1;16;.941;3600000;0
23308;419;20;72;43;5;38;.884;3600000;0
23308;691;10;0;0;0;0;.00nan;0;0
23308;707;20;0;0;0;0;.00nan;0;0
23345;1149;12;0;0;0;0;.00nan;0;0
23345;1221;25;0;0;0;0;.00nan;0;0
23345;1278;12;54;37;5;32;.865;3600000;0
23345;2269;25;90;33;1;32;.970;3600000;0
23402;0;48;0;0;0;0;.00nan;0;0
23402;487;27;0;0;0;0;.00nan;0;0
23402;2557;27;69;36;3;33;.917;3554000;0
23402;2947;29;60;25;2;23;.920;3600000;0
23288;737;23;0;0;0;0;.00nan;0;0
23288;783;11;80;39;3;36;.923;3558000;0
23288;2375;23;70;25;1;24;.960;3600000;0
23288;2810;11;0;0;0;0;.00nan;0;0
23347;429;28;84;31;1;30;.968;3600000;0
23347;1021;15;86;34;3;31;.912;3566000;0
23347;1061;28;0;0;0;0;.00nan;0;0
23347;1128;15;0;0;0;0;.00nan;0;0
23579;711;3;93;33;1;32;.970;3600000;0
23579;1731;3;0;0;0;0;.00nan;0;0
23579;2174;18;59;32;3;29;.906;3575000;0
23579;2314;18;0;0;0;0;.00nan;0;0
23474;489;19;43;5;1;4;.800;455000;0
23474;710;26;52;1;0;1;1.000;217000;0
23474;1056;19;44;31;6;25;.806;3092000;0
23474;1239;26;58;36;6;30;.833;3383000;0
23495;295;24;73;34;3;31;.912;3872000;0
23495;812;24;0;0;0;0;.00nan;0;0
23495;1406;21;74;32;3;29;.906;3900000;0
23495;1690;21;0;0;0;0;.00nan;0;0
23306;360;16;87;52;4;48;.923;3633000;0
23306;505;17;49;30;5;25;.833;3633000;0
23306;1333;17;0;0;0;0;.00nan;0;0
23306;2687;16;0;0;0;0;.00nan;0;0
23332;482;6;0;0;0;0;.00nan;0;0
23332;483;6;96;55;3;52;.945;3674000;0
23332;727;4;60;29;4;25;.862;3674000;0
23332;1335;4;0;0;0;0;.00nan;0;0
23348;13;7;92;39;1;38;.974;3558000;0
23348;316;7;0;0;0;0;.00nan;0;0
23348;1052;9;0;0;0;0;.00nan;0;0
23348;1332;9;100;34;0;34;1.000;3600000;0
23340;360;16;0;0;0;0;.00nan;0;0
23340;998;8;66;39;4;35;.897;3585000;0
23340;2266;8;0;0;0;0;.00nan;0;0
23340;2687;16;81;40;3;37;.925;3600000;0
23357;318;22;48;0;0;0;.00nan;107000;0
23357;1036;22;40;47;8;39;.830;3493000;0
23357;1221;25;72;30;3;27;.900;3600000;0
23357;2269;25;0;0;0;0;.00nan;0;0
23512;268;1;0;0;0;0;.00nan;0;0
23512;734;2;97;37;1;36;.973;3600000;0
23512;2800;1;58;41;6;35;.854;3600000;0
23512;5915;33;0;0;0;0;.00nan;0;0
23301;735;5;100;30;0;30;1.000;3600000;0
23301;737;23;58;8;0;8;1.000;794000;0
23301;1361;5;0;0;0;0;.00nan;0;0
23301;2375;23;21;29;7;22;.759;2806000;0
23446;103;30;95;36;2;34;.944;3600000;0
23446;482;6;32;15;4;11;.733;816000;0
23446;483;6;81;34;2;32;.941;2784000;0
23446;2549;30;0;0;0;0;.00nan;0;0
23331;711;3;0;0;0;0;.00nan;0;0
23331;1163;0;64;32;4;28;.875;3600000;0
23331;1731;3;31;32;6;26;.813;3534000;0
23331;2804;0;0;0;0;0;.00nan;0;0
23338;112;13;46;28;5;23;.821;3600000;0
23338;714;13;0;0;0;0;.00nan;0;0
23338;727;4;0;0;0;0;.00nan;0;0
23338;1335;4;65;33;4;29;.879;3600000;0
23355;710;26;0;0;0;0;.00nan;0;0
23355;1239;26;81;38;3;35;.921;3600000;0
23355;2016;14;0;0;0;0;.00nan;0;0
23355;2057;14;66;30;4;26;.867;3592000;0
23335;277;10;0;0;0;0;.00nan;0;0
23335;691;10;60;15;1;14;.933;3600000;0
23335;2016;14;95;46;2;44;.957;3576000;0
23335;2057;14;0;0;0;0;.00nan;0;0
23520;735;5;58;30;3;27;.900;3600000;0
23520;1021;15;28;30;6;24;.800;3001000;0
23520;1128;15;59;6;0;6;1.000;599000;0
23520;1361;5;0;0;0;0;.00nan;0;0
23488;1149;12;51;38;5;33;.868;3600000;0
23488;1278;12;0;0;0;0;.00nan;0;0
23488;1406;21;94;40;2;38;.950;3600000;0
23488;1690;21;0;0;0;0;.00nan;0;0
23416;0;48;63;32;4;28;.875;3600000;0
23416;419;20;83;56;5;51;.911;3556000;0
23416;707;20;0;0;0;0;.00nan;0;0
23416;2947;29;0;0;0;0;.00nan;0;0
23440;268;1;61;28;3;25;.893;3600000;0
23440;487;27;0;0;0;0;.00nan;0;0
23440;2557;27;78;29;2;27;.931;3600000;0
23440;2800;1;0;0;0;0;.00nan;0;0
23946;734;2;0;0;0;0;.00nan;0;0
23946;783;11;82;47;4;43;.915;3600000;0
23946;2810;11;0;0;0;0;.00nan;0;0
23946;5915;33;86;26;1;25;.962;3600000;0
24230;1052;9;0;0;0;0;.00nan;0;0
24230;1332;9;67;41;4;37;.902;3895000;0
24230;2174;18;0;0;0;0;.00nan;0;0
24230;2314;18;78;35;4;31;.886;3900000;0
23369;489;19;0;0;0;0;.00nan;0;0
23369;1056;19;90;40;3;37;.925;3600000;0
23369;1221;25;64;36;4;32;.889;3575000;0
23369;2269;25;0;0;0;0;.00nan;0;0
23307;360;16;95;33;1;32;.970;3600000;0
23307;737;23;53;22;3;19;.864;3553000;0
23307;2375;23;0;0;0;0;.00nan;0;0
23307;2687;16;0;0;0;0;.00nan;0;0
23386;429;28;0;0;0;0;.00nan;0;0
23386;1021;15;69;32;3;29;.906;3900000;0
23386;1061;28;67;32;3;29;.906;3900000;0
23386;1128;15;0;0;0;0;.00nan;0;0
23724;295;24;80;29;1;28;.966;3900000;0
23724;734;2;100;37;1;36;.973;3900000;0
23724;812;24;0;0;0;0;.00nan;0;0
23724;5915;33;0;0;0;0;.00nan;0;0
23656;711;3;43;28;5;23;.821;3225000;0
23656;783;11;84;43;4;39;.907;3600000;0
23656;1731;3;28;7;3;4;.571;375000;0
23656;2810;11;0;0;0;0;.00nan;0;0
23339;505;17;48;40;6;34;.850;3510000;0
23339;710;26;0;0;0;0;.00nan;0;0
23339;1239;26;73;33;3;30;.909;3600000;0
23339;1333;17;48;0;0;0;.00nan;90000;0
23380;0;48;84;25;1;24;.960;3600000;0
23380;1052;9;0;0;0;0;.00nan;0;0
23380;1332;9;98;47;3;44;.936;3550000;0
23380;2947;29;0;0;0;0;.00nan;0;0
24283;103;30;64;44;5;39;.886;3600000;0
24283;735;5;0;0;0;0;.00nan;0;0
24283;1361;5;75;30;2;28;.933;3600000;0
24283;2549;30;0;0;0;0;.00nan;0;0
23628;268;1;0;0;0;0;.00nan;0;0
23628;318;22;48;0;0;0;.00nan;154000;0
23628;1036;22;30;28;6;22;.786;3446000;0
23628;2800;1;71;37;3;34;.919;3600000;0
23343;1163;0;0;0;0;0;.00nan;0;0
23343;1406;21;62;25;3;22;.880;3544000;0
23343;1690;21;0;0;0;0;.00nan;0;0
23343;2804;0;100;48;2;46;.958;3600000;0
23363;1052;9;67;51;6;45;.882;3150000;0
23363;1149;12;71;29;3;26;.897;3600000;0
23363;1278;12;0;0;0;0;.00nan;0;0
23363;1332;9;52;11;1;10;.909;450000;0
23358;429;28;53;33;5;28;.848;3571000;0
23358;1061;28;0;0;0;0;.00nan;0;0
23358;1163;0;55;38;4;34;.895;3600000;0
23358;2804;0;0;0;0;0;.00nan;0;0
23368;112;13;98;35;2;33;.943;3600000;0
23368;295;24;0;0;0;0;.00nan;0;0
23368;714;13;0;0;0;0;.00nan;0;0
23368;812;24;54;41;5;36;.878;3600000;0
24229;487;27;52;37;5;32;.865;3589000;0
24229;1406;21;0;0;0;0;.00nan;0;0
24229;1690;21;84;41;4;37;.902;3600000;0
24229;2557;27;0;0;0;0;.00nan;0;0
23403;489;19;0;0;0;0;.00nan;0;0
23403;505;17;0;0;0;0;.00nan;0;0
23403;1056;19;100;38;0;38;1.000;3600000;0
23403;1333;17;82;44;4;40;.909;3600000;0
23443;735;5;81;39;3;36;.923;3600000;0
23443;1361;5;0;0;0;0;.00nan;0;0
23443;2016;14;0;0;0;0;.00nan;0;0
23443;2057;14;93;43;2;41;.953;3600000;0
23539;0;48;0;0;0;0;.00nan;0;0
23539;2174;18;31;28;6;22;.786;3081000;0
23539;2314;18;43;2;1;1;.500;663000;0
23539;2947;29;56;42;6;36;.857;3744000;0
23349;710;26;58;41;6;35;.854;3377000;0
23349;727;4;0;0;0;0;.00nan;0;0
23349;1239;26;50;1;0;1;1.000;223000;0
23349;1335;4;86;34;2;32;.941;3600000;0
23531;268;1;0;0;0;0;.00nan;0;0
23531;482;6;0;0;0;0;.00nan;0;0
23531;483;6;99;45;3;42;.933;3900000;0
23531;2800;1;88;37;3;34;.919;3900000;0
23450;13;7;0;0;0;0;.00nan;0;0
23450;103;30;0;0;0;0;.00nan;0;0
23450;316;7;64;34;5;29;.853;3600000;0
23450;2549;30;95;39;1;38;.974;3600000;0
23328;737;23;0;0;0;0;.00nan;0;0
23328;1221;25;63;22;2;20;.909;3600000;0
23328;2269;25;0;0;0;0;.00nan;0;0
23328;2375;23;66;46;5;41;.891;3600000;0
23846;783;11;0;0;0;0;.00nan;0;0
23846;1021;15;80;29;1;28;.966;3600000;0
23846;1128;15;0;0;0;0;.00nan;0;0
23846;2810;11;88;37;2;35;.946;3570000;0
23476;419;20;86;29;1;28;.966;3600000;0
23476;707;20;0;0;0;0;.00nan;0;0
23476;1149;12;0;0;0;0;.00nan;0;0
23476;1278;12;70;32;3;29;.906;3560000;0
23366;112;13;0;0;0;0;.00nan;0;0
23366;482;6;77;32;2;30;.938;3600000;0
23366;483;6;0;0;0;0;.00nan;0;0
23366;714;13;67;29;3;26;.897;3571000;0
23361;360;16;49;24;3;21;.875;3544000;0
23361;998;8;88;37;2;35;.946;3600000;0
23361;2266;8;0;0;0;0;.00nan;0;0
23361;2687;16;0;0;0;0;.00nan;0;0
23469;277;10;0;0;0;0;.00nan;0;0
23469;489;19;0;0;0;0;.00nan;0;0
23469;691;10;61;23;2;21;.913;3600000;0
23469;1056;19;54;41;5;36;.878;3600000;0
23392;103;30;65;37;4;33;.892;3600000;0
23392;1163;0;100;35;0;35;1.000;3600000;0
23392;2549;30;0;0;0;0;.00nan;0;0
23392;2804;0;0;0;0;0;.00nan;0;0
23370;727;4;78;33;2;31;.939;3900000;0
23370;735;5;79;35;2;33;.943;3900000;0
23370;1335;4;0;0;0;0;.00nan;0;0
23370;1361;5;0;0;0;0;.00nan;0;0
23362;998;8;98;44;2;42;.955;3600000;0
23362;1052;9;0;0;0;0;.00nan;0;0
23362;1332;9;40;37;6;31;.838;3600000;0
23362;2266;8;0;0;0;0;.00nan;0;0
23417;277;10;66;16;1;15;.938;3600000;0
23417;691;10;0;0;0;0;.00nan;0;0
23417;2016;14;0;0;0;0;.00nan;0;0
23417;2057;14;78;43;4;39;.907;3600000;0
23315;487;27;0;0;0;0;.00nan;0;0
23315;737;23;0;0;0;0;.00nan;0;0
23315;2375;23;100;36;0;36;1.000;3600000;0
23315;2557;27;93;44;3;41;.932;3600000;0
23401;505;17;79;30;2;28;.933;3600000;0
23401;1333;17;0;0;0;0;.00nan;0;0
23401;1406;21;34;13;3;10;.769;3559000;0
23401;1690;21;0;0;0;0;.00nan;0;0
23755;318;22;0;0;0;0;.00nan;0;0
23755;711;3;32;35;7;28;.800;2705000;0
23755;1036;22;84;39;2;37;.949;3600000;0
23755;1731;3;37;6;2;4;.667;895000;0
23573;0;48;90;38;2;36;.947;3600000;0
23573;734;2;53;28;4;24;.857;3513000;0
23573;2947;29;0;0;0;0;.00nan;0;0
23573;5915;33;0;0;0;0;.00nan;0;0
23760;1021;15;83;44;3;41;.932;3900000;0
23760;1128;15;0;0;0;0;.00nan;0;0
23760;2174;18;0;0;0;0;.00nan;0;0
23760;2314;18;92;37;3;34;.919;3900000;0
23486;13;7;96;33;1;32;.970;3600000;0
23486;316;7;0;0;0;0;.00nan;0;0
23486;419;20;0;0;0;0;.00nan;0;0
23486;707;20;56;24;3;21;.875;3600000;0
23344;360;16;86;28;0;28;1.000;2526000;0
23344;1221;25;0;0;0;0;.00nan;0;0
23344;2269;25;83;31;1;30;.968;3600000;0
23344;2687;16;38;14;4;10;.714;1074000;0
23480;489;19;0;0;0;0;.00nan;0;0
23480;710;26;0;0;0;0;.00nan;0;0
23480;1056;19;43;20;3;17;.850;3595000;0
23480;1239;26;91;28;1;27;.964;3600000;0
23518;734;2;0;0;0;0;.00nan;0;0
23518;1149;12;61;39;5;34;.872;3600000;0
23518;1278;12;0;0;0;0;.00nan;0;0
23518;5915;33;74;37;3;34;.919;3600000;0
23642;268;1;0;0;0;0;.00nan;0;0
23642;295;24;67;36;4;32;.889;3900000;0
23642;812;24;0;0;0;0;.00nan;0;0
23642;2800;1;66;34;4;30;.882;3900000;0
23383;487;27;93;33;1;32;.970;3600000;0
23383;727;4;39;1;1;0;.000;301000;0
23383;1335;4;61;45;6;39;.867;3299000;0
23383;2557;27;0;0;0;0;.00nan;0;0
23360;735;5;0;0;0;0;.00nan;0;0
23360;1221;25;73;34;3;31;.912;3556000;0
23360;1361;5;82;29;2;27;.931;3600000;0
23360;2269;25;0;0;0;0;.00nan;0;0
23504;318;22;84;33;2;31;.939;3600000;0
23504;711;3;0;0;0;0;.00nan;0;0
23504;1036;22;0;0;0;0;.00nan;0;0
23504;1731;3;79;40;4;36;.900;3536000;0
23492;419;20;93;47;2;45;.957;3555000;0
23492;707;20;0;0;0;0;.00nan;0;0
23492;2016;14;0;0;0;0;.00nan;0;0
23492;2057;14;83;16;0;16;1.000;3600000;0
23412;103;30;100;46;1;45;.978;3600000;0
23412;998;8;74;53;5;48;.906;3600000;0
23412;2266;8;0;0;0;0;.00nan;0;0
23412;2549;30;0;0;0;0;.00nan;0;0
23373;112;13;60;31;4;27;.871;3600000;0
23373;714;13;0;0;0;0;.00nan;0;0
23373;783;11;76;47;5;42;.894;3582000;0
23373;2810;11;0;0;0;0;.00nan;0;0
24281;482;6;0;0;0;0;.00nan;0;0
24281;483;6;99;36;1;35;.972;3860000;0
24281;710;26;89;37;2;35;.946;3860000;0
24281;1239;26;0;0;0;0;.00nan;0;0
23435;13;7;0;0;0;0;.00nan;0;0
23435;277;10;0;0;0;0;.00nan;0;0
23435;316;7;81;33;2;31;.939;3546000;0
23435;691;10;92;20;0;20;1.000;3600000;0
23388;429;28;0;0;0;0;.00nan;0;0
23388;1061;28;79;34;3;31;.912;3750000;0
23388;2174;18;0;0;0;0;.00nan;0;0
23388;2314;18;68;32;4;28;.875;3750000;0
24253;318;22;0;0;0;0;.00nan;0;0
24253;1021;15;63;28;3;25;.893;3600000;0
24253;1036;22;58;32;4;28;.875;3589000;0
24253;1128;15;0;0;0;0;.00nan;0;0
23536;487;27;0;0;0;0;.00nan;0;0
23536;1406;21;59;20;2;18;.900;3581000;0
23536;1690;21;0;0;0;0;.00nan;0;0
23536;2557;27;80;30;1;29;.967;3600000;0
23524;13;7;65;35;4;31;.886;3600000;0
23524;316;7;0;0;0;0;.00nan;0;0
23524;2016;14;0;0;0;0;.00nan;0;0
23524;2057;14;88;29;1;28;.966;3600000;0
23428;1149;12;67;47;5;42;.894;3600000;0
23428;1163;0;76;32;2;30;.938;3600000;0
23428;1278;12;0;0;0;0;.00nan;0;0
23428;2804;0;0;0;0;0;.00nan;0;0
23517;487;27;100;35;0;35;1.000;3600000;0
23517;489;19;0;0;0;0;.00nan;0;0
23517;1056;19;86;48;4;44;.917;3600000;0
23517;2557;27;0;0;0;0;.00nan;0;0
23549;419;20;89;53;2;51;.962;3572000;0
23549;707;20;0;0;0;0;.00nan;0;0
23549;710;26;0;0;0;0;.00nan;0;0
23549;1239;26;100;37;0;37;1.000;3600000;0
23422;711;3;50;0;0;0;.00nan;0;0
23422;1052;9;0;0;0;0;.00nan;0;0
23422;1332;9;79;25;1;24;.960;3600000;0
23422;1731;3;36;38;6;32;.842;3600000;0
23454;505;17;89;52;2;50;.962;3900000;0
23454;1333;17;0;0;0;0;.00nan;0;0
23454;2174;18;79;30;2;28;.933;3900000;0
23454;2314;18;0;0;0;0;.00nan;0;0
23470;103;30;100;35;2;33;.943;3900000;0
23470;277;10;0;0;0;0;.00nan;0;0
23470;691;10;76;27;2;25;.926;3900000;0
23470;2549;30;0;0;0;0;.00nan;0;0
23695;268;1;0;0;0;0;.00nan;0;0
23695;318;22;0;0;0;0;.00nan;0;0
23695;1036;22;82;24;1;23;.958;3600000;0
23695;2800;1;59;42;5;37;.881;3600000;0
23389;482;6;69;36;4;32;.889;2924000;0
23389;483;6;30;15;4;11;.733;676000;0
23389;1221;25;45;25;4;21;.840;3600000;0
23389;2269;25;0;0;0;0;.00nan;0;0
23391;727;4;97;42;2;40;.952;3600000;0
23391;1021;15;58;25;3;22;.880;3576000;0
23391;1128;15;0;0;0;0;.00nan;0;0
23391;1335;4;0;0;0;0;.00nan;0;0
23408;360;16;85;39;3;36;.923;3600000;0
23408;489;19;100;30;0;30;1.000;3600000;0
23408;1056;19;0;0;0;0;.00nan;0;0
23408;2687;16;0;0;0;0;.00nan;0;0
23453;429;28;0;0;0;0;.00nan;0;0
23453;1061;28;99;42;2;40;.952;3900000;0
23453;1149;12;0;0;0;0;.00nan;0;0
23453;1278;12;79;40;2;38;.950;3900000;0
23427;277;10;66;17;2;15;.882;3600000;0
23427;691;10;0;0;0;0;.00nan;0;0
23427;1163;0;0;0;0;0;.00nan;0;0
23427;2804;0;68;42;5;37;.881;3600000;0
23685;13;7;0;0;0;0;.00nan;0;0
23685;295;24;58;32;4;28;.875;3532000;0
23685;316;7;82;37;2;35;.946;3600000;0
23685;812;24;0;0;0;0;.00nan;0;0
23375;112;13;93;34;1;33;.971;3600000;0
23375;505;17;0;0;0;0;.00nan;0;0
23375;714;13;0;0;0;0;.00nan;0;0
23375;1333;17;54;30;4;26;.867;3600000;0
23372;1052;9;79;30;2;28;.933;3600000;0
23372;1332;9;0;0;0;0;.00nan;0;0
23372;1406;21;76;36;4;32;.889;3562000;0
23372;1690;21;0;0;0;0;.00nan;0;0
23558;0;48;69;35;4;31;.886;3600000;0
23558;710;26;81;36;2;34;.944;2655000;0
23558;1239;26;23;10;4;6;.600;888000;0
23558;2947;29;0;0;0;0;.00nan;0;0
23350;737;23;0;0;0;0;.00nan;0;0
23350;783;11;74;35;3;32;.914;3600000;0
23350;2375;23;87;29;1;28;.966;3600000;0
23350;2810;11;0;0;0;0;.00nan;0;0
23589;419;20;0;0;0;0;.00nan;0;0
23589;707;20;95;36;2;34;.944;3600000;0
23589;711;3;58;34;5;29;.853;3600000;0
23589;1731;3;0;0;0;0;.00nan;0;0
23533;0;48;0;0;0;0;.00nan;0;0
23533;734;2;0;0;0;0;.00nan;0;0
23533;1355;2;62;36;4;32;.889;3600000;0
23533;2947;29;98;31;1;30;.968;3600000;0
23377;727;4;0;0;0;0;.00nan;0;0
23377;998;8;34;20;4;16;.800;1073000;0
23377;1335;4;91;32;1;31;.969;3600000;0
23377;2266;8;87;33;1;32;.970;2527000;0
23692;268;1;0;0;0;0;.00nan;0;0
23692;2016;14;0;0;0;0;.00nan;0;0
23692;2057;14;100;39;0;39;1.000;3600000;0
23692;2800;1;88;33;1;32;.970;3545000;0
23395;360;16;99;32;1;31;.969;3600000;0
23395;735;5;75;39;3;36;.923;3597000;0
23395;1361;5;0;0;0;0;.00nan;0;0
23395;2687;16;0;0;0;0;.00nan;0;0
23399;482;6;0;0;0;0;.00nan;0;0
23399;483;6;45;32;5;27;.844;3568000;0
23399;1163;0;81;42;3;39;.929;3600000;0
23399;2804;0;0;0;0;0;.00nan;0;0
23359;737;23;0;0;0;0;.00nan;0;0
23359;998;8;100;45;1;44;.978;3600000;0
23359;2266;8;0;0;0;0;.00nan;0;0
23359;2375;23;48;21;3;18;.857;3582000;0
23433;318;22;0;0;0;0;.00nan;0;0
23433;1036;22;91;36;2;34;.944;3600000;0
23433;1052;9;0;0;0;0;.00nan;0;0
23433;1332;9;72;44;4;40;.909;3557000;0
23557;710;26;61;43;5;38;.884;3600000;0
23557;1239;26;0;0;0;0;.00nan;0;0
23557;2174;18;0;0;0;0;.00nan;0;0
23557;2314;18;99;47;1;46;.979;3600000;0
23421;429;28;0;0;0;0;.00nan;0;0
23421;1021;15;41;29;5;24;.828;3600000;0
23421;1061;28;92;37;2;35;.946;3600000;0
23421;1128;15;0;0;0;0;.00nan;0;0
23487;103;30;83;33;2;31;.939;3600000;0
23487;1406;21;54;23;3;20;.870;3564000;0
23487;1690;21;0;0;0;0;.00nan;0;0
23487;2549;30;0;0;0;0;.00nan;0;0
23382;112;13;46;31;5;26;.839;3470000;0
23382;714;13;50;0;0;0;.00nan;130000;0
23382;1221;25;32;26;6;20;.769;1622000;0
23382;2269;25;69;18;1;17;.944;1909000;0
23622;13;7;61;25;2;23;.920;3732000;0
23622;316;7;0;0;0;0;.00nan;0;0
23622;783;11;94;48;3;45;.938;3732000;0
23622;2810;11;0;0;0;0;.00nan;0;0
23426;277;10;0;0;0;0;.00nan;0;0
23426;691;10;80;30;2;28;.933;3600000;0
23426;735;5;0;0;0;0;.00nan;0;0
23426;1361;5;89;52;3;49;.942;3573000;0
23410;489;19;100;46;1;45;.978;3600000;0
23410;1056;19;0;0;0;0;.00nan;0;0
23410;1221;25;0;0;0;0;.00nan;0;0
23410;2269;25;70;23;2;21;.913;3561000;0
23577;0;48;57;33;5;28;.848;2049000;0
23577;419;20;96;37;1;36;.973;3600000;0
23577;707;20;0;0;0;0;.00nan;0;0
23577;2947;29;73;19;1;18;.947;1551000;0
23957;295;24;80;29;1;28;.966;3600000;0
23957;711;3;22;4;3;1;.250;524000;0
23957;812;24;0;0;0;0;.00nan;0;0
23957;1731;3;68;54;6;48;.889;3076000;0
23384;112;13;50;1;0;1;1.000;151000;0
23384;487;27;85;36;2;34;.944;3600000;0
23384;714;13;57;40;6;34;.850;3449000;0
23384;2557;27;0;0;0;0;.00nan;0;0
23393;429;28;0;0;0;0;.00nan;0;0
23393;1061;28;60;27;3;24;.889;3600000;0
23393;1406;21;0;0;0;0;.00nan;0;0
23393;1690;21;75;41;4;37;.902;3576000;0
23812;318;22;97;43;2;41;.953;3600000;0
23812;734;2;0;0;0;0;.00nan;0;0
23812;1036;22;0;0;0;0;.00nan;0;0
23812;1355;2;72;34;3;31;.912;3600000;0
23394;360;16;46;23;4;19;.826;3401000;0
23394;727;4;75;36;3;33;.917;3600000;0
23394;1335;4;0;0;0;0;.00nan;0;0
23394;2687;16;50;1;0;1;1.000;199000;0
23468;103;30;0;0;0;0;.00nan;0;0
23468;1149;12;0;0;0;0;.00nan;0;0
23468;1278;12;31;25;5;20;.800;3600000;0
23468;2549;30;93;41;2;39;.951;3600000;0
23423;505;17;48;32;5;27;.844;3523000;0
23423;998;8;64;32;3;29;.906;3600000;0
23423;1333;17;0;0;0;0;.00nan;0;0
23423;2266;8;0;0;0;0;.00nan;0;0
23567;295;24;0;0;0;0;.00nan;0;0
23567;487;27;0;0;0;0;.00nan;0;0
23567;812;24;81;39;4;35;.897;3900000;0
23567;2557;27;81;44;4;40;.909;3900000;0
23376;482;6;53;10;1;9;.900;868000;0
23376;483;6;43;32;6;26;.813;2732000;0
23376;737;23;0;0;0;0;.00nan;0;0
23376;2375;23;70;36;4;32;.889;3600000;0
23979;268;1;0;0;0;0;.00nan;0;0
23979;734;2;60;31;4;27;.871;3549000;0
23979;1355;2;0;0;0;0;.00nan;0;0
23979;2800;1;87;41;3;38;.927;3600000;0
23528;735;5;30;11;3;8;.727;564000;0
23528;1361;5;65;34;4;30;.882;3036000;0
23528;2174;18;0;0;0;0;.00nan;0;0
23528;2314;18;87;29;1;28;.966;3600000;0
23595;1021;15;80;22;1;21;.955;3600000;0
23595;1128;15;0;0;0;0;.00nan;0;0
23595;2016;14;38;34;6;28;.824;2834000;0
23595;2057;14;28;16;4;12;.750;766000;0
23722;783;11;0;0;0;0;.00nan;0;0
23722;2016;14;0;0;0;0;.00nan;0;0
23722;2057;14;88;27;1;26;.963;3600000;0
23722;2810;11;80;46;3;43;.935;3567000;0
23553;0;48;53;36;5;31;.861;3600000;0
23553;489;19;0;0;0;0;.00nan;0;0
23553;1056;19;85;30;2;28;.933;3600000;0
23553;2947;29;0;0;0;0;.00nan;0;0
23436;1052;9;68;11;0;11;1.000;1117000;0
23436;1163;0;69;35;4;31;.886;3600000;0
23436;1332;9;38;43;6;37;.860;2436000;0
23436;2804;0;0;0;0;0;.00nan;0;0
23458;318;22;0;0;0;0;.00nan;0;0
23458;1036;22;77;34;3;31;.912;3574000;0
23458;1221;25;91;38;2;36;.947;3600000;0
23458;2269;25;0;0;0;0;.00nan;0;0
23813;429;28;0;0;0;0;.00nan;0;0
23813;783;11;66;47;6;41;.872;3600000;0
23813;1061;28;71;20;1;19;.950;3600000;0
23813;2810;11;0;0;0;0;.00nan;0;0
23483;505;17;22;4;3;1;.250;405000;0
23483;711;3;0;0;0;0;.00nan;0;0
23483;1333;17;63;29;3;26;.897;3195000;0
23483;1731;3;99;37;1;36;.973;3600000;0
23406;727;4;60;37;4;33;.892;3600000;0
23406;1021;15;56;23;3;20;.870;3600000;0
23406;1128;15;0;0;0;0;.00nan;0;0
23406;1335;4;0;0;0;0;.00nan;0;0
23501;103;30;27;15;4;11;.733;976000;0
23501;295;24;0;0;0;0;.00nan;0;0
23501;812;24;69;26;3;23;.885;3600000;0
23501;2549;30;82;34;3;31;.912;2624000;0
23418;711;3;90;38;2;36;.947;3600000;0
23418;1221;25;0;0;0;0;.00nan;0;0
23418;1731;3;0;0;0;0;.00nan;0;0
23418;2269;25;70;35;3;32;.914;3600000;0
23429;727;4;0;0;0;0;.00nan;0;0
23429;1163;0;57;29;4;25;.862;3588000;0
23429;1335;4;87;31;2;29;.935;3600000;0
23429;2804;0;0;0;0;0;.00nan;0;0
23634;735;5;75;32;3;29;.906;3574000;0
23634;1361;5;0;0;0;0;.00nan;0;0
23634;2016;14;0;0;0;0;.00nan;0;0
23634;2057;14;99;41;2;39;.951;3600000;0
23379;360;16;55;36;5;31;.861;3600000;0
23379;737;23;100;47;0;47;1.000;3600000;0
23379;2687;16;0;0;0;0;.00nan;0;0
23379;2936;31;0;0;0;0;.00nan;0;0
23385;112;13;64;28;3;25;.893;3900000;0
23385;482;6;0;0;0;0;.00nan;0;0
23385;483;6;64;32;3;29;.906;3900000;0
23385;714;13;0;0;0;0;.00nan;0;0
23465;489;19;73;17;1;16;.941;3574000;0
23465;505;17;100;28;0;28;1.000;3600000;0
23465;1056;19;0;0;0;0;.00nan;0;0
23465;1333;17;0;0;0;0;.00nan;0;0
23500;277;10;0;0;0;0;.00nan;0;0
23500;295;24;93;61;4;57;.934;3545000;0
23500;691;10;57;23;3;20;.870;3600000;0
23500;812;24;0;0;0;0;.00nan;0;0
23548;103;30;99;33;1;32;.970;3600000;0
23548;318;22;59;32;4;28;.875;3600000;0
23548;1036;22;0;0;0;0;.00nan;0;0
23548;2549;30;0;0;0;0;.00nan;0;0
23497;13;7;0;0;0;0;.00nan;0;0
23497;316;7;82;35;2;33;.943;3600000;0
23497;1149;12;0;0;0;0;.00nan;0;0
23497;1278;12;58;33;4;29;.879;3552000;0
23449;998;8;73;50;5;45;.900;3512000;0
23449;2174;18;56;23;3;20;.870;3600000;0
23449;2266;8;0;0;0;0;.00nan;0;0
23449;2314;18;0;0;0;0;.00nan;0;0
23552;268;1;0;0;0;0;.00nan;0;0
23552;1406;21;48;24;4;20;.833;3618000;0
23552;1690;21;0;0;0;0;.00nan;0;0
23552;2800;1;91;63;5;58;.921;3618000;0
23434;482;6;85;32;1;31;.969;3600000;0
23434;483;6;0;0;0;0;.00nan;0;0
23434;1052;9;56;6;0;6;1.000;412000;0
23434;1332;9;35;33;6;27;.818;3188000;0
23503;277;10;77;18;1;17;.944;3600000;0
23503;419;20;64;40;5;35;.875;3600000;0
23503;691;10;0;0;0;0;.00nan;0;0
23503;707;20;0;0;0;0;.00nan;0;0
23411;0;48;83;34;2;32;.941;3600000;0
23411;360;16;36;26;5;21;.808;3600000;0
23411;2687;16;0;0;0;0;.00nan;0;0
23411;2947;29;0;0;0;0;.00nan;0;0
23414;710;26;0;0;0;0;.00nan;0;0
23414;727;4;62;46;6;40;.870;3248000;0
23414;1239;26;53;30;5;25;.833;3600000;0
23414;1335;4;44;4;1;3;.750;352000;0
23415;112;13;78;23;1;22;.957;3600000;0
23415;419;20;0;0;0;0;.00nan;0;0
23415;707;20;63;36;4;32;.889;3600000;0
23415;714;13;0;0;0;0;.00nan;0;0
23610;318;22;0;0;0;0;.00nan;0;0
23610;1036;22;93;44;2;42;.955;3900000;0
23610;1406;21;94;33;2;31;.939;3893000;0
23610;1690;21;0;0;0;0;.00nan;0;0
23397;737;23;86;32;1;31;.969;3600000;0
23397;1163;0;27;12;4;8;.667;609000;0
23397;2804;0;85;38;3;35;.921;2991000;0
23397;2936;31;0;0;0;0;.00nan;0;0
23638;268;1;48;0;0;0;.00nan;67000;0
23638;735;5;0;0;0;0;.00nan;0;0
23638;1361;5;67;29;3;26;.897;3600000;0
23638;2800;1;39;42;7;35;.833;3533000;0
23472;734;2;0;0;0;0;.00nan;0;0
23472;998;8;61;40;4;36;.900;3598000;0
23472;1355;2;77;34;2;32;.941;3600000;0
23472;2266;8;0;0;0;0;.00nan;0;0
23438;1052;9;79;37;2;35;.946;3600000;0
23438;1332;9;0;0;0;0;.00nan;0;0
23438;2016;14;0;0;0;0;.00nan;0;0
23438;2057;14;69;40;5;35;.875;3600000;0
23532;487;27;0;0;0;0;.00nan;0;0
23532;489;19;0;0;0;0;.00nan;0;0
23532;1056;19;83;38;3;35;.921;3600000;0
23532;2557;27;67;42;5;37;.881;3520000;0
23437;1221;25;82;29;2;27;.931;3600000;0
23437;2174;18;19;31;7;24;.774;3253000;0
23437;2269;25;0;0;0;0;.00nan;0;0
23437;2314;18;50;2;0;2;1.000;347000;0
23516;429;28;0;0;0;0;.00nan;0;0
23516;1061;28;69;22;1;21;.955;3600000;0
23516;2016;14;83;40;2;38;.950;3574000;0
23516;2057;14;0;0;0;0;.00nan;0;0
23606;277;10;0;0;0;0;.00nan;0;0
23606;691;10;92;27;1;26;.963;3600000;0
23606;2174;18;0;0;0;0;.00nan;0;0
23606;2314;18;61;26;3;23;.885;3554000;0
23568;13;7;0;0;0;0;.00nan;0;0
23568;316;7;91;38;2;36;.947;3600000;0
23568;487;27;78;36;4;32;.889;3559000;0
23568;2557;27;0;0;0;0;.00nan;0;0
23475;295;24;0;0;0;0;.00nan;0;0
23475;812;24;55;27;4;23;.852;3600000;0
23475;998;8;96;48;3;45;.938;3600000;0
23475;2266;8;0;0;0;0;.00nan;0;0
23491;505;17;57;33;4;29;.879;3583000;0
23491;710;26;71;32;3;29;.906;3600000;0
23491;1239;26;0;0;0;0;.00nan;0;0
23491;1333;17;0;0;0;0;.00nan;0;0
23400;737;23;0;0;0;0;.00nan;0;0
23400;1021;15;80;43;4;39;.907;3600000;0
23400;1128;15;0;0;0;0;.00nan;0;0
23400;2936;31;79;27;1;26;.963;3600000;0
23574;13;7;65;41;5;36;.878;3615000;0
23574;316;7;0;0;0;0;.00nan;0;0
23574;1149;12;0;0;0;0;.00nan;0;0
23574;1278;12;64;33;4;29;.879;3615000;0
23527;0;48;0;0;0;0;.00nan;0;0
23527;429;28;99;46;2;44;.957;3600000;0
23527;1061;28;0;0;0;0;.00nan;0;0
23527;2947;29;53;36;5;31;.861;3600000;0
23604;711;3;0;0;0;0;.00nan;0;0
23604;1052;9;0;0;0;0;.00nan;0;0
23604;1332;9;76;27;2;25;.926;3600000;0
23604;1731;3;74;41;3;38;.927;3561000;0
23419;112;13;61;31;4;27;.871;3600000;0
23419;714;13;0;0;0;0;.00nan;0;0
23419;1406;21;57;22;3;19;.864;3600000;0
23419;1690;21;0;0;0;0;.00nan;0;0
23570;103;30;83;36;2;34;.944;3600000;0
23570;734;2;58;26;4;22;.846;3514000;0
23570;1355;2;0;0;0;0;.00nan;0;0
23570;2549;30;0;0;0;0;.00nan;0;0
23413;360;16;73;44;5;39;.886;3600000;0
23413;735;5;81;20;1;19;.950;3600000;0
23413;1361;5;0;0;0;0;.00nan;0;0
23413;2687;16;0;0;0;0;.00nan;0;0
23664;268;1;0;0;0;0;.00nan;0;0
23664;1021;15;0;0;0;0;.00nan;0;0
23664;1128;15;84;19;0;19;1.000;3600000;0
23664;2800;1;77;25;1;24;.960;3547000;0
23522;487;27;0;0;0;0;.00nan;0;0
23522;1149;12;78;25;1;24;.960;3600000;0
23522;1278;12;0;0;0;0;.00nan;0;0
23522;2557;27;98;23;0;23;1.000;3600000;0
23551;419;20;91;31;1;30;.968;3900000;0
23551;482;6;0;0;0;0;.00nan;0;0
23551;483;6;89;33;1;32;.970;3900000;0
23551;707;20;0;0;0;0;.00nan;0;0
23955;710;26;0;0;0;0;.00nan;0;0
23955;783;11;80;50;5;45;.900;3600000;0
23955;1239;26;99;45;2;43;.956;3600000;0
23955;2810;11;0;0;0;0;.00nan;0;0
24279;318;22;0;0;0;0;.00nan;0;0
24279;1036;22;85;33;1;32;.970;3600000;0
24279;2016;14;0;0;0;0;.00nan;0;0
24279;2057;14;60;32;5;27;.844;3600000;0
23554;318;22;72;30;3;27;.900;3600000;0
23554;998;8;89;58;4;54;.931;3543000;0
23554;1036;22;0;0;0;0;.00nan;0;0
23554;2266;8;0;0;0;0;.00nan;0;0
23654;735;5;0;0;0;0;.00nan;0;0
23654;1361;5;67;26;3;23;.885;3600000;0
23654;2016;14;32;31;6;25;.806;3600000;0
23654;2057;14;0;0;0;0;.00nan;0;0
23473;112;13;0;0;0;0;.00nan;0;0
23473;710;26;87;50;4;46;.920;3600000;0
23473;714;13;74;19;1;18;.947;3600000;0
23473;1239;26;0;0;0;0;.00nan;0;0
23455;487;27;0;0;0;0;.00nan;0;0
23455;1163;0;0;0;0;0;.00nan;0;0
23455;2557;27;71;32;3;29;.906;3600000;0
23455;2804;0;98;22;0;22;1.000;3600000;0
23783;13;7;0;0;0;0;.00nan;0;0
23783;277;10;0;0;0;0;.00nan;0;0
23783;316;7;93;49;3;46;.939;3900000;0
23783;691;10;67;31;3;28;.903;3900000;0
23585;0;48;85;53;4;49;.925;3600000;0
23585;295;24;74;20;1;19;.950;3600000;0
23585;812;24;0;0;0;0;.00nan;0;0
23585;2947;29;0;0;0;0;.00nan;0;0
23464;360;16;76;23;1;22;.957;3600000;0
23464;711;3;58;6;0;6;1.000;493000;0
23464;1731;3;36;34;6;28;.824;3107000;0
23464;2687;16;0;0;0;0;.00nan;0;0
23526;505;17;0;0;0;0;.00nan;0;0
23526;1333;17;79;45;4;41;.911;3900000;0
23526;1406;21;61;30;4;26;.867;3900000;0
23526;1690;21;0;0;0;0;.00nan;0;0
23561;419;20;0;0;0;0;.00nan;0;0
23561;489;19;0;0;0;0;.00nan;0;0
23561;707;20;69;37;5;32;.865;3600000;0
23561;1056;19;81;25;1;24;.960;3600000;0
23588;103;30;88;35;2;33;.943;3600000;0
23588;268;1;0;0;0;0;.00nan;0;0
23588;2549;30;0;0;0;0;.00nan;0;0
23588;2800;1;75;39;3;36;.923;3545000;0
23542;783;11;0;0;0;0;.00nan;0;0
23542;1221;25;0;0;0;0;.00nan;0;0
23542;2269;25;55;25;3;22;.880;3600000;0
23542;2810;11;49;35;6;29;.829;3600000;0
23582;482;6;48;7;1;6;.857;558000;0
23582;483;6;53;40;6;34;.850;3042000;0
23582;737;23;27;26;6;20;.769;3163000;0
23582;2936;31;51;1;0;1;1.000;437000;0
24048;1021;15;0;0;0;0;.00nan;0;0
24048;1128;15;39;42;7;35;.833;3568000;0
24048;2174;18;0;0;0;0;.00nan;0;0
24048;2314;18;45;26;5;21;.808;3600000;0
23636;429;28;0;0;0;0;.00nan;0;0
23636;734;2;0;0;0;0;.00nan;0;0
23636;1061;28;100;31;0;31;1.000;3900000;0
23636;1355;2;98;37;0;37;1.000;3900000;0
23920;727;4;47;33;5;28;.848;3600000;0
23920;1052;9;0;0;0;0;.00nan;0;0
23920;1332;9;90;41;2;39;.951;3600000;0
23920;1335;4;0;0;0;0;.00nan;0;0
23696;1021;15;73;30;3;27;.900;3630000;0
23696;1128;15;0;0;0;0;.00nan;0;0
23696;2016;14;0;0;0;0;.00nan;0;0
23696;2057;14;75;26;2;24;.923;3630000;0
23441;727;4;0;0;0;0;.00nan;0;0
23441;1221;25;98;29;1;28;.966;3600000;0
23441;1335;4;90;41;3;38;.927;3559000;0
23441;2269;25;0;0;0;0;.00nan;0;0
23576;487;27;0;0;0;0;.00nan;0;0
23576;710;26;0;0;0;0;.00nan;0;0
23576;1239;26;100;26;0;26;1.000;3600000;0
23576;2557;27;97;40;2;38;.950;3565000;0
23390;112;13;82;22;1;21;.955;3600000;0
23390;714;13;0;0;0;0;.00nan;0;0
23390;1406;21;50;37;6;31;.838;3489000;0
23390;1690;21;48;0;0;0;.00nan;111000;0
23559;0;48;73;38;4;34;.895;3542000;0
23559;489;19;0;0;0;0;.00nan;0;0
23559;1056;19;82;34;2;32;.941;3600000;0
23559;2947;29;0;0;0;0;.00nan;0;0
23571;295;24;38;46;8;38;.826;3600000;0
23571;812;24;0;0;0;0;.00nan;0;0
23571;1149;12;0;0;0;0;.00nan;0;0
23571;1278;12;73;27;2;25;.926;3600000;0
23439;318;22;0;0;0;0;.00nan;0;0
23439;1163;0;0;0;0;0;.00nan;0;0
23439;2033;51;49;26;4;22;.846;3578000;0
23439;2804;0;75;30;2;28;.933;3600000;0
23672;419;20;86;33;2;31;.939;3600000;0
23672;707;20;0;0;0;0;.00nan;0;0
23672;783;11;62;29;4;25;.862;3525000;0
23672;2810;11;0;0;0;0;.00nan;0;0
23499;277;10;0;0;0;0;.00nan;0;0
23499;691;10;55;32;4;28;.875;3762000;0
23499;998;8;77;48;5;43;.896;3755000;0
23499;2266;8;0;0;0;0;.00nan;0;0
23407;505;17;62;33;4;29;.879;3600000;0
23407;737;23;0;0;0;0;.00nan;0;0
23407;1333;17;0;0;0;0;.00nan;0;0
23407;2375;23;93;40;3;37;.925;3600000;0
23485;13;7;0;0;0;0;.00nan;0;0
23485;316;7;64;36;3;33;.917;3544000;0
23485;360;16;87;38;2;36;.947;3600000;0
23485;2687;16;0;0;0;0;.00nan;0;0
23445;737;23;86;39;3;36;.923;3600000;0
23445;998;8;29;24;6;18;.750;2448000;0
23445;2266;8;51;8;1;7;.875;1152000;0
23445;2375;23;0;0;0;0;.00nan;0;0
23965;735;5;0;0;0;0;.00nan;0;0
23965;783;11;0;0;0;0;.00nan;0;0
23965;1361;5;98;26;1;25;.962;3600000;0
23965;2810;11;85;31;2;29;.935;3600000;0
23457;727;4;84;33;2;31;.939;3600000;0
23457;1335;4;0;0;0;0;.00nan;0;0
23457;2174;18;60;27;3;24;.889;3550000;0
23457;2314;18;0;0;0;0;.00nan;0;0
23442;419;20;0;0;0;0;.00nan;0;0
23442;707;20;69;45;5;40;.889;3554000;0
23442;1052;9;0;0;0;0;.00nan;0;0
23442;1332;9;57;33;4;29;.879;3600000;0
23639;710;26;0;0;0;0;.00nan;0;0
23639;711;3;0;0;0;0;.00nan;0;0
23639;1239;26;75;28;2;26;.929;3869000;0
23639;1731;3;92;49;3;46;.939;3869000;0
23463;360;16;79;32;3;29;.906;3600000;0
23463;734;2;0;0;0;0;.00nan;0;0
23463;1355;2;82;22;1;21;.955;3600000;0
23463;2687;16;0;0;0;0;.00nan;0;0
23583;268;1;0;0;0;0;.00nan;0;0
23583;429;28;52;14;1;13;.929;2516000;0
23583;1061;28;29;15;4;11;.733;1033000;0
23583;2800;1;63;34;4;30;.882;3600000;0
23462;277;10;79;17;0;17;1.000;3600000;0
23462;691;10;0;0;0;0;.00nan;0;0
23462;1221;25;0;0;0;0;.00nan;0;0
23462;2269;25;69;47;5;42;.894;3600000;0
23640;103;30;30;27;5;22;.815;3600000;0
23640;2016;14;100;38;0;38;1.000;3600000;0
23640;2057;14;0;0;0;0;.00nan;0;0
23640;2549;30;0;0;0;0;.00nan;0;0
23593;0;48;90;45;3;42;.933;3005000;0
23593;1021;15;85;15;0;15;1.000;3600000;0
23593;1128;15;0;0;0;0;.00nan;0;0
23593;2947;29;26;7;3;4;.571;595000;0
23602;482;6;0;0;0;0;.00nan;0;0
23602;483;6;75;30;2;28;.933;3600000;0
23602;505;17;43;4;1;3;.750;617000;0
23602;1333;17;36;31;6;25;.806;2983000;0
23509;112;13;76;31;3;28;.903;3734000;0
23509;714;13;0;0;0;0;.00nan;0;0
23509;2174;18;0;0;0;0;.00nan;0;0
23509;2314;18;83;37;4;33;.892;3734000;0
23860;268;1;0;0;0;0;.00nan;0;0
23860;489;19;0;0;0;0;.00nan;0;0
23860;1056;19;91;39;2;37;.949;3600000;0
23860;2800;1;61;28;3;25;.893;3554000;0
23502;734;2;100;39;1;38;.974;3600000;0
23502;1163;0;0;0;0;0;.00nan;0;0
23502;1355;2;0;0;0;0;.00nan;0;0
23502;2804;0;66;34;4;30;.882;3600000;0
23614;429;28;0;0;0;0;.00nan;0;0
23614;487;27;0;0;0;0;.00nan;0;0
23614;1061;28;62;30;3;27;.900;3600000;0
23614;2557;27;55;31;4;27;.871;3566000;0
23460;318;22;67;19;1;18;.947;3600000;0
23460;1052;9;30;27;6;21;.778;2031000;0
23460;1332;9;63;15;1;14;.933;1569000;0
23460;2033;51;0;0;0;0;.00nan;0;0
23537;295;24;0;0;0;0;.00nan;0;0
23537;812;24;100;37;0;37;1.000;3600000;0
23537;1406;21;62;42;5;37;.881;3600000;0
23537;1690;21;0;0;0;0;.00nan;0;0
23645;13;7;0;0;0;0;.00nan;0;0
23645;316;7;73;21;1;20;.952;3600000;0
23645;482;6;67;41;4;37;.902;3600000;0
23645;483;6;0;0;0;0;.00nan;0;0
23648;103;30;0;0;0;0;.00nan;0;0
23648;1149;12;61;38;5;33;.868;3600000;0
23648;1278;12;0;0;0;0;.00nan;0;0
23648;2549;30;59;21;2;19;.905;3600000;0
23555;710;26;59;33;4;29;.879;3600000;0
23555;1221;25;99;34;1;33;.971;3600000;0
23555;1239;26;0;0;0;0;.00nan;0;0
23555;2269;25;0;0;0;0;.00nan;0;0
23494;727;4;76;40;3;37;.925;3570000;0
23494;1021;15;89;29;1;28;.966;3600000;0
23494;1128;15;0;0;0;0;.00nan;0;0
23494;1335;4;0;0;0;0;.00nan;0;0
23597;711;3;0;0;0;0;.00nan;0;0
23597;1731;3;79;36;3;33;.917;3900000;0
23597;2834;29;0;0;0;0;.00nan;0;0
23597;2947;29;68;37;3;34;.919;3900000;0
23447;737;23;0;0;0;0;.00nan;0;0
23447;1021;15;0;0;0;0;.00nan;0;0
23447;1128;15;78;37;3;34;.919;3600000;0
23447;2375;23;63;35;4;31;.886;3600000;0
23513;268;1;0;0;0;0;.00nan;0;0
23513;1221;25;0;0;0;0;.00nan;0;0
23513;2269;25;89;36;2;34;.944;3561000;0
23513;2800;1;100;36;1;35;.972;3600000;0
23534;783;11;81;33;3;30;.909;3600000;0
23534;998;8;69;49;5;44;.898;3582000;0
23534;2266;8;0;0;0;0;.00nan;0;0
23534;2810;11;0;0;0;0;.00nan;0;0
23596;295;24;0;0;0;0;.00nan;0;0
23596;735;5;0;0;0;0;.00nan;0;0
23596;812;24;87;44;3;41;.932;3600000;0
23596;1361;5;73;43;4;39;.907;3522000;0
23992;13;7;51;2;0;2;1.000;589000;0
23992;316;7;26;24;6;18;.750;3011000;0
23992;734;2;0;0;0;0;.00nan;0;0
23992;1355;2;90;29;1;28;.966;3600000;0
23612;482;6;0;0;0;0;.00nan;0;0
23612;483;6;68;24;2;22;.917;3600000;0
23612;2834;29;87;45;3;42;.933;3596000;0
23612;2947;29;0;0;0;0;.00nan;0;0
23541;487;27;0;0;0;0;.00nan;0;0
23541;1149;12;0;0;0;0;.00nan;0;0
23541;1278;12;73;23;1;22;.957;3600000;0
23541;2557;27;100;44;0;44;1.000;3600000;0
23461;505;17;58;33;4;29;.879;3600000;0
23461;727;4;69;10;0;10;1.000;1591000;0
23461;1333;17;0;0;0;0;.00nan;0;0
23461;1335;4;48;33;5;28;.848;2009000;0
23479;103;30;67;21;1;20;.952;3600000;0
23479;112;13;88;43;3;40;.930;3553000;0
23479;714;13;0;0;0;0;.00nan;0;0
23479;2549;30;0;0;0;0;.00nan;0;0
23690;419;20;83;43;3;40;.930;3515000;0
23690;707;20;0;0;0;0;.00nan;0;0
23690;711;3;96;34;1;33;.971;3600000;0
23690;1731;3;0;0;0;0;.00nan;0;0
23586;318;22;0;0;0;0;.00nan;0;0
23586;429;28;0;0;0;0;.00nan;0;0
23586;1061;28;74;43;3;40;.930;3900000;0
23586;2033;51;100;45;3;42;.933;3900000;0
23444;277;10;82;11;0;11;1.000;3600000;0
23444;691;10;0;0;0;0;.00nan;0;0
23444;1163;0;97;55;2;53;.964;3600000;0
23444;2804;0;0;0;0;0;.00nan;0;0
23713;318;22;73;26;2;24;.923;3799000;0
23713;1406;21;0;0;0;0;.00nan;0;0
23713;1690;21;98;39;1;38;.974;3799000;0
23713;2033;51;0;0;0;0;.00nan;0;0
23701;295;24;94;34;2;32;.941;3900000;0
23701;429;28;74;32;2;30;.938;3900000;0
23701;812;24;0;0;0;0;.00nan;0;0
23701;1061;28;0;0;0;0;.00nan;0;0
23647;419;20;0;0;0;0;.00nan;0;0
23647;487;27;0;0;0;0;.00nan;0;0
23647;707;20;75;42;4;38;.905;3900000;0
23647;2557;27;79;40;4;36;.900;3900000;0
23506;1163;0;0;0;0;0;.00nan;0;0
23506;2174;18;0;0;0;0;.00nan;0;0
23506;2314;18;94;37;3;34;.919;3665000;0
23506;2804;0;97;31;2;29;.935;3665000;0
23489;727;4;0;0;0;0;.00nan;0;0
23489;1221;25;78;28;2;26;.929;3600000;0
23489;1335;4;95;52;3;49;.942;3577000;0
23489;2269;25;0;0;0;0;.00nan;0;0
23720;783;11;95;37;2;35;.946;3600000;0
23720;2016;14;96;34;1;33;.971;3600000;0
23720;2057;14;0;0;0;0;.00nan;0;0
23720;2810;11;0;0;0;0;.00nan;0;0
23545;998;8;35;34;6;28;.824;2588000;0
23545;2174;18;54;24;3;21;.875;3600000;0
23545;2266;8;25;13;4;9;.692;1012000;0
23545;2314;18;0;0;0;0;.00nan;0;0
23456;489;19;0;0;0;0;.00nan;0;0
23456;1052;9;0;0;0;0;.00nan;0;0
23456;1056;19;84;35;3;32;.914;3600000;0
23456;1332;9;77;46;5;41;.891;3569000;0
23477;277;10;94;21;0;21;1.000;3600000;0
23477;691;10;0;0;0;0;.00nan;0;0
23477;737;23;0;0;0;0;.00nan;0;0
23477;2375;23;56;38;4;34;.895;3600000;0
23601;1149;12;100;32;0;32;1.000;3600000;0
23601;1278;12;0;0;0;0;.00nan;0;0
23601;1406;21;60;34;4;30;.882;3600000;0
23601;1690;21;0;0;0;0;.00nan;0;0
23521;103;30;34;22;5;17;.773;3600000;0
23521;360;16;0;0;0;0;.00nan;0;0
23521;2549;30;0;0;0;0;.00nan;0;0
23521;2687;16;92;34;2;32;.941;3600000;0
23587;112;13;0;0;0;0;.00nan;0;0
23587;714;13;91;46;3;43;.935;3900000;0
23587;735;5;0;0;0;0;.00nan;0;0
23587;1361;5;74;30;3;27;.900;3900000;0
23540;505;17;44;35;5;30;.857;3600000;0
23540;734;2;0;0;0;0;.00nan;0;0
23540;1333;17;0;0;0;0;.00nan;0;0
23540;1355;2;88;27;1;26;.963;3600000;0
23719;13;7;46;42;7;35;.833;3600000;0
23719;316;7;0;0;0;0;.00nan;0;0
23719;318;22;0;0;0;0;.00nan;0;0
23719;2033;51;94;31;2;29;.935;3600000;0
23490;360;16;70;38;4;34;.895;3581000;0
23490;482;6;0;0;0;0;.00nan;0;0
23490;483;6;84;34;3;31;.912;3600000;0
23490;2687;16;0;0;0;0;.00nan;0;0
23592;489;19;83;49;4;45;.918;3517000;0
23592;1056;19;0;0;0;0;.00nan;0;0
23592;1163;0;99;42;2;40;.952;3600000;0
23592;2804;0;0;0;0;0;.00nan;0;0
23625;487;27;0;0;0;0;.00nan;0;0
23625;710;26;0;0;0;0;.00nan;0;0
23625;1239;26;90;41;2;39;.951;3576000;0
23625;2557;27;92;37;1;36;.973;3600000;0
23550;277;10;71;17;1;16;.941;3600000;0
23550;691;10;0;0;0;0;.00nan;0;0
23550;2834;29;67;48;5;43;.896;3600000;0
23550;2947;29;0;0;0;0;.00nan;0;0
23591;112;13;66;29;3;26;.897;3600000;0
23591;714;13;0;0;0;0;.00nan;0;0
23591;2016;14;0;0;0;0;.00nan;0;0
23591;2057;14;65;36;4;32;.889;3598000;0
23496;429;28;0;0;0;0;.00nan;0;0
23496;737;23;0;0;0;0;.00nan;0;0
23496;1061;28;86;24;1;23;.958;3600000;0
23496;2375;23;86;56;5;51;.911;3600000;0
23556;482;6;80;33;2;31;.939;3600000;0
23556;483;6;0;0;0;0;.00nan;0;0
23556;998;8;40;18;4;14;.778;1061000;0
23556;2266;8;93;32;1;31;.969;2539000;0
23707;268;1;0;0;0;0;.00nan;0;0
23707;505;17;0;0;0;0;.00nan;0;0
23707;1333;17;100;29;1;28;.966;3600000;0
23707;2800;1;73;26;2;24;.923;3568000;0
23729;1021;15;67;29;2;27;.931;3600000;0
23729;1128;15;0;0;0;0;.00nan;0;0
23729;1406;21;75;39;3;36;.923;3568000;0
23729;1690;21;0;0;0;0;.00nan;0;0
23471;103;30;94;32;1;31;.969;3600000;0
23471;1052;9;0;0;0;0;.00nan;0;0
23471;1332;9;68;34;3;31;.912;3589000;0
23471;2549;30;0;0;0;0;.00nan;0;0
23649;710;26;91;45;3;42;.933;3755000;0
23649;1239;26;0;0;0;0;.00nan;0;0
23649;1278;12;0;0;0;0;.00nan;0;0
23649;2081;56;64;24;2;22;.917;3755000;0
24062;13;7;0;0;0;0;.00nan;0;0
24062;295;24;0;0;0;0;.00nan;0;0
24062;316;7;93;31;1;30;.968;3600000;0
24062;812;24;56;23;2;21;.913;3560000;0
23730;419;20;48;46;7;39;.848;3600000;0
23730;707;20;0;0;0;0;.00nan;0;0
23730;783;11;49;22;4;18;.818;3600000;0
23730;2810;11;0;0;0;0;.00nan;0;0
23482;735;5;0;0;0;0;.00nan;0;0
23482;1052;9;85;34;2;32;.941;3574000;0
23482;1332;9;0;0;0;0;.00nan;0;0
23482;1361;5;90;33;1;32;.970;3600000;0
23717;489;19;0;0;0;0;.00nan;0;0
23717;711;3;0;0;0;0;.00nan;0;0
23717;1056;19;65;18;1;17;.944;3600000;0
23717;1731;3;80;51;4;47;.922;3600000;0
23530;360;16;57;32;4;28;.875;3533000;0
23530;2174;18;0;0;0;0;.00nan;0;0
23530;2687;16;0;0;0;0;.00nan;0;0
23530;5791;59;63;20;2;18;.900;3600000;0
23763;295;24;0;0;0;0;.00nan;0;0
23763;710;26;69;14;0;14;1.000;590000;0
23763;812;24;98;48;3;45;.938;3600000;0
23763;1239;26;9;35;9;26;.743;3010000;0
23560;734;2;0;0;0;0;.00nan;0;0
23560;1221;25;100;42;2;40;.952;3900000;0
23560;1355;2;85;32;2;30;.938;3900000;0
23560;2269;25;0;0;0;0;.00nan;0;0
23605;112;13;91;37;3;34;.919;3900000;0
23605;714;13;0;0;0;0;.00nan;0;0
23605;1278;12;85;43;3;40;.930;3900000;0
23605;2081;56;0;0;0;0;.00nan;0;0
23877;268;1;0;0;0;0;.00nan;0;0
23877;429;28;0;0;0;0;.00nan;0;0
23877;1061;28;58;28;4;24;.857;3600000;0
23877;2800;1;53;17;3;14;.824;3600000;0
23519;737;23;0;0;0;0;.00nan;0;0
23519;1163;0;81;32;2;30;.938;3900000;0
23519;2375;23;76;30;2;28;.933;3900000;0
23519;2804;0;0;0;0;0;.00nan;0;0
23673;487;27;0;0;0;0;.00nan;0;0
23673;2174;18;70;38;4;34;.895;3600000;0
23673;2557;27;42;32;5;27;.844;3548000;0
23673;5791;59;0;0;0;0;.00nan;0;0
23613;998;8;0;0;0;0;.00nan;0;0
23613;1021;15;50;0;0;0;.00nan;60000;0
23613;1128;15;74;25;2;23;.920;3540000;0
23613;2266;8;78;52;5;47;.904;3600000;0
23529;318;22;0;0;0;0;.00nan;0;0
23529;727;4;44;29;5;24;.828;3678000;0
23529;1335;4;0;0;0;0;.00nan;0;0
23529;2033;51;53;41;6;35;.854;3678000;0
23658;482;6;0;0;0;0;.00nan;0;0
23658;483;6;68;45;4;41;.911;3583000;0
23658;505;17;52;16;2;14;.875;3600000;0
23658;1333;17;0;0;0;0;.00nan;0;0
23546;360;16;89;18;0;18;1.000;3600000;0
23546;711;3;0;0;0;0;.00nan;0;0
23546;1731;3;59;41;5;36;.878;3600000;0
23546;2687;16;0;0;0;0;.00nan;0;0
23514;734;2;85;36;2;34;.944;3600000;0
23514;737;23;72;39;4;35;.897;3600000;0
23514;1355;2;0;0;0;0;.00nan;0;0
23514;2375;23;0;0;0;0;.00nan;0;0
23700;103;30;76;26;1;25;.962;3600000;0
23700;2016;14;0;0;0;0;.00nan;0;0
23700;2057;14;97;52;2;50;.962;3591000;0
23700;2549;30;0;0;0;0;.00nan;0;0
23735;268;1;55;35;5;30;.857;3900000;0
23735;783;11;0;0;0;0;.00nan;0;0
23735;2800;1;0;0;0;0;.00nan;0;0
23735;2810;11;69;39;5;34;.872;3900000;0
23565;419;20;65;46;6;40;.870;3186000;0
23565;707;20;54;10;1;9;.900;414000;0
23565;1221;25;0;0;0;0;.00nan;0;0
23565;2269;25;97;35;1;34;.971;3600000;0
23523;112;13;0;0;0;0;.00nan;0;0
23523;714;13;88;35;2;33;.943;3600000;0
23523;1052;9;0;0;0;0;.00nan;0;0
23523;1332;9;89;51;4;47;.922;3562000;0
23616;1128;15;0;0;0;0;.00nan;0;0
23616;2751;50;97;29;0;29;1.000;3900000;0
23616;2834;29;100;36;0;36;1.000;3900000;0
23616;2947;29;0;0;0;0;.00nan;0;0
23535;429;28;76;33;3;30;.909;3600000;0
23535;727;4;72;20;1;19;.950;1493000;0
23535;1061;28;0;0;0;0;.00nan;0;0
23535;1335;4;34;29;6;23;.793;2107000;0
23538;489;19;0;0;0;0;.00nan;0;0
23538;1052;9;35;34;6;28;.824;1779000;0
23538;1056;19;63;19;2;17;.895;3600000;0
23538;1332;9;81;27;1;26;.963;1821000;0
23600;487;27;0;0;0;0;.00nan;0;0
23600;735;5;0;0;0;0;.00nan;0;0
23600;1361;5;50;34;5;29;.853;3543000;0
23600;2557;27;87;48;4;44;.917;3600000;0
23626;360;16;66;29;3;26;.897;3600000;0
23626;1278;12;32;28;6;22;.786;3401000;0
23626;2081;56;52;2;0;2;1.000;199000;0
23626;2687;16;0;0;0;0;.00nan;0;0
23590;998;8;93;54;4;50;.926;3600000;0
23590;1163;0;33;23;5;18;.783;3585000;0
23590;2266;8;0;0;0;0;.00nan;0;0
23590;2804;0;0;0;0;0;.00nan;0;0
23796;13;7;74;22;2;20;.909;3600000;0
23796;316;7;0;0;0;0;.00nan;0;0
23796;710;26;0;0;0;0;.00nan;0;0
23796;1239;26;70;33;3;30;.909;3600000;0
23739;735;5;57;37;4;33;.892;3900000;0
23739;1361;5;0;0;0;0;.00nan;0;0
23739;2016;14;0;0;0;0;.00nan;0;0
23739;2057;14;48;30;4;26;.867;3900000;0
23650;419;20;63;44;5;39;.886;3627000;0
23650;482;6;0;0;0;0;.00nan;0;0
23650;483;6;53;35;4;31;.886;3627000;0
23650;707;20;0;0;0;0;.00nan;0;0
23547;277;10;0;0;0;0;.00nan;0;0
23547;691;10;69;16;1;15;.938;3600000;0
23547;737;23;0;0;0;0;.00nan;0;0
23547;2375;23;62;29;3;26;.897;3534000;0
23675;112;13;62;57;8;49;.860;3126000;0
23675;295;24;0;0;0;0;.00nan;0;0
23675;714;13;47;6;1;5;.833;474000;0
23675;812;24;65;20;2;18;.900;3600000;0
23620;318;22;0;0;0;0;.00nan;0;0
23620;1036;22;70;39;4;35;.897;3557000;0
23620;2834;29;67;35;3;32;.914;3600000;0
23620;2947;29;0;0;0;0;.00nan;0;0
23704;103;30;75;30;3;27;.900;3550000;0
23704;1128;15;0;0;0;0;.00nan;0;0
23704;2549;30;0;0;0;0;.00nan;0;0
23704;2751;50;100;37;1;36;.973;3600000;0
23609;489;19;62;26;3;23;.885;3600000;0
23609;783;11;65;36;4;32;.889;3549000;0
23609;1056;19;0;0;0;0;.00nan;0;0
23609;2810;11;0;0;0;0;.00nan;0;0
23572;1221;25;83;36;3;33;.917;3600000;0
23572;1406;21;0;0;0;0;.00nan;0;0
23572;1690;21;40;32;5;27;.844;3527000;0
23572;2269;25;0;0;0;0;.00nan;0;0
23525;429;28;0;0;0;0;.00nan;0;0
23525;727;4;74;37;3;34;.919;3794000;0
23525;1061;28;95;42;2;40;.952;3794000;0
23525;1335;4;0;0;0;0;.00nan;0;0
23667;268;1;0;0;0;0;.00nan;0;0
23667;487;27;50;32;5;27;.844;3600000;0
23667;2557;27;0;0;0;0;.00nan;0;0
23667;2800;1;100;34;0;34;1.000;3600000;0
23839;295;24;94;30;1;29;.967;3600000;0
23839;318;22;60;32;4;28;.875;3600000;0
23839;812;24;0;0;0;0;.00nan;0;0
23839;1036;22;0;0;0;0;.00nan;0;0
23584;277;10;27;21;5;16;.762;2355000;0
23584;505;17;0;0;0;0;.00nan;0;0
23584;691;10;51;2;0;2;1.000;1191000;0
23584;1333;17;89;45;4;41;.911;3600000;0
23715;710;26;0;0;0;0;.00nan;0;0
23715;711;3;0;0;0;0;.00nan;0;0
23715;1239;26;54;30;4;26;.867;3600000;0
23715;1731;3;88;30;1;29;.967;3600000;0
23657;1278;12;0;0;0;0;.00nan;0;0
23657;2081;56;70;35;4;31;.886;3600000;0
23657;2834;29;0;0;0;0;.00nan;0;0
23657;2947;29;52;37;5;32;.865;3600000;0
23563;429;28;99;42;1;41;.976;3600000;0
23563;737;23;87;32;2;30;.938;3579000;0
23563;1061;28;0;0;0;0;.00nan;0;0
23563;2375;23;0;0;0;0;.00nan;0;0
23778;2016;14;69;30;3;27;.900;3900000;0
23778;2057;14;0;0;0;0;.00nan;0;0
23778;2174;18;0;0;0;0;.00nan;0;0
23778;5791;59;74;40;3;37;.925;3900000;0
23746;103;30;91;35;2;33;.943;3576000;0
23746;489;19;0;0;0;0;.00nan;0;0
23746;1056;19;100;34;0;34;1.000;3600000;0
23746;2549;30;0;0;0;0;.00nan;0;0
23615;1163;0;73;37;3;34;.919;3548000;0
23615;1406;21;72;30;2;28;.933;3600000;0
23615;1690;21;0;0;0;0;.00nan;0;0
23615;2804;0;0;0;0;0;.00nan;0;0
23829;268;1;0;0;0;0;.00nan;0;0
23829;505;17;0;0;0;0;.00nan;0;0
23829;1333;17;80;24;1;23;.958;3900000;0
23829;2800;1;98;45;1;44;.978;3900000;0
23543;360;16;72;40;4;36;.900;3594000;0
23543;1052;9;0;0;0;0;.00nan;0;0
23543;1332;9;83;34;2;32;.941;3600000;0
23543;2687;16;0;0;0;0;.00nan;0;0
24015;735;5;0;0;0;0;.00nan;0;0
24015;783;11;100;39;1;38;.974;3600000;0
24015;1361;5;64;28;3;25;.893;3569000;0
24015;2810;11;0;0;0;0;.00nan;0;0
23635;998;8;53;41;6;35;.854;3598000;0
23635;2174;18;0;0;0;0;.00nan;0;0
23635;2266;8;50;0;0;0;.00nan;2000;0
23635;2314;18;73;20;1;19;.950;3600000;0
23794;419;20;100;33;0;33;1.000;3600000;0
23794;707;20;0;0;0;0;.00nan;0;0
23794;711;3;0;0;0;0;.00nan;0;0
23794;1731;3;65;30;3;27;.900;3600000;0
23599;277;10;0;0;0;0;.00nan;0;0
23599;691;10;40;23;5;18;.783;3609000;0
23599;734;2;0;0;0;0;.00nan;0;0
23599;1355;2;59;33;4;29;.879;3587000;0
23674;482;6;0;0;0;0;.00nan;0;0
23674;483;6;62;27;3;24;.889;3900000;0
23674;1406;21;0;0;0;0;.00nan;0;0
23674;1690;21;90;48;3;45;.938;3900000;0
23564;13;7;0;0;0;0;.00nan;0;0
23564;316;7;83;33;2;31;.939;3600000;0
23564;737;23;55;21;3;18;.857;3600000;0
23564;2375;23;0;0;0;0;.00nan;0;0
23765;318;22;0;0;0;0;.00nan;0;0
23765;1036;22;65;34;4;30;.882;3600000;0
23765;2174;18;60;27;3;24;.889;3600000;0
23765;2314;18;0;0;0;0;.00nan;0;0
23617;277;10;77;33;2;31;.939;3900000;0
23617;691;10;0;0;0;0;.00nan;0;0
23617;1128;15;0;0;0;0;.00nan;0;0
23617;2751;50;100;36;2;34;.944;3900000;0
23731;505;17;72;29;3;26;.897;3900000;0
23731;1333;17;0;0;0;0;.00nan;0;0
23731;2834;29;90;52;3;49;.942;3900000;0
23731;2947;29;0;0;0;0;.00nan;0;0
23608;419;20;82;48;4;44;.917;3600000;0
23608;707;20;0;0;0;0;.00nan;0;0
23608;1052;9;80;45;4;41;.911;3295000;0
23608;1332;9;22;5;3;2;.400;305000;0
23902;268;1;0;0;0;0;.00nan;0;0
23902;735;5;0;0;0;0;.00nan;0;0
23902;1361;5;53;23;4;19;.826;3541000;0
23902;2800;1;100;46;2;44;.957;3600000;0
23705;482;6;69;41;3;38;.927;3600000;0
23705;483;6;0;0;0;0;.00nan;0;0
23705;2016;14;48;0;0;0;.00nan;92000;0
23705;2057;14;64;40;6;34;.850;3508000;0
23607;727;4;91;28;1;27;.964;3600000;0
23607;1149;12;65;35;4;31;.886;3600000;0
23607;1278;12;0;0;0;0;.00nan;0;0
23607;1335;4;0;0;0;0;.00nan;0;0
23651;13;7;84;25;2;23;.920;3650000;0
23651;316;7;0;0;0;0;.00nan;0;0
23651;360;16;97;41;1;40;.976;3650000;0
23651;2687;16;0;0;0;0;.00nan;0;0
23709;505;17;0;0;0;0;.00nan;0;0
23709;1128;15;74;29;2;27;.931;3563000;0
23709;1333;17;100;33;0;33;1.000;3600000;0
23709;2751;50;0;0;0;0;.00nan;0;0
23643;489;19;0;0;0;0;.00nan;0;0
23643;998;8;100;48;2;46;.958;3600000;0
23643;1056;19;80;39;5;34;.872;3600000;0
23643;2266;8;0;0;0;0;.00nan;0;0
23618;487;27;51;1;0;1;1.000;45000;0
23618;1052;9;0;0;0;0;.00nan;0;0
23618;1332;9;99;53;2;51;.962;3600000;0
23618;2557;27;22;32;7;25;.781;3555000;0
23682;711;3;0;0;0;0;.00nan;0;0
23682;1731;3;65;30;3;27;.900;3600000;0
23682;2834;29;48;0;0;0;.00nan;105000;0
23682;2947;29;51;41;6;35;.854;3495000;0
23562;737;23;0;0;0;0;.00nan;0;0
23562;783;11;77;38;4;34;.895;3513000;0
23562;2375;23;89;42;2;40;.952;3600000;0
23562;2810;11;0;0;0;0;.00nan;0;0
23817;112;13;73;45;4;41;.911;3570000;0
23817;268;1;81;32;2;30;.938;3600000;0
23817;714;13;0;0;0;0;.00nan;0;0
23817;2800;1;0;0;0;0;.00nan;0;0
23684;103;30;31;32;6;26;.813;3555000;0
23684;1406;21;82;52;5;47;.904;3600000;0
23684;1690;21;0;0;0;0;.00nan;0;0
23684;2549;30;0;0;0;0;.00nan;0;0
23644;734;2;0;0;0;0;.00nan;0;0
23644;1163;0;93;30;1;29;.967;3600000;0
23644;1355;2;62;34;4;30;.882;3600000;0
23644;2804;0;0;0;0;0;.00nan;0;0
23632;295;24;0;0;0;0;.00nan;0;0
23632;812;24;92;33;1;32;.970;3900000;0
23632;1221;25;87;33;1;32;.970;3900000;0
23632;2269;25;0;0;0;0;.00nan;0;0
23637;295;24;50;35;5;30;.857;3600000;0
23637;727;4;0;0;0;0;.00nan;0;0
23637;812;24;0;0;0;0;.00nan;0;0
23637;1335;4;79;31;2;29;.935;3600000;0
23655;277;10;0;0;0;0;.00nan;0;0
23655;691;10;79;32;3;29;.906;3600000;0
23655;710;26;0;0;0;0;.00nan;0;0
23655;1239;26;40;20;4;16;.800;3568000;0
23697;487;27;28;21;5;16;.762;3600000;0
23697;489;19;100;36;0;36;1.000;3600000;0
23697;1056;19;0;0;0;0;.00nan;0;0
23697;2557;27;0;0;0;0;.00nan;0;0
23677;1163;0;0;0;0;0;.00nan;0;0
23677;2016;14;0;0;0;0;.00nan;0;0
23677;2057;14;76;39;3;36;.923;3844000;0
23677;2804;0;70;29;4;25;.862;3844000;0
23665;482;6;0;0;0;0;.00nan;0;0
23665;483;6;62;31;3;28;.903;3600000;0
23665;1149;12;69;39;4;35;.897;3600000;0
23665;1278;12;0;0;0;0;.00nan;0;0
23734;735;5;72;32;3;29;.906;3600000;0
23734;998;8;82;44;4;40;.909;3600000;0
23734;1361;5;0;0;0;0;.00nan;0;0
23734;2266;8;0;0;0;0;.00nan;0;0
23544;505;17;0;0;0;0;.00nan;0;0
23544;1052;9;0;0;0;0;.00nan;0;0
23544;1332;9;62;37;5;32;.865;3600000;0
23544;1333;17;41;36;7;29;.806;3541000;0
23749;103;30;0;0;0;0;.00nan;0;0
23749;2549;30;42;34;5;29;.853;3583000;0
23749;2834;29;98;56;4;52;.929;3600000;0
23749;2947;29;0;0;0;0;.00nan;0;0
23759;711;3;0;0;0;0;.00nan;0;0
23759;1406;21;36;32;6;26;.813;2909000;0
23759;1690;21;62;5;0;5;1.000;691000;0
23759;1731;3;43;31;5;26;.839;3600000;0
23660;419;20;100;33;0;33;1.000;3600000;0
23660;707;20;0;0;0;0;.00nan;0;0
23660;1221;25;37;12;3;9;.750;862000;0
23660;2269;25;55;42;6;36;.857;2738000;0
23569;734;2;50;35;5;30;.857;3837000;0
23569;737;23;0;0;0;0;.00nan;0;0
23569;1355;2;0;0;0;0;.00nan;0;0
23569;2375;23;37;27;6;21;.778;3837000;0
23646;360;16;59;9;1;8;.889;761000;0
23646;429;28;93;40;2;38;.950;3600000;0
23646;1061;28;0;0;0;0;.00nan;0;0
23646;2687;16;44;34;6;28;.824;2839000;0
23772;318;22;0;0;0;0;.00nan;0;0
23772;1036;22;76;36;3;33;.917;3900000;0
23772;2174;18;0;0;0;0;.00nan;0;0
23772;2314;18;72;36;3;33;.917;3900000;0
23786;112;13;98;41;2;39;.951;3600000;0
23786;711;3;40;26;5;21;.808;3600000;0
23786;714;13;0;0;0;0;.00nan;0;0
23786;1731;3;0;0;0;0;.00nan;0;0
23666;487;27;0;0;0;0;.00nan;0;0
23666;734;2;0;0;0;0;.00nan;0;0
23666;1355;2;80;23;1;22;.957;3600000;0
23666;2557;27;80;45;5;40;.889;3600000;0
23738;419;20;62;44;6;38;.864;3600000;0
23738;707;20;0;0;0;0;.00nan;0;0
23738;1128;15;0;0;0;0;.00nan;0;0
23738;2751;50;70;22;1;21;.955;3600000;0
23694;489;19;65;28;3;25;.893;3593000;0
23694;1056;19;0;0;0;0;.00nan;0;0
23694;1163;0;75;23;1;22;.957;3600000;0
23694;2804;0;0;0;0;0;.00nan;0;0
23623;482;6;54;43;6;37;.860;3549000;0
23623;483;6;50;0;0;0;.00nan;51000;0
23623;727;4;100;34;0;34;1.000;3600000;0
23623;1335;4;0;0;0;0;.00nan;0;0
23881;710;26;0;0;0;0;.00nan;0;0
23881;1239;26;83;26;1;25;.962;3600000;0
23881;1406;21;0;0;0;0;.00nan;0;0
23881;1690;21;97;41;2;39;.951;3600000;0
23653;318;22;99;43;1;42;.977;3600000;0
23653;360;16;52;27;4;23;.852;3600000;0
23653;1036;22;0;0;0;0;.00nan;0;0
23653;2687;16;0;0;0;0;.00nan;0;0
23670;1149;12;0;0;0;0;.00nan;0;0
23670;1278;12;90;49;2;47;.959;3600000;0
23670;2174;18;41;31;5;26;.839;3600000;0
23670;2314;18;0;0;0;0;.00nan;0;0
23753;103;30;45;29;5;24;.828;3600000;0
23753;295;24;59;9;0;9;1.000;776000;0
23753;812;24;34;28;6;22;.786;2791000;0
23753;2549;30;0;0;0;0;.00nan;0;0
23743;13;7;0;0;0;0;.00nan;0;0
23743;316;7;98;48;3;45;.938;3600000;0
23743;735;5;0;0;0;0;.00nan;0;0
23743;1361;5;94;22;0;22;1.000;3600000;0
23741;998;8;0;0;0;0;.00nan;0;0
23741;2016;14;0;0;0;0;.00nan;0;0
23741;2057;14;91;31;2;29;.935;3600000;0
23741;2266;8;78;42;4;38;.905;3567000;0
23659;277;10;0;0;0;0;.00nan;0;0
23659;691;10;49;17;3;14;.824;3600000;0
23659;710;26;17;7;4;3;.429;615000;0
23659;1239;26;82;36;2;34;.944;2985000;0
23671;268;1;0;0;0;0;.00nan;0;0
23671;429;28;65;26;2;24;.923;3545000;0
23671;1061;28;0;0;0;0;.00nan;0;0
23671;2800;1;99;39;1;38;.974;3600000;0
23683;429;28;0;0;0;0;.00nan;0;0
23683;1061;28;64;34;4;30;.882;3722000;0
23683;1221;25;90;44;3;41;.932;3722000;0
23683;2269;25;0;0;0;0;.00nan;0;0
23773;13;7;0;0;0;0;.00nan;0;0
23773;316;7;42;22;4;18;.818;3900000;0
23773;2834;29;76;43;4;39;.907;3900000;0
23773;2947;29;0;0;0;0;.00nan;0;0
23834;268;1;0;0;0;0;.00nan;0;0
23834;318;22;0;0;0;0;.00nan;0;0
23834;1036;22;57;30;4;26;.867;3600000;0
23834;2800;1;64;44;5;39;.886;3560000;0
23663;734;2;0;0;0;0;.00nan;0;0
23663;1052;9;0;0;0;0;.00nan;0;0
23663;1332;9;85;41;2;39;.951;3600000;0
23663;1355;2;99;33;1;32;.970;3600000;0
23808;112;13;80;17;1;16;.941;3600000;0
23808;482;6;0;0;0;0;.00nan;0;0
23808;483;6;75;37;3;34;.919;3569000;0
23808;714;13;0;0;0;0;.00nan;0;0
23710;1149;12;67;30;3;27;.900;3600000;0
23710;1278;12;0;0;0;0;.00nan;0;0
23710;1406;21;25;6;3;3;.500;536000;0
23710;1690;21;86;40;2;38;.950;3047000;0
23810;419;20;82;48;5;43;.896;3600000;0
23810;489;19;0;0;0;0;.00nan;0;0
23810;707;20;0;0;0;0;.00nan;0;0
23810;1056;19;62;22;2;20;.909;3600000;0
23699;727;4;30;33;7;26;.788;3600000;0
23699;783;11;98;55;3;52;.945;3600000;0
23699;1335;4;0;0;0;0;.00nan;0;0
23699;2810;11;0;0;0;0;.00nan;0;0
23994;360;16;73;34;3;31;.912;3600000;0
23994;2174;18;0;0;0;0;.00nan;0;0
23994;2314;18;76;28;2;26;.929;3600000;0
23994;2687;16;0;0;0;0;.00nan;0;0
23718;429;28;67;21;2;19;.905;3600000;0
23718;711;3;0;0;0;0;.00nan;0;0
23718;1061;28;0;0;0;0;.00nan;0;0
23718;1731;3;81;52;5;47;.904;3600000;0
23764;13;7;54;25;3;22;.880;3544000;0
23764;316;7;0;0;0;0;.00nan;0;0
23764;734;2;83;41;2;39;.951;3600000;0
23764;1355;2;0;0;0;0;.00nan;0;0
23822;295;24;78;33;2;31;.939;2939000;0
23822;419;20;0;0;0;0;.00nan;0;0
23822;707;20;67;31;3;28;.903;3600000;0
23822;812;24;12;4;4;0;.000;661000;0
23619;783;11;0;0;0;0;.00nan;0;0
23619;1052;9;80;30;2;28;.933;3831000;0
23619;1332;9;0;0;0;0;.00nan;0;0
23619;2810;11;92;45;3;42;.933;3831000;0
23575;737;23;56;39;5;34;.872;3600000;0
23575;1163;0;93;34;1;33;.971;3600000;0
23575;2375;23;0;0;0;0;.00nan;0;0
23575;2804;0;0;0;0;0;.00nan;0;0
23791;489;19;46;29;5;24;.828;3600000;0
23791;710;26;91;40;3;37;.925;3223000;0
23791;1056;19;0;0;0;0;.00nan;0;0
23791;1239;26;29;8;3;5;.625;352000;0
23669;360;16;0;0;0;0;.00nan;0;0
23669;1128;15;0;0;0;0;.00nan;0;0
23669;2687;16;56;41;5;36;.878;3597000;0
23669;2751;50;56;32;4;28;.875;3600000;0
23680;268;1;51;39;6;33;.846;3600000;0
23680;727;4;0;0;0;0;.00nan;0;0
23680;1335;4;80;25;1;24;.960;3600000;0
23680;2800;1;0;0;0;0;.00nan;0;0
23797;318;22;64;42;5;37;.881;3542000;0
23797;998;8;70;36;4;32;.889;3600000;0
23797;1036;22;0;0;0;0;.00nan;0;0
23797;2266;8;0;0;0;0;.00nan;0;0
23668;277;10;0;0;0;0;.00nan;0;0
23668;487;27;0;0;0;0;.00nan;0;0
23668;691;10;90;16;0;16;1.000;3600000;0
23668;2557;27;98;58;3;55;.948;3600000;0
23768;103;30;63;29;3;26;.897;3571000;0
23768;1406;21;87;44;3;41;.932;3873000;0
23768;1690;21;0;0;0;0;.00nan;0;0
23768;2549;30;52;7;0;7;1.000;329000;0
23698;505;17;0;0;0;0;.00nan;0;0
23698;1149;12;50;1;0;1;1.000;83000;0
23698;1278;12;32;33;6;27;.818;3517000;0
23698;1333;17;74;27;2;25;.926;3600000;0
23687;1221;25;56;21;3;18;.857;3600000;0
23687;2016;14;0;0;0;0;.00nan;0;0
23687;2057;14;98;62;5;57;.919;3534000;0
23687;2269;25;0;0;0;0;.00nan;0;0
23702;295;24;0;0;0;0;.00nan;0;0
23702;487;27;81;44;3;41;.932;3541000;0
23702;812;24;92;25;1;24;.960;3600000;0
23702;2557;27;0;0;0;0;.00nan;0;0
23728;429;28;0;0;0;0;.00nan;0;0
23728;1061;28;52;33;5;28;.848;3571000;0
23728;2834;29;66;31;3;28;.903;3600000;0
23728;2947;29;0;0;0;0;.00nan;0;0
23598;737;23;88;51;5;46;.902;3584000;0
23598;2174;18;0;0;0;0;.00nan;0;0
23598;2314;18;60;22;3;19;.864;3600000;0
23598;2375;23;0;0;0;0;.00nan;0;0
23747;268;1;0;0;0;0;.00nan;0;0
23747;1128;15;0;0;0;0;.00nan;0;0
23747;2751;50;56;28;4;24;.857;3547000;0
23747;2800;1;89;35;2;33;.943;3600000;0
23712;998;8;94;46;3;43;.935;3900000;0
23712;1221;25;68;29;3;26;.897;3900000;0
23712;2266;8;0;0;0;0;.00nan;0;0
23712;2269;25;0;0;0;0;.00nan;0;0
23652;1052;9;0;0;0;0;.00nan;0;0
23652;1163;0;68;20;1;19;.950;3600000;0
23652;1332;9;74;43;4;39;.907;3600000;0
23652;2804;0;0;0;0;0;.00nan;0;0
23641;711;3;0;0;0;0;.00nan;0;0
23641;727;4;81;25;1;24;.960;3600000;0
23641;1731;3;70;34;3;31;.912;3536000;0
23641;2846;41;0;0;0;0;.00nan;0;0
23676;360;16;86;26;1;25;.962;3600000;0
23676;783;11;70;39;4;35;.897;3600000;0
23676;2687;16;0;0;0;0;.00nan;0;0
23676;2810;11;0;0;0;0;.00nan;0;0
23792;489;19;87;39;3;36;.923;3600000;0
23792;1865;61;0;0;0;0;.00nan;0;0
23792;2016;14;0;0;0;0;.00nan;0;0
23792;2057;14;66;38;4;34;.895;3600000;0
23756;13;7;0;0;0;0;.00nan;0;0
23756;316;7;100;33;0;33;1.000;3600000;0
23756;2834;29;0;0;0;0;.00nan;0;0
23756;2947;29;61;28;3;25;.893;3600000;0
23679;277;10;0;0;0;0;.00nan;0;0
23679;691;10;90;15;0;15;1.000;3600000;0
23679;735;5;0;0;0;0;.00nan;0;0
23679;1361;5;78;54;5;49;.907;3600000;0
23754;482;6;0;0;0;0;.00nan;0;0
23754;483;6;64;30;3;27;.900;3600000;0
23754;1406;21;58;19;2;17;.895;1230000;0
23754;1690;21;15;31;7;24;.774;2370000;0
23847;419;20;45;33;6;27;.818;2350000;0
23847;482;6;66;37;3;34;.919;3600000;0
23847;483;6;0;0;0;0;.00nan;0;0
23847;707;20;54;15;2;13;.867;1250000;0
23867;710;26;0;0;0;0;.00nan;0;0
23867;1128;15;95;33;1;32;.970;3600000;0
23867;1239;26;90;42;4;38;.905;3600000;0
23867;2751;50;0;0;0;0;.00nan;0;0
23892;505;17;0;0;0;0;.00nan;0;0
23892;711;3;100;38;0;38;1.000;3600000;0
23892;1333;17;59;20;2;18;.900;3553000;0
23892;1731;3;0;0;0;0;.00nan;0;0
23627;735;5;84;27;1;26;.963;3600000;0
23627;737;23;0;0;0;0;.00nan;0;0
23627;1361;5;0;0;0;0;.00nan;0;0
23627;2375;23;82;36;3;33;.917;3580000;0
23803;734;2;0;0;0;0;.00nan;0;0
23803;1355;2;97;26;1;25;.962;3600000;0
23803;2016;14;84;43;3;40;.930;3584000;0
23803;2057;14;0;0;0;0;.00nan;0;0
23662;277;10;0;0;0;0;.00nan;0;0
23662;487;27;0;0;0;0;.00nan;0;0
23662;691;10;26;19;5;14;.737;3581000;0
23662;2557;27;90;49;3;46;.939;3600000;0
23706;112;13;99;30;1;29;.967;3600000;0
23706;714;13;0;0;0;0;.00nan;0;0
23706;1163;0;0;0;0;0;.00nan;0;0
23706;2804;0;82;36;3;33;.917;3569000;0
24056;103;30;59;49;7;42;.857;3600000;0
24056;318;22;0;0;0;0;.00nan;0;0
24056;1036;22;84;34;3;31;.912;3600000;0
24056;2549;30;0;0;0;0;.00nan;0;0
23681;360;16;85;30;1;29;.967;3600000;0
23681;710;26;0;0;0;0;.00nan;0;0
23681;1239;26;67;24;2;22;.917;3600000;0
23681;2687;16;0;0;0;0;.00nan;0;0
23733;998;8;67;23;2;21;.913;3537000;0
23733;1221;25;0;0;0;0;.00nan;0;0
23733;2266;8;0;0;0;0;.00nan;0;0
23733;2269;25;100;30;0;30;1.000;3600000;0
23916;103;30;0;0;0;0;.00nan;0;0
23916;505;17;57;31;3;28;.903;3545000;0
23916;1333;17;0;0;0;0;.00nan;0;0
23916;2549;30;93;38;2;36;.947;3600000;0
23821;112;13;0;0;0;0;.00nan;0;0
23821;714;13;85;45;4;41;.911;3592000;0
23821;1149;12;61;26;3;23;.885;3600000;0
23821;1278;12;0;0;0;0;.00nan;0;0
24120;734;2;80;30;2;28;.933;3600000;0
24120;1221;25;0;0;0;0;.00nan;0;0
24120;1355;2;0;0;0;0;.00nan;0;0
24120;2269;25;55;34;4;30;.882;3583000;0
23748;429;28;61;33;3;30;.909;3900000;0
23748;735;5;0;0;0;0;.00nan;0;0
23748;1061;28;0;0;0;0;.00nan;0;0
23748;1361;5;66;35;3;32;.914;3900000;0
23828;295;24;0;0;0;0;.00nan;0;0
23828;812;24;99;42;1;41;.976;3833000;0
23828;2174;18;74;33;2;31;.939;3833000;0
23828;2314;18;0;0;0;0;.00nan;0;0
23721;277;10;0;0;0;0;.00nan;0;0
23721;482;6;0;0;0;0;.00nan;0;0
23721;483;6;48;30;5;25;.833;3553000;0
23721;691;10;71;30;3;27;.900;3600000;0
23752;487;27;0;0;0;0;.00nan;0;0
23752;998;8;82;30;2;28;.933;3900000;0
23752;2266;8;0;0;0;0;.00nan;0;0
23752;2557;27;79;37;2;35;.946;3900000;0
23737;710;26;0;0;0;0;.00nan;0;0
23737;1163;0;70;40;5;35;.875;3574000;0
23737;1239;26;64;32;4;28;.875;3600000;0
23737;2804;0;0;0;0;0;.00nan;0;0
23836;13;7;0;0;0;0;.00nan;0;0
23836;316;7;71;22;1;21;.955;3600000;0
23836;489;19;52;44;6;38;.864;3600000;0
23836;1865;61;0;0;0;0;.00nan;0;0
23689;318;22;0;0;0;0;.00nan;0;0
23689;1036;22;55;45;6;39;.867;3545000;0
23689;1052;9;0;0;0;0;.00nan;0;0
23689;1332;9;52;30;5;25;.833;3600000;0
23708;103;30;100;45;1;44;.978;3600000;0
23708;727;4;67;26;2;24;.923;3556000;0
23708;2549;30;0;0;0;0;.00nan;0;0
23708;2846;41;0;0;0;0;.00nan;0;0
23842;1149;12;62;22;3;19;.864;3600000;0
23842;1278;12;0;0;0;0;.00nan;0;0
23842;2016;14;0;0;0;0;.00nan;0;0
23842;2057;14;57;37;5;32;.865;3531000;0
23661;268;1;0;0;0;0;.00nan;0;0
23661;737;23;0;0;0;0;.00nan;0;0
23661;2375;23;55;25;4;21;.840;3900000;0
23661;2800;1;97;55;4;51;.927;3900000;0
23631;737;23;74;35;2;33;.943;3568000;0
23631;1406;21;89;27;1;26;.963;3600000;0
23631;1690;21;0;0;0;0;.00nan;0;0
23631;2375;23;0;0;0;0;.00nan;0;0
23693;112;13;50;43;6;37;.860;3480000;0
23693;277;10;73;24;2;22;.917;3600000;0
23693;691;10;0;0;0;0;.00nan;0;0
23693;714;13;44;4;1;3;.750;120000;0
23996;103;30;0;0;0;0;.00nan;0;0
23996;419;20;94;35;1;34;.971;3600000;0
23996;707;20;0;0;0;0;.00nan;0;0
23996;2549;30;48;24;4;20;.833;3600000;0
23714;727;4;0;0;0;0;.00nan;0;0
23714;783;11;86;38;3;35;.921;3600000;0
23714;2810;11;0;0;0;0;.00nan;0;0
23714;2846;41;56;36;5;31;.861;3588000;0
23745;429;28;58;25;3;22;.880;3608000;0
23745;487;27;93;40;2;38;.950;3608000;0
23745;1061;28;0;0;0;0;.00nan;0;0
23745;2557;27;0;0;0;0;.00nan;0;0
24108;360;16;47;23;3;20;.870;3555000;0
24108;1163;0;0;0;0;0;.00nan;0;0
24108;2687;16;0;0;0;0;.00nan;0;0
24108;2804;0;91;35;2;33;.943;3600000;0
23762;710;26;61;34;5;29;.853;3660000;0
23762;1021;15;37;31;6;25;.806;3622000;0
23762;1128;15;0;0;0;0;.00nan;0;0
23762;1239;26;0;0;0;0;.00nan;0;0
23742;295;24;0;0;0;0;.00nan;0;0
23742;812;24;78;26;1;25;.962;3600000;0
23742;1221;25;0;0;0;0;.00nan;0;0
23742;2269;25;65;38;4;34;.895;3600000;0
23678;268;1;100;30;0;30;1.000;3600000;0
23678;1052;9;80;31;2;29;.935;3565000;0
23678;1332;9;0;0;0;0;.00nan;0;0
23678;2800;1;0;0;0;0;.00nan;0;0
23953;489;19;0;0;0;0;.00nan;0;0
23953;711;3;100;28;0;28;1.000;3600000;0
23953;1731;3;0;0;0;0;.00nan;0;0
23953;1865;61;90;34;1;33;.971;3581000;0
23800;735;5;0;0;0;0;.00nan;0;0
23800;998;8;0;0;0;0;.00nan;0;0
23800;1361;5;61;36;4;32;.889;3570000;0
23800;2266;8;84;32;2;30;.938;3600000;0
23868;734;2;0;0;0;0;.00nan;0;0
23868;1149;12;0;0;0;0;.00nan;0;0
23868;1278;12;84;35;3;32;.914;3585000;0
23868;1355;2;79;26;1;25;.962;3600000;0
23784;13;7;78;42;4;38;.905;3569000;0
23784;316;7;0;0;0;0;.00nan;0;0
23784;505;17;0;0;0;0;.00nan;0;0
23784;1333;17;87;33;2;31;.939;3600000;0
23825;783;11;0;0;0;0;.00nan;0;0
23825;2016;14;0;0;0;0;.00nan;0;0
23825;2057;14;83;34;2;32;.941;3818000;0
23825;2810;11;93;59;3;56;.949;3818000;0
23736;360;16;0;0;0;0;.00nan;0;0
23736;1406;21;0;0;0;0;.00nan;0;0
23736;1690;21;95;45;2;43;.956;3600000;0
23736;2687;16;65;32;3;29;.906;3562000;0
24029;318;22;0;0;0;0;.00nan;0;0
24029;419;20;83;34;2;32;.941;3900000;0
24029;707;20;0;0;0;0;.00nan;0;0
24029;1036;22;85;32;2;30;.938;3863000;0
23723;734;2;0;0;0;0;.00nan;0;0
23723;1163;0;98;55;4;51;.927;3600000;0
23723;1355;2;62;15;2;13;.867;3600000;0
23723;2804;0;0;0;0;0;.00nan;0;0
23809;429;28;0;0;0;0;.00nan;0;0
23809;711;3;57;39;5;34;.872;3600000;0
23809;1061;28;76;28;2;26;.929;3600000;0
23809;1731;3;0;0;0;0;.00nan;0;0
23703;505;17;0;0;0;0;.00nan;0;0
23703;1052;9;0;0;0;0;.00nan;0;0
23703;1332;9;73;38;3;35;.921;3900000;0
23703;1333;17;83;34;3;31;.912;3900000;0
23766;277;10;0;0;0;0;.00nan;0;0
23766;482;6;0;0;0;0;.00nan;0;0
23766;483;6;98;49;2;47;.959;3566000;0
23766;691;10;97;20;0;20;1.000;3600000;0
23804;710;26;0;0;0;0;.00nan;0;0
23804;1239;26;43;37;6;31;.838;3600000;0
23804;2834;29;100;35;0;35;1.000;3600000;0
23804;2947;29;0;0;0;0;.00nan;0;0
23727;727;4;81;35;3;32;.914;3581000;0
23727;1335;4;0;0;0;0;.00nan;0;0
23727;2174;18;0;0;0;0;.00nan;0;0
23727;2314;18;79;27;1;26;.963;3600000;0
23850;112;13;0;0;0;0;.00nan;0;0
23850;714;13;81;31;2;29;.935;3568000;0
23850;1021;15;90;31;1;30;.968;3600000;0
23850;1128;15;0;0;0;0;.00nan;0;0
24231;489;19;63;34;4;30;.882;3622000;0
24231;711;3;0;0;0;0;.00nan;0;0
24231;1731;3;52;35;5;30;.857;3622000;0
24231;1865;61;0;0;0;0;.00nan;0;0
23823;295;24;51;2;0;2;1.000;373000;0
23823;812;24;53;40;6;34;.850;3169000;0
23823;1149;12;54;34;5;29;.853;3600000;0
23823;1278;12;0;0;0;0;.00nan;0;0
23780;482;6;41;31;5;26;.839;3600000;0
23780;483;6;0;0;0;0;.00nan;0;0
23780;2834;29;83;29;1;28;.966;3600000;0
23780;2947;29;0;0;0;0;.00nan;0;0
23840;735;5;0;0;0;0;.00nan;0;0
23840;1361;5;59;35;4;31;.886;3599000;0
23840;2174;18;69;23;2;21;.913;3600000;0
23840;2314;18;0;0;0;0;.00nan;0;0
23744;783;11;35;28;6;22;.786;2792000;0
23744;1221;25;0;0;0;0;.00nan;0;0
23744;2269;25;87;28;1;27;.964;3600000;0
23744;2810;11;62;11;0;11;1.000;808000;0
23686;360;16;89;39;2;37;.949;3900000;0
23686;429;28;80;34;2;32;.941;3900000;0
23686;1061;28;0;0;0;0;.00nan;0;0
23686;2687;16;0;0;0;0;.00nan;0;0
23732;268;1;57;38;4;34;.895;3600000;0
23732;1163;0;78;22;1;21;.955;3600000;0
23732;2800;1;0;0;0;0;.00nan;0;0
23732;2804;0;0;0;0;0;.00nan;0;0
23802;360;16;0;0;0;0;.00nan;0;0
23802;1021;15;55;22;3;19;.864;3658000;0
23802;1128;15;0;0;0;0;.00nan;0;0
23802;2687;16;97;42;2;40;.952;3658000;0
23848;734;2;0;0;0;0;.00nan;0;0
23848;735;5;60;35;5;30;.857;3600000;0
23848;1355;2;96;34;1;33;.971;3600000;0
23848;1361;5;0;0;0;0;.00nan;0;0
23767;505;17;0;0;0;0;.00nan;0;0
23767;1221;25;100;49;2;47;.959;3600000;0
23767;1333;17;69;28;3;25;.893;3553000;0
23767;2269;25;0;0;0;0;.00nan;0;0
23774;1406;21;94;39;2;37;.949;3600000;0
23774;1690;21;0;0;0;0;.00nan;0;0
23774;2016;14;0;0;0;0;.00nan;0;0
23774;2057;14;21;26;7;19;.731;3600000;0
23761;318;22;0;0;0;0;.00nan;0;0
23761;487;27;0;0;0;0;.00nan;0;0
23761;1036;22;54;27;4;23;.852;3576000;0
23761;2557;27;96;41;2;39;.951;3600000;0
23688;112;13;77;29;2;27;.931;3900000;0
23688;714;13;0;0;0;0;.00nan;0;0
23688;737;23;0;0;0;0;.00nan;0;0
23688;2375;23;88;39;2;37;.949;3900000;0
23871;13;7;80;37;3;34;.919;3600000;0
23871;316;7;0;0;0;0;.00nan;0;0
23871;2174;18;0;0;0;0;.00nan;0;0
23871;2314;18;49;32;5;27;.844;3542000;0
24060;103;30;47;33;5;28;.848;3600000;0
24060;419;20;74;24;2;22;.917;3600000;0
24060;707;20;0;0;0;0;.00nan;0;0
24060;2549;30;0;0;0;0;.00nan;0;0
23830;295;24;0;0;0;0;.00nan;0;0
23830;812;24;54;18;3;15;.833;3578000;0
23830;2834;29;0;0;0;0;.00nan;0;0
23830;2947;29;95;42;2;40;.952;3600000;0
23750;1052;9;0;0;0;0;.00nan;0;0
23750;1149;12;74;36;3;33;.917;3900000;0
23750;1278;12;0;0;0;0;.00nan;0;0
23750;1332;9;69;29;3;26;.897;3900000;0
23790;482;6;0;0;0;0;.00nan;0;0
23790;483;6;48;33;6;27;.818;3738000;0
23790;735;5;0;0;0;0;.00nan;0;0
23790;1361;5;64;42;5;37;.881;3738000;0
23789;505;17;0;0;0;0;.00nan;0;0
23789;1163;0;54;31;4;27;.871;3543000;0
23789;1333;17;85;31;2;29;.935;3600000;0
23789;2804;0;0;0;0;0;.00nan;0;0
23853;489;19;0;0;0;0;.00nan;0;0
23853;1021;15;56;34;5;29;.853;3579000;0
23853;1128;15;0;0;0;0;.00nan;0;0
23853;1865;61;73;38;4;34;.895;3600000;0
23882;295;24;76;30;3;27;.900;3563000;0
23882;710;26;84;33;2;31;.939;3600000;0
23882;812;24;0;0;0;0;.00nan;0;0
23882;1239;26;0;0;0;0;.00nan;0;0
23931;103;30;52;6;0;6;1.000;349000;0
23931;2549;30;51;34;5;29;.853;3551000;0
23931;2834;29;57;35;5;30;.857;3895000;0
23931;2947;29;0;0;0;0;.00nan;0;0
23811;419;20;0;0;0;0;.00nan;0;0
23811;487;27;64;23;2;21;.913;3600000;0
23811;707;20;48;35;5;30;.857;3600000;0
23811;2557;27;0;0;0;0;.00nan;0;0
23691;268;1;0;0;0;0;.00nan;0;0
23691;737;23;0;0;0;0;.00nan;0;0
23691;2375;23;62;29;3;26;.897;3560000;0
23691;2800;1;88;33;2;31;.939;3600000;0
23757;783;11;75;32;3;29;.906;3900000;0
23757;1163;0;0;0;0;0;.00nan;0;0
23757;2804;0;61;32;3;29;.906;3900000;0
23757;2810;11;0;0;0;0;.00nan;0;0
23849;710;26;0;0;0;0;.00nan;0;0
23849;998;8;75;43;5;38;.884;3587000;0
23849;1239;26;77;22;1;21;.955;3600000;0
23849;2266;8;50;0;0;0;.00nan;13000;0
23852;112;13;0;0;0;0;.00nan;0;0
23852;714;13;76;39;4;35;.897;3731000;0
23852;1149;12;0;0;0;0;.00nan;0;0
23852;1278;12;64;24;3;21;.875;3731000;0
23716;489;19;63;21;2;19;.905;3600000;0
23716;737;23;72;31;3;28;.903;3542000;0
23716;1865;61;0;0;0;0;.00nan;0;0
23716;2375;23;0;0;0;0;.00nan;0;0
23921;318;22;43;13;2;11;.846;2485000;0
23921;1021;15;0;0;0;0;.00nan;0;0
23921;1036;22;34;21;5;16;.762;1115000;0
23921;1128;15;67;19;1;18;.947;3600000;0
23771;277;10;0;0;0;0;.00nan;0;0
23771;691;10;49;17;3;14;.824;3600000;0
23771;1406;21;74;43;4;39;.907;3600000;0
23771;1690;21;0;0;0;0;.00nan;0;0
23990;2016;14;66;33;3;30;.909;3014000;0
23990;2057;14;32;8;3;5;.625;586000;0
23990;2174;18;0;0;0;0;.00nan;0;0
23990;2314;18;60;40;5;35;.875;3600000;0
23806;360;16;84;30;1;29;.967;3600000;0
23806;734;2;0;0;0;0;.00nan;0;0
23806;1355;2;74;31;2;29;.935;3578000;0
23806;2687;16;0;0;0;0;.00nan;0;0
23777;13;7;0;0;0;0;.00nan;0;0
23777;316;7;83;27;1;26;.963;3600000;0
23777;487;27;0;0;0;0;.00nan;0;0
23777;2557;27;74;31;2;29;.935;3600000;0
23824;429;28;79;35;2;33;.943;3600000;0
23824;735;5;55;29;5;24;.828;3600000;0
23824;1061;28;0;0;0;0;.00nan;0;0
23824;1361;5;0;0;0;0;.00nan;0;0
23855;482;6;68;39;4;35;.897;3600000;0
23855;483;6;0;0;0;0;.00nan;0;0
23855;711;3;100;38;0;38;1.000;3600000;0
23855;1731;3;0;0;0;0;.00nan;0;0
23776;727;4;63;42;5;37;.881;3555000;0
23776;1221;25;0;0;0;0;.00nan;0;0
23776;1335;4;0;0;0;0;.00nan;0;0
23776;2269;25;53;32;4;28;.875;3600000;0
23928;268;1;64;45;5;40;.889;3572000;0
23928;2016;14;0;0;0;0;.00nan;0;0
23928;2057;14;60;35;4;31;.886;3600000;0
23928;2800;1;0;0;0;0;.00nan;0;0
23769;13;7;71;34;3;31;.912;3557000;0
23769;316;7;0;0;0;0;.00nan;0;0
23769;1052;9;0;0;0;0;.00nan;0;0
23769;1332;9;93;39;2;37;.949;3600000;0
23711;711;3;68;34;4;30;.882;3600000;0
23711;737;23;0;0;0;0;.00nan;0;0
23711;1731;3;0;0;0;0;.00nan;0;0
23711;2375;23;85;27;1;26;.963;3600000;0
23785;277;10;0;0;0;0;.00nan;0;0
23785;429;28;0;0;0;0;.00nan;0;0
23785;691;10;76;28;2;26;.929;3900000;0
23785;1061;28;90;43;2;41;.953;3900000;0
23898;268;1;51;3;0;3;1.000;659000;0
23898;998;8;74;36;3;33;.917;3600000;0
23898;2266;8;0;0;0;0;.00nan;0;0
23898;2800;1;42;41;7;34;.829;2941000;0
23781;734;2;0;0;0;0;.00nan;0;0
23781;1221;25;100;27;0;27;1.000;3600000;0
23781;1355;2;63;35;4;31;.886;3600000;0
23781;2269;25;0;0;0;0;.00nan;0;0
23878;419;20;77;27;2;25;.926;3600000;0
23878;707;20;0;0;0;0;.00nan;0;0
23878;1149;12;77;36;3;33;.917;3600000;0
23878;1278;12;0;0;0;0;.00nan;0;0
23799;505;17;0;0;0;0;.00nan;0;0
23799;727;4;46;36;5;31;.861;3558000;0
23799;1333;17;84;35;3;32;.914;3600000;0
23799;1335;4;0;0;0;0;.00nan;0;0
23903;112;13;83;27;1;26;.963;3900000;0
23903;489;19;83;27;1;26;.963;3900000;0
23903;714;13;0;0;0;0;.00nan;0;0
23903;1056;19;0;0;0;0;.00nan;0;0
23969;295;24;0;0;0;0;.00nan;0;0
23969;812;24;54;23;3;20;.870;3564000;0
23969;2174;18;0;0;0;0;.00nan;0;0
23969;2314;18;98;41;2;39;.951;3600000;0
23831;783;11;39;31;6;25;.806;2162000;0
23831;2810;11;53;12;2;10;.833;1377000;0
23831;2834;29;46;34;6;28;.824;3004000;0
23831;2947;29;60;7;0;7;1.000;596000;0
23758;1052;9;43;48;7;41;.854;2791000;0
23758;1332;9;26;6;3;3;.500;809000;0
23758;1406;21;60;33;4;29;.879;3600000;0
23758;1690;21;0;0;0;0;.00nan;0;0
23910;103;30;0;0;0;0;.00nan;0;0
23910;710;26;73;47;4;43;.915;3600000;0
23910;1239;26;0;0;0;0;.00nan;0;0
23910;2549;30;66;28;3;25;.893;3600000;0
23844;360;16;87;31;2;29;.935;3600000;0
23844;1021;15;75;34;3;31;.912;3600000;0
23844;1128;15;0;0;0;0;.00nan;0;0
23844;2687;16;0;0;0;0;.00nan;0;0
23924;103;30;100;42;0;42;1.000;3600000;0
23924;487;27;0;0;0;0;.00nan;0;0
23924;2549;30;0;0;0;0;.00nan;0;0
23924;2557;27;84;33;2;31;.939;3578000;0
23833;360;16;0;0;0;0;.00nan;0;0
23833;783;11;0;0;0;0;.00nan;0;0
23833;2687;16;49;23;4;19;.826;3690000;0
23833;2810;11;99;46;3;43;.935;3690000;0
23941;13;7;0;0;0;0;.00nan;0;0
23941;316;7;100;35;1;34;.971;3600000;0
23941;2834;29;65;31;3;28;.903;3600000;0
23941;2947;29;0;0;0;0;.00nan;0;0
23841;429;28;60;39;4;35;.897;3572000;0
23841;482;6;0;0;0;0;.00nan;0;0
23841;483;6;86;41;3;38;.927;3600000;0
23841;1061;28;0;0;0;0;.00nan;0;0
23816;727;4;0;0;0;0;.00nan;0;0
23816;1335;4;57;25;3;22;.880;3600000;0
23816;2016;14;77;26;2;24;.923;3600000;0
23816;2057;14;0;0;0;0;.00nan;0;0
23827;277;10;100;42;2;40;.952;3900000;0
23827;691;10;0;0;0;0;.00nan;0;0
23827;998;8;0;0;0;0;.00nan;0;0
23827;2266;8;77;35;2;33;.943;3900000;0
23993;112;13;0;0;0;0;.00nan;0;0
23993;711;3;0;0;0;0;.00nan;0;0
23993;714;13;94;37;1;36;.973;3600000;0
23993;1731;3;89;32;2;30;.938;3549000;0
23775;1163;0;98;39;2;37;.949;3600000;0
23775;2174;18;0;0;0;0;.00nan;0;0
23775;2314;18;72;44;5;39;.886;3600000;0
23775;2804;0;0;0;0;0;.00nan;0;0
23782;735;5;0;0;0;0;.00nan;0;0
23782;1221;25;24;12;4;8;.667;955000;0
23782;1361;5;77;35;2;33;.943;3600000;0
23782;2269;25;60;31;4;27;.871;2645000;0
23787;419;20;72;32;2;30;.938;3600000;0
23787;707;20;0;0;0;0;.00nan;0;0
23787;1406;21;45;41;6;35;.854;3600000;0
23787;1690;21;0;0;0;0;.00nan;0;0
23814;505;17;0;0;0;0;.00nan;0;0
23814;734;2;0;0;0;0;.00nan;0;0
23814;1333;17;94;19;0;19;1.000;3600000;0
23814;1355;2;82;33;2;31;.939;3560000;0
24148;998;8;89;36;3;33;.917;3545000;0
24148;1021;15;85;27;1;26;.963;3600000;0
24148;1128;15;0;0;0;0;.00nan;0;0
24148;2266;8;0;0;0;0;.00nan;0;0
24190;277;10;0;0;0;0;.00nan;0;0
24190;489;19;0;0;0;0;.00nan;0;0
24190;691;10;88;35;3;32;.914;3600000;0
24190;1056;19;28;21;5;16;.762;3559000;0
23986;268;1;0;0;0;0;.00nan;0;0
23986;2800;1;99;46;1;45;.978;3600000;0
23986;2834;29;0;0;0;0;.00nan;0;0
23986;2947;29;55;26;3;23;.885;3513000;0
23863;429;28;55;26;4;22;.846;3537000;0
23863;783;11;91;37;2;35;.946;3600000;0
23863;1061;28;0;0;0;0;.00nan;0;0
23863;2810;11;0;0;0;0;.00nan;0;0
23845;1163;0;88;36;2;34;.944;3681000;0
23845;2016;14;0;0;0;0;.00nan;0;0
23845;2057;14;63;25;3;22;.880;3681000;0
23845;2804;0;0;0;0;0;.00nan;0;0
23929;1149;12;82;40;3;37;.925;3600000;0
23929;1278;12;0;0;0;0;.00nan;0;0
23929;2174;18;0;0;0;0;.00nan;0;0
23929;2314;18;59;27;4;23;.852;3595000;0
23795;711;3;48;35;5;30;.857;3600000;0
23795;1221;25;0;0;0;0;.00nan;0;0
23795;1731;3;0;0;0;0;.00nan;0;0
23795;2269;25;92;32;1;31;.969;3600000;0
23968;419;20;74;29;3;26;.897;3600000;0
23968;707;20;0;0;0;0;.00nan;0;0
23968;1149;12;0;0;0;0;.00nan;0;0
23968;1278;12;94;19;0;19;1.000;3600000;0
23725;318;22;0;0;0;0;.00nan;0;0
23725;737;23;0;0;0;0;.00nan;0;0
23725;1036;22;48;27;4;23;.852;3784000;0
23725;2375;23;66;31;3;28;.903;3784000;0
23798;1163;0;48;8;1;7;.875;1289000;0
23798;2804;0;25;29;7;22;.759;2311000;0
23798;2834;29;68;38;4;34;.895;3600000;0
23798;2947;29;0;0;0;0;.00nan;0;0
23819;429;28;0;0;0;0;.00nan;0;0
23819;734;2;0;0;0;0;.00nan;0;0
23819;1061;28;100;40;1;39;.975;3600000;0
23819;1355;2;79;30;2;28;.933;3570000;0
23815;13;7;88;39;3;36;.923;3569000;0
23815;316;7;0;0;0;0;.00nan;0;0
23815;505;17;0;0;0;0;.00nan;0;0
23815;1333;17;82;24;1;23;.958;3600000;0
23851;295;24;0;0;0;0;.00nan;0;0
23851;735;5;0;0;0;0;.00nan;0;0
23851;812;24;80;28;1;27;.964;3600000;0
23851;1361;5;68;34;3;31;.912;3543000;0
23857;482;6;0;0;0;0;.00nan;0;0
23857;483;6;89;42;2;40;.952;3568000;0
23857;2016;14;68;17;1;16;.941;3600000;0
23857;2057;14;0;0;0;0;.00nan;0;0
23919;103;30;100;50;1;49;.980;3900000;0
23919;710;26;93;29;1;28;.966;3900000;0
23919;1239;26;0;0;0;0;.00nan;0;0
23919;2549;30;0;0;0;0;.00nan;0;0
23883;112;13;100;34;1;33;.971;3600000;0
23883;714;13;0;0;0;0;.00nan;0;0
23883;1406;21;81;41;4;37;.902;3600000;0
23883;1690;21;0;0;0;0;.00nan;0;0
23770;360;16;36;11;3;8;.727;3600000;0
23770;1052;9;62;17;1;16;.941;2464000;0
23770;1332;9;34;14;4;10;.714;1136000;0
23770;2687;16;0;0;0;0;.00nan;0;0
23826;487;27;0;0;0;0;.00nan;0;0
23826;727;4;12;18;6;12;.667;2359000;0
23826;1335;4;66;10;0;10;1.000;1198000;0
23826;2557;27;70;37;4;33;.892;3600000;0
23838;419;20;0;0;0;0;.00nan;0;0
23838;707;20;60;36;4;32;.889;3600000;0
23838;727;4;0;0;0;0;.00nan;0;0
23838;1335;4;53;36;5;31;.861;3581000;0
23915;112;13;0;0;0;0;.00nan;0;0
23915;710;26;0;0;0;0;.00nan;0;0
23915;714;13;78;35;3;32;.914;3600000;0
23915;1239;26;74;28;2;26;.929;3600000;0
23793;277;10;0;0;0;0;.00nan;0;0
23793;295;24;83;38;3;35;.921;3600000;0
23793;691;10;92;33;2;31;.939;3600000;0
23793;812;24;0;0;0;0;.00nan;0;0
23875;103;30;0;0;0;0;.00nan;0;0
23875;482;6;58;43;5;38;.884;3566000;0
23875;483;6;0;0;0;0;.00nan;0;0
23875;2549;30;58;31;4;27;.871;3600000;0
23913;711;3;66;36;4;32;.889;3553000;0
23913;1406;21;0;0;0;0;.00nan;0;0
23913;1690;21;70;24;2;22;.917;3600000;0
23913;1731;3;0;0;0;0;.00nan;0;0
23960;13;7;0;0;0;0;.00nan;0;0
23960;316;7;55;35;5;30;.857;3600000;0
23960;711;3;0;0;0;0;.00nan;0;0
23960;1731;3;79;31;2;29;.935;3600000;0
23869;735;5;0;0;0;0;.00nan;0;0
23869;1021;15;47;20;3;17;.850;3542000;0
23869;1128;15;0;0;0;0;.00nan;0;0
23869;1361;5;99;47;2;45;.957;3600000;0
23861;783;11;100;32;0;32;1.000;3600000;0
23861;2174;18;78;40;3;37;.925;3600000;0
23861;2314;18;0;0;0;0;.00nan;0;0
23861;2810;11;0;0;0;0;.00nan;0;0
23862;429;28;0;0;0;0;.00nan;0;0
23862;734;2;88;30;0;30;1.000;3900000;0
23862;1061;28;100;39;0;39;1.000;3900000;0
23862;1355;2;0;0;0;0;.00nan;0;0
23858;277;10;30;26;6;20;.769;3572000;0
23858;487;27;0;0;0;0;.00nan;0;0
23858;691;10;50;0;0;0;.00nan;10000;0
23858;2557;27;99;49;3;46;.939;3600000;0
23937;318;22;69;26;2;24;.923;1648000;0
23937;360;16;68;32;3;29;.906;3600000;0
23937;1036;22;40;28;6;22;.786;1952000;0
23937;2687;16;0;0;0;0;.00nan;0;0
23805;737;23;0;0;0;0;.00nan;0;0
23805;1221;25;0;0;0;0;.00nan;0;0
23805;2269;25;79;37;3;34;.919;3600000;0
23805;2375;23;67;37;4;33;.892;3541000;0
23801;998;8;41;40;6;34;.850;3600000;0
23801;1052;9;0;0;0;0;.00nan;0;0
23801;1332;9;69;32;3;29;.906;3600000;0
23801;2266;8;0;0;0;0;.00nan;0;0
23975;735;5;74;45;4;41;.911;3600000;0
23975;998;8;0;0;0;0;.00nan;0;0
23975;1361;5;0;0;0;0;.00nan;0;0
23975;2266;8;86;26;1;25;.962;3600000;0
23873;489;19;0;0;0;0;.00nan;0;0
23873;727;4;100;36;1;35;.972;3667000;0
23873;1056;19;92;45;2;43;.956;3667000;0
23873;1335;4;0;0;0;0;.00nan;0;0
23895;419;20;71;34;4;30;.882;3557000;0
23895;707;20;0;0;0;0;.00nan;0;0
23895;1163;0;81;33;3;30;.909;3600000;0
23895;2804;0;0;0;0;0;.00nan;0;0
23820;318;22;0;0;0;0;.00nan;0;0
23820;1036;22;100;43;0;43;1.000;3600000;0
23820;1221;25;57;31;4;27;.871;3600000;0
23820;2269;25;0;0;0;0;.00nan;0;0
23997;13;7;56;11;1;10;.909;3600000;0
23997;316;7;0;0;0;0;.00nan;0;0
23997;2834;29;95;49;3;46;.939;3541000;0
23997;2947;29;0;0;0;0;.00nan;0;0
23726;295;24;66;24;2;22;.917;3600000;0
23726;737;23;84;44;3;41;.932;3545000;0
23726;812;24;0;0;0;0;.00nan;0;0
23726;2375;23;0;0;0;0;.00nan;0;0
23818;360;16;0;0;0;0;.00nan;0;0
23818;505;17;0;0;0;0;.00nan;0;0
23818;1333;17;84;34;3;31;.912;3600000;0
23818;2687;16;80;49;6;43;.878;3600000;0
23880;482;6;0;0;0;0;.00nan;0;0
23880;483;6;63;43;5;38;.884;3600000;0
23880;2174;18;0;0;0;0;.00nan;0;0
23880;2314;18;99;40;1;39;.975;3600000;0
23864;734;2;70;22;1;21;.955;3600000;0
23864;1021;15;89;38;2;36;.947;3600000;0
23864;1128;15;0;0;0;0;.00nan;0;0
23864;1355;2;0;0;0;0;.00nan;0;0
24035;112;13;63;36;4;32;.889;3600000;0
24035;489;19;55;35;5;30;.857;3588000;0
24035;714;13;0;0;0;0;.00nan;0;0
24035;1056;19;0;0;0;0;.00nan;0;0
23856;505;17;73;24;2;22;.917;3900000;0
23856;783;11;90;43;2;41;.953;3900000;0
23856;1333;17;0;0;0;0;.00nan;0;0
23856;2810;11;0;0;0;0;.00nan;0;0
23914;277;10;0;0;0;0;.00nan;0;0
23914;691;10;68;38;4;34;.895;3561000;0
23914;1149;12;0;0;0;0;.00nan;0;0
23914;1278;12;77;33;3;30;.909;3600000;0
24020;103;30;65;38;5;33;.868;3593000;0
24020;268;1;30;25;6;19;.760;3600000;0
24020;2549;30;0;0;0;0;.00nan;0;0
24020;2800;1;0;0;0;0;.00nan;0;0
23807;487;27;0;0;0;0;.00nan;0;0
23807;1052;9;0;0;0;0;.00nan;0;0
23807;1332;9;75;29;2;27;.931;3547000;0
23807;2557;27;84;28;1;27;.964;3600000;0
23989;998;8;77;45;4;41;.911;3558000;0
23989;2016;14;0;0;0;0;.00nan;0;0
23989;2057;14;71;35;3;32;.914;3600000;0
23989;2266;8;0;0;0;0;.00nan;0;0
23901;1021;15;82;29;2;27;.931;3600000;0
23901;1128;15;0;0;0;0;.00nan;0;0
23901;1406;21;58;38;4;34;.895;3556000;0
23901;1690;21;0;0;0;0;.00nan;0;0
24030;13;7;0;0;0;0;.00nan;0;0
24030;316;7;71;46;5;41;.891;3600000;0
24030;318;22;0;0;0;0;.00nan;0;0
24030;1036;22;100;43;1;42;.977;3600000;0
23985;295;24;0;0;0;0;.00nan;0;0
23985;812;24;88;34;2;32;.941;3600000;0
23985;2834;29;65;33;4;29;.879;2224000;0
23985;2947;29;71;15;0;15;1.000;1309000;0
23951;360;16;51;41;6;35;.854;3600000;0
23951;482;6;0;0;0;0;.00nan;0;0
23951;483;6;84;26;1;25;.962;3600000;0
23951;2687;16;0;0;0;0;.00nan;0;0
23854;1221;25;0;0;0;0;.00nan;0;0
23854;2174;18;0;0;0;0;.00nan;0;0
23854;2269;25;71;24;2;22;.917;3600000;0
23854;2314;18;75;33;3;30;.909;3600000;0
23923;1149;12;96;21;0;21;1.000;3600000;0
23923;1163;0;26;12;4;8;.667;1000000;0
23923;1278;12;0;0;0;0;.00nan;0;0
23923;2804;0;84;43;4;39;.907;2600000;0
23890;268;1;0;0;0;0;.00nan;0;0
23890;783;11;0;0;0;0;.00nan;0;0
23890;2800;1;51;30;4;26;.867;3600000;0
23890;2810;11;80;48;5;43;.896;3562000;0
24074;112;13;0;0;0;0;.00nan;0;0
24074;489;19;0;0;0;0;.00nan;0;0
24074;714;13;66;30;2;28;.933;3600000;0
24074;1056;19;78;37;3;34;.919;3566000;0
23980;710;26;92;33;1;32;.970;3600000;0
23980;735;5;0;0;0;0;.00nan;0;0
23980;1239;26;0;0;0;0;.00nan;0;0
23980;1361;5;50;26;3;23;.885;3572000;0
23872;419;20;73;33;3;30;.909;3600000;0
23872;707;20;0;0;0;0;.00nan;0;0
23872;734;2;49;29;4;25;.862;3600000;0
23872;1355;2;0;0;0;0;.00nan;0;0
23908;419;20;0;0;0;0;.00nan;0;0
23908;482;6;55;30;4;26;.867;3600000;0
23908;483;6;0;0;0;0;.00nan;0;0
23908;707;20;56;39;5;34;.872;3585000;0
23885;1221;25;100;47;2;45;.957;3900000;0
23885;2174;18;87;35;2;33;.943;3900000;0
23885;2269;25;0;0;0;0;.00nan;0;0
23885;2314;18;0;0;0;0;.00nan;0;0
23891;487;27;88;18;0;18;1.000;3600000;0
23891;1406;21;98;55;1;54;.982;3584000;0
23891;1690;21;0;0;0;0;.00nan;0;0
23891;2557;27;0;0;0;0;.00nan;0;0
23884;505;17;0;0;0;0;.00nan;0;0
23884;710;26;54;24;3;21;.875;2934000;0
23884;1239;26;22;12;4;8;.667;666000;0
23884;1333;17;100;32;0;32;1.000;3600000;0
23876;429;28;0;0;0;0;.00nan;0;0
23876;1021;15;64;41;5;36;.878;3600000;0
23876;1061;28;92;35;1;34;.971;3600000;0
23876;1128;15;0;0;0;0;.00nan;0;0
23832;277;10;0;0;0;0;.00nan;0;0
23832;691;10;91;24;0;24;1.000;3600000;0
23832;1052;9;0;0;0;0;.00nan;0;0
23832;1332;9;85;47;3;44;.936;3600000;0
23837;13;7;46;31;5;26;.839;3598000;0
23837;316;7;0;0;0;0;.00nan;0;0
23837;737;23;79;37;4;33;.892;3600000;0
23837;2375;23;0;0;0;0;.00nan;0;0
23987;735;5;78;33;2;31;.939;3600000;0
23987;1361;5;0;0;0;0;.00nan;0;0
23987;2834;29;73;34;3;31;.912;3552000;0
23987;2947;29;0;0;0;0;.00nan;0;0
23874;727;4;56;46;6;40;.870;3600000;0
23874;734;2;0;0;0;0;.00nan;0;0
23874;1335;4;0;0;0;0;.00nan;0;0
23874;1355;2;83;24;1;23;.958;3600000;0
23870;427;54;43;3;1;2;.667;760000;0
23870;783;11;93;38;3;35;.921;3600000;0
23870;2266;8;38;32;6;26;.813;2840000;0
23870;2810;11;0;0;0;0;.00nan;0;0
23906;505;17;0;0;0;0;.00nan;0;0
23906;1149;12;35;29;6;23;.793;2015000;0
23906;1278;12;57;17;2;15;.882;1585000;0
23906;1333;17;46;31;5;26;.839;3600000;0
23917;427;54;53;37;5;32;.865;3600000;0
23917;1163;0;61;34;4;30;.882;3600000;0
23917;2266;8;0;0;0;0;.00nan;0;0
23917;2804;0;0;0;0;0;.00nan;0;0
23865;277;10;0;0;0;0;.00nan;0;0
23865;691;10;24;17;5;12;.706;3600000;0
23865;1052;9;0;0;0;0;.00nan;0;0
23865;1332;9;100;37;0;37;1.000;3600000;0
23932;711;3;83;60;5;55;.917;3600000;0
23932;1021;15;42;24;4;20;.833;3600000;0
23932;1128;15;0;0;0;0;.00nan;0;0
23932;1731;3;0;0;0;0;.00nan;0;0
23897;268;1;0;0;0;0;.00nan;0;0
23897;1163;0;0;0;0;0;.00nan;0;0
23897;2800;1;77;33;2;31;.939;3600000;0
23897;2804;0;71;54;6;48;.889;3600000;0
23894;487;27;25;6;3;3;.500;576000;0
23894;783;11;100;41;0;41;1.000;3600000;0
23894;2557;27;70;26;2;24;.923;3024000;0
23894;2810;11;0;0;0;0;.00nan;0;0
23925;1149;12;0;0;0;0;.00nan;0;0
23925;1278;12;92;28;1;27;.964;3900000;0
23925;1406;21;96;39;1;38;.974;3900000;0
23925;1690;21;0;0;0;0;.00nan;0;0
24103;318;22;0;0;0;0;.00nan;0;0
24103;489;19;0;0;0;0;.00nan;0;0
24103;1036;22;97;51;3;48;.941;3545000;0
24103;1056;19;69;22;2;20;.909;3600000;0
23934;295;24;44;28;5;23;.821;3600000;0
23934;710;26;55;38;6;32;.842;3600000;0
23934;812;24;0;0;0;0;.00nan;0;0
23934;1239;26;0;0;0;0;.00nan;0;0
23886;737;23;0;0;0;0;.00nan;0;0
23886;2016;14;0;0;0;0;.00nan;0;0
23886;2057;14;68;31;4;27;.871;3900000;0
23886;2375;23;71;45;4;41;.911;3900000;0
23887;727;4;75;29;2;27;.931;3516000;0
23887;734;2;0;0;0;0;.00nan;0;0
23887;1335;4;0;0;0;0;.00nan;0;0
23887;1355;2;100;30;0;30;1.000;3600000;0
23971;735;5;71;40;3;37;.925;3561000;0
23971;1361;5;0;0;0;0;.00nan;0;0
23971;2174;18;0;0;0;0;.00nan;0;0
23971;2314;18;77;22;1;21;.955;3600000;0
23972;360;16;100;24;0;24;1.000;3600000;0
23972;419;20;76;44;4;40;.909;3600000;0
23972;707;20;0;0;0;0;.00nan;0;0
23972;2687;16;0;0;0;0;.00nan;0;0
23879;277;10;89;30;1;29;.967;3600000;0
23879;505;17;0;0;0;0;.00nan;0;0
23879;691;10;0;0;0;0;.00nan;0;0
23879;1333;17;70;28;2;26;.929;3600000;0
23952;489;19;100;43;1;42;.977;3900000;0
23952;1056;19;0;0;0;0;.00nan;0;0
23952;1406;21;0;0;0;0;.00nan;0;0
23952;1690;21;88;37;1;36;.973;3900000;0
23889;1021;15;0;0;0;0;.00nan;0;0
23889;1052;9;0;0;0;0;.00nan;0;0
23889;1128;15;100;48;2;46;.958;3600000;0
23889;1332;9;59;34;4;30;.882;3571000;0
24032;13;7;0;0;0;0;.00nan;0;0
24032;316;7;57;22;3;19;.864;3600000;0
24032;711;3;0;0;0;0;.00nan;0;0
24032;1731;3;49;28;4;24;.857;3600000;0
23909;1221;25;53;2;0;2;1.000;150000;0
23909;2016;14;100;30;0;30;1.000;3600000;0
23909;2057;14;0;0;0;0;.00nan;0;0
23909;2269;25;43;37;6;31;.838;3450000;0
23930;427;54;100;48;0;48;1.000;3600000;0
23930;429;28;0;0;0;0;.00nan;0;0
23930;1061;28;73;23;1;22;.957;3544000;0
23930;2266;8;0;0;0;0;.00nan;0;0
23922;360;16;86;38;3;35;.921;3563000;0
23922;487;27;0;0;0;0;.00nan;0;0
23922;2557;27;83;31;2;29;.935;3600000;0
23922;2687;16;0;0;0;0;.00nan;0;0
23899;737;23;91;37;1;36;.973;3600000;0
23899;1149;12;75;30;2;28;.933;3548000;0
23899;1278;12;0;0;0;0;.00nan;0;0
23899;2375;23;0;0;0;0;.00nan;0;0
23893;268;1;77;29;2;27;.931;3600000;0
23893;727;4;91;47;3;44;.936;3600000;0
23893;1335;4;0;0;0;0;.00nan;0;0
23893;2800;1;0;0;0;0;.00nan;0;0
24088;103;30;67;38;5;33;.868;3532000;0
24088;295;24;75;32;3;29;.906;3600000;0
24088;812;24;0;0;0;0;.00nan;0;0
24088;2549;30;0;0;0;0;.00nan;0;0
24010;2016;14;100;36;1;35;.972;3600000;0
24010;2057;14;0;0;0;0;.00nan;0;0
24010;2834;29;66;29;3;26;.897;3513000;0
24010;2947;29;0;0;0;0;.00nan;0;0
23942;429;28;49;28;4;24;.857;3600000;0
23942;482;6;62;21;2;19;.905;2323000;0
23942;483;6;44;23;4;19;.826;1191000;0
23942;1061;28;0;0;0;0;.00nan;0;0
24033;360;16;0;0;0;0;.00nan;0;0
24033;489;19;0;0;0;0;.00nan;0;0
24033;1056;19;93;18;0;18;1.000;3600000;0
24033;2687;16;98;48;1;47;.979;3576000;0
23866;103;30;72;26;1;25;.962;3600000;0
23866;1052;9;0;0;0;0;.00nan;0;0
23866;1332;9;89;37;2;35;.946;3600000;0
23866;2549;30;0;0;0;0;.00nan;0;0
23896;295;24;0;0;0;0;.00nan;0;0
23896;727;4;32;32;6;26;.813;3558000;0
23896;812;24;85;30;1;29;.967;3600000;0
23896;1335;4;50;0;0;0;.00nan;42000;0
24053;112;13;93;29;1;28;.966;3600000;0
24053;482;6;0;0;0;0;.00nan;0;0
24053;483;6;60;35;4;31;.886;3600000;0
24053;714;13;0;0;0;0;.00nan;0;0
23911;318;22;0;0;0;0;.00nan;0;0
23911;734;2;0;0;0;0;.00nan;0;0
23911;1036;22;59;22;3;19;.864;3600000;0
23911;1355;2;48;28;4;24;.857;3600000;0
24184;487;27;0;0;0;0;.00nan;0;0
24184;710;26;79;45;4;41;.911;3561000;0
24184;1239;26;0;0;0;0;.00nan;0;0
24184;2557;27;78;37;3;34;.919;3600000;0
23940;735;5;56;37;5;32;.865;3547000;0
23940;737;23;0;0;0;0;.00nan;0;0
23940;1361;5;0;0;0;0;.00nan;0;0
23940;2375;23;64;40;4;36;.900;3600000;0
23918;268;1;0;0;0;0;.00nan;0;0
23918;1221;25;0;0;0;0;.00nan;0;0
23918;2269;25;93;33;1;32;.970;3600000;0
23918;2800;1;83;39;2;37;.949;3545000;0
23954;13;7;100;32;0;32;1.000;3600000;0
23954;316;7;0;0;0;0;.00nan;0;0
23954;1406;21;83;39;2;37;.949;3600000;0
23954;1690;21;0;0;0;0;.00nan;0;0
24011;783;11;92;31;1;30;.968;3600000;0
24011;998;8;32;29;6;23;.793;2624000;0
24011;2266;8;64;17;1;16;.941;976000;0
24011;2810;11;0;0;0;0;.00nan;0;0
23900;103;30;0;0;0;0;.00nan;0;0
23900;783;11;0;0;0;0;.00nan;0;0
23900;2549;30;81;32;2;30;.938;3600000;0
23900;2810;11;68;35;3;32;.914;3579000;0
23936;295;24;86;47;4;43;.915;3777000;0
23936;812;24;0;0;0;0;.00nan;0;0
23936;1021;15;80;35;3;32;.914;3777000;0
23936;1128;15;0;0;0;0;.00nan;0;0
23950;429;28;0;0;0;0;.00nan;0;0
23950;1061;28;39;22;4;18;.818;3600000;0
23950;2174;18;62;33;3;30;.909;2691000;0
23950;2314;18;28;11;4;7;.636;909000;0
23956;735;5;0;0;0;0;.00nan;0;0
23956;1052;9;62;25;2;23;.920;3600000;0
23956;1332;9;0;0;0;0;.00nan;0;0
23956;1361;5;46;31;4;27;.871;3573000;0
23983;710;26;0;0;0;0;.00nan;0;0
23983;737;23;87;20;0;20;1.000;3600000;0
23983;1239;26;76;37;3;34;.919;3600000;0
23983;2375;23;0;0;0;0;.00nan;0;0
23938;998;8;58;16;2;14;.875;1512000;0
23938;1406;21;0;0;0;0;.00nan;0;0
23938;1690;21;62;32;4;28;.875;3600000;0
23938;2266;8;25;27;6;21;.778;2088000;0
24063;360;16;82;40;2;38;.950;3600000;0
24063;2687;16;0;0;0;0;.00nan;0;0
24063;2834;29;72;36;3;33;.917;3563000;0
24063;2947;29;0;0;0;0;.00nan;0;0
23888;419;20;67;30;3;27;.900;3600000;0
23888;707;20;0;0;0;0;.00nan;0;0
23888;734;2;45;28;4;24;.857;3543000;0
23888;1355;2;0;0;0;0;.00nan;0;0
24001;711;3;0;0;0;0;.00nan;0;0
24001;1149;12;0;0;0;0;.00nan;0;0
24001;1278;12;81;24;1;23;.958;3600000;0
24001;1731;3;68;31;2;29;.935;3571000;0
24206;112;13;0;0;0;0;.00nan;0;0
24206;487;27;34;26;5;21;.808;3543000;0
24206;714;13;66;39;4;35;.897;3600000;0
24206;2557;27;0;0;0;0;.00nan;0;0
24128;318;22;52;39;6;33;.846;2766000;0
24128;1036;22;42;8;2;6;.750;834000;0
24128;2016;14;0;0;0;0;.00nan;0;0
24128;2057;14;69;25;2;23;.920;3600000;0
23927;505;17;0;0;0;0;.00nan;0;0
23927;1163;0;65;47;5;42;.894;3595000;0
23927;1333;17;94;45;4;41;.911;3600000;0
23927;2804;0;0;0;0;0;.00nan;0;0
23905;13;7;56;18;2;16;.889;3600000;0
23905;316;7;0;0;0;0;.00nan;0;0
23905;727;4;0;0;0;0;.00nan;0;0
23905;1335;4;83;42;3;39;.929;3600000;0
23961;1021;15;68;19;1;18;.947;3600000;0
23961;1128;15;0;0;0;0;.00nan;0;0
23961;2016;14;0;0;0;0;.00nan;0;0
23961;2057;14;94;41;2;39;.951;3582000;0
23944;429;28;0;0;0;0;.00nan;0;0
23944;783;11;80;39;4;35;.897;3600000;0
23944;1061;28;64;23;2;21;.913;3600000;0
23944;2810;11;0;0;0;0;.00nan;0;0
23962;482;6;0;0;0;0;.00nan;0;0
23962;483;6;68;39;4;35;.897;3688000;0
23962;1149;12;0;0;0;0;.00nan;0;0
23962;1278;12;74;29;3;26;.897;3688000;0
24059;112;13;85;44;3;41;.932;3542000;0
24059;714;13;0;0;0;0;.00nan;0;0
24059;735;5;97;37;2;35;.946;3600000;0
24059;1361;5;0;0;0;0;.00nan;0;0
23926;103;30;96;52;2;50;.962;3900000;0
23926;277;10;0;0;0;0;.00nan;0;0
23926;691;10;62;23;2;21;.913;3900000;0
23926;2549;30;0;0;0;0;.00nan;0;0
24042;489;19;0;0;0;0;.00nan;0;0
24042;1056;19;92;27;1;26;.963;3600000;0
24042;2834;29;73;38;3;35;.921;3548000;0
24042;2947;29;0;0;0;0;.00nan;0;0
23904;734;2;0;0;0;0;.00nan;0;0
23904;1163;0;93;56;4;52;.929;3600000;0
23904;1355;2;92;34;1;33;.971;3600000;0
23904;2804;0;0;0;0;0;.00nan;0;0
23939;295;24;0;0;0;0;.00nan;0;0
23939;812;24;64;40;5;35;.875;3600000;0
23939;998;8;13;24;7;17;.708;2442000;0
23939;2266;8;45;19;3;16;.842;1158000;0
24036;268;1;0;0;0;0;.00nan;0;0
24036;711;3;60;36;4;32;.889;3587000;0
24036;1731;3;0;0;0;0;.00nan;0;0
24036;2800;1;78;34;3;31;.912;3600000;0
23943;429;28;100;35;1;34;.971;3600000;0
23943;505;17;0;0;0;0;.00nan;0;0
23943;1061;28;0;0;0;0;.00nan;0;0
23943;1333;17;84;36;3;33;.917;3534000;0
24086;268;1;71;29;3;26;.897;3600000;0
24086;360;16;0;0;0;0;.00nan;0;0
24086;2687;16;69;42;4;38;.905;3542000;0
24086;2800;1;0;0;0;0;.00nan;0;0
23976;277;10;27;30;6;24;.800;3028000;0
23976;691;10;50;8;1;7;.875;572000;0
23976;2174;18;0;0;0;0;.00nan;0;0
23976;2314;18;94;37;2;35;.946;3600000;0
23970;419;20;84;23;1;22;.957;3600000;0
23970;707;20;0;0;0;0;.00nan;0;0
23970;1149;12;60;31;4;27;.871;3600000;0
23970;1278;12;0;0;0;0;.00nan;0;0
24104;1052;9;0;0;0;0;.00nan;0;0
24104;1332;9;99;38;1;37;.974;3600000;0
24104;2016;14;78;38;4;34;.895;3600000;0
24104;2057;14;0;0;0;0;.00nan;0;0
24038;710;26;0;0;0;0;.00nan;0;0
24038;711;3;44;9;2;7;.778;1152000;0
24038;1239;26;66;43;5;38;.884;3600000;0
24038;1731;3;35;31;6;25;.806;2448000;0
23907;727;4;99;47;2;45;.957;3600000;0
23907;737;23;94;49;4;45;.918;3554000;0
23907;1335;4;0;0;0;0;.00nan;0;0
23907;2375;23;0;0;0;0;.00nan;0;0
23958;13;7;0;0;0;0;.00nan;0;0
23958;316;7;48;26;4;22;.846;3600000;0
23958;1221;25;0;0;0;0;.00nan;0;0
23958;2269;25;92;32;1;31;.969;3600000;0
24028;489;19;0;0;0;0;.00nan;0;0
24028;1021;15;60;26;3;23;.885;3600000;0
24028;1056;19;100;28;0;28;1.000;3600000;0
24028;1128;15;0;0;0;0;.00nan;0;0
23981;419;20;0;0;0;0;.00nan;0;0
23981;707;20;80;40;2;38;.950;3726000;0
23981;1406;21;69;28;3;25;.893;3726000;0
23981;1690;21;0;0;0;0;.00nan;0;0
23933;487;27;0;0;0;0;.00nan;0;0
23933;505;17;48;35;5;30;.857;3600000;0
23933;1333;17;0;0;0;0;.00nan;0;0
23933;2557;27;72;23;1;22;.957;3600000;0
24091;277;10;0;0;0;0;.00nan;0;0
24091;691;10;85;28;1;27;.964;3600000;0
24091;2834;29;87;33;2;31;.939;3548000;0
24091;2947;29;0;0;0;0;.00nan;0;0
23945;1163;0;88;33;1;32;.970;3600000;0
23945;1221;25;0;0;0;0;.00nan;0;0
23945;2269;25;84;40;3;37;.925;3587000;0
23945;2804;0;0;0;0;0;.00nan;0;0
23963;482;6;0;0;0;0;.00nan;0;0
23963;483;6;72;29;2;27;.931;3600000;0
23963;2174;18;0;0;0;0;.00nan;0;0
23963;2314;18;66;29;3;26;.897;3541000;0
23995;783;11;82;49;5;44;.898;3600000;0
23995;1163;0;0;0;0;0;.00nan;0;0
23995;2804;0;88;29;1;28;.966;3600000;0
23995;2810;11;0;0;0;0;.00nan;0;0
24226;277;10;100;43;0;43;1.000;3600000;0
24226;360;16;52;17;2;15;.882;3581000;0
24226;691;10;0;0;0;0;.00nan;0;0
24226;2687;16;0;0;0;0;.00nan;0;0
23982;429;28;0;0;0;0;.00nan;0;0
23982;489;19;0;0;0;0;.00nan;0;0
23982;1056;19;77;36;3;33;.917;3900000;0
23982;1061;28;89;35;3;32;.914;3900000;0
23978;13;7;65;30;3;27;.900;3600000;0
23978;316;7;0;0;0;0;.00nan;0;0
23978;710;26;0;0;0;0;.00nan;0;0
23978;1239;26;77;44;4;40;.909;3597000;0
24026;1406;21;67;33;3;30;.909;3600000;0
24026;1690;21;0;0;0;0;.00nan;0;0
24026;2834;29;0;0;0;0;.00nan;0;0
24026;2947;29;71;40;4;36;.900;3600000;0
23948;295;24;100;48;1;47;.979;3600000;0
23948;487;27;0;0;0;0;.00nan;0;0
23948;812;24;0;0;0;0;.00nan;0;0
23948;2557;27;58;20;3;17;.850;3565000;0
23959;318;22;0;0;0;0;.00nan;0;0
23959;727;4;84;46;4;42;.913;3900000;0
23959;1036;22;60;33;4;29;.879;3900000;0
23959;1335;4;0;0;0;0;.00nan;0;0
23966;1021;15;86;27;1;26;.963;3600000;0
23966;1128;15;0;0;0;0;.00nan;0;0
23966;1221;25;0;0;0;0;.00nan;0;0
23966;2269;25;63;29;3;26;.897;3575000;0
24043;13;7;0;0;0;0;.00nan;0;0
24043;316;7;95;36;1;35;.972;3600000;0
24043;489;19;90;21;0;21;1.000;3600000;0
24043;1056;19;0;0;0;0;.00nan;0;0
23935;318;22;66;36;4;32;.889;3600000;0
23935;727;4;53;8;1;7;.875;1327000;0
23935;1036;22;0;0;0;0;.00nan;0;0
23935;1335;4;21;23;6;17;.739;2273000;0
24082;482;6;0;0;0;0;.00nan;0;0
24082;483;6;58;39;5;34;.872;3600000;0
24082;1052;9;0;0;0;0;.00nan;0;0
24082;1332;9;87;42;2;40;.952;3600000;0
24019;103;30;58;26;3;23;.885;3600000;0
24019;783;11;61;12;1;11;.917;853000;0
24019;2549;30;0;0;0;0;.00nan;0;0
24019;2810;11;12;23;7;16;.696;2747000;0
24014;2016;14;0;0;0;0;.00nan;0;0
24014;2057;14;96;31;2;29;.935;3900000;0
24014;2174;18;0;0;0;0;.00nan;0;0
24014;2314;18;80;31;2;29;.935;3900000;0
23912;112;13;27;22;5;17;.773;3600000;0
23912;714;13;0;0;0;0;.00nan;0;0
23912;734;2;60;10;0;10;1.000;986000;0
23912;1355;2;38;31;6;25;.806;2577000;0
23991;429;28;79;28;1;27;.964;3600000;0
23991;998;8;98;53;2;51;.962;3572000;0
23991;1061;28;0;0;0;0;.00nan;0;0
23991;2266;8;0;0;0;0;.00nan;0;0
24013;295;24;0;0;0;0;.00nan;0;0
24013;505;17;0;0;0;0;.00nan;0;0
24013;812;24;54;28;4;24;.857;3687000;0
24013;1333;17;52;32;5;27;.844;3687000;0
23947;737;23;55;28;4;24;.857;3544000;0
23947;998;8;0;0;0;0;.00nan;0;0
23947;2266;8;73;34;3;31;.912;3600000;0
23947;2375;23;0;0;0;0;.00nan;0;0
24153;277;10;66;33;3;30;.909;3560000;0
24153;691;10;0;0;0;0;.00nan;0;0
24153;2834;29;77;24;2;22;.917;3600000;0
24153;2947;29;0;0;0;0;.00nan;0;0
24005;419;20;66;48;5;43;.896;3557000;0
24005;487;27;0;0;0;0;.00nan;0;0
24005;707;20;0;0;0;0;.00nan;0;0
24005;2557;27;69;34;4;30;.882;3600000;0
24002;103;30;100;28;0;28;1.000;3600000;0
24002;2174;18;0;0;0;0;.00nan;0;0
24002;2314;18;79;30;2;28;.933;3577000;0
24002;2549;30;0;0;0;0;.00nan;0;0
23999;429;28;0;0;0;0;.00nan;0;0
23999;1061;28;62;34;4;30;.882;3566000;0
23999;1163;0;73;35;3;32;.914;3600000;0
23999;2804;0;0;0;0;0;.00nan;0;0
23974;268;1;0;0;0;0;.00nan;0;0
23974;1221;25;0;0;0;0;.00nan;0;0
23974;2269;25;84;44;4;40;.909;3600000;0
23974;2800;1;42;34;5;29;.853;3552000;0
24021;13;7;39;22;4;18;.818;3600000;0
24021;316;7;0;0;0;0;.00nan;0;0
24021;1021;15;0;0;0;0;.00nan;0;0
24021;1128;15;55;42;6;36;.857;3576000;0
23998;737;23;0;0;0;0;.00nan;0;0
23998;1149;12;0;0;0;0;.00nan;0;0
23998;1278;12;61;26;3;23;.885;3600000;0
23998;2375;23;81;41;4;37;.902;3600000;0
24098;277;10;0;0;0;0;.00nan;0;0
24098;318;22;0;0;0;0;.00nan;0;0
24098;691;10;80;39;3;36;.923;3621000;0
24098;1036;22;69;25;2;23;.920;3621000;0
24054;711;3;71;35;3;32;.914;3520000;0
24054;1731;3;0;0;0;0;.00nan;0;0
24054;2016;14;0;0;0;0;.00nan;0;0
24054;2057;14;94;31;1;30;.968;3600000;0
24000;489;19;60;44;6;38;.864;3535000;0
24000;505;17;0;0;0;0;.00nan;0;0
24000;1056;19;50;1;0;1;1.000;65000;0
24000;1333;17;67;26;2;24;.923;3600000;0
23973;734;2;62;33;4;29;.879;3600000;0
23973;735;5;73;32;3;29;.906;3600000;0
23973;1355;2;0;0;0;0;.00nan;0;0
23973;1361;5;0;0;0;0;.00nan;0;0
24008;419;20;75;30;2;28;.933;3600000;0
24008;505;17;47;31;4;27;.871;3586000;0
24008;707;20;0;0;0;0;.00nan;0;0
24008;1333;17;0;0;0;0;.00nan;0;0
24046;1021;15;79;34;3;31;.912;3600000;0
24046;1128;15;0;0;0;0;.00nan;0;0
24046;1149;12;59;28;4;24;.857;3600000;0
24046;1278;12;0;0;0;0;.00nan;0;0
24022;268;1;21;12;4;8;.667;991000;0
24022;295;24;74;24;2;22;.917;3600000;0
24022;812;24;0;0;0;0;.00nan;0;0
24022;2800;1;91;48;3;45;.938;2609000;0
24092;482;6;80;39;3;36;.923;3254000;0
24092;483;6;22;5;3;2;.400;346000;0
24092;710;26;0;0;0;0;.00nan;0;0
24092;1239;26;71;39;4;35;.897;3600000;0
24007;734;2;0;0;0;0;.00nan;0;0
24007;1355;2;100;37;0;37;1.000;3600000;0
24007;1406;21;43;30;4;26;.867;3600000;0
24007;1690;21;0;0;0;0;.00nan;0;0
23977;112;13;0;0;0;0;.00nan;0;0
23977;714;13;38;40;6;34;.850;3600000;0
23977;998;8;63;28;3;25;.893;3600000;0
23977;2266;8;0;0;0;0;.00nan;0;0
24145;735;5;0;0;0;0;.00nan;0;0
24145;1361;5;58;35;5;30;.857;3522000;0
24145;2834;29;82;37;3;34;.919;3600000;0
24145;2947;29;0;0;0;0;.00nan;0;0
23967;727;4;88;30;2;28;.933;3839000;0
23967;1163;0;0;0;0;0;.00nan;0;0
23967;1335;4;0;0;0;0;.00nan;0;0
23967;2804;0;92;42;3;39;.929;3839000;0
24039;103;30;79;46;5;41;.891;3524000;0
24039;487;27;0;0;0;0;.00nan;0;0
24039;2549;30;0;0;0;0;.00nan;0;0
24039;2557;27;60;22;3;19;.864;3600000;0
24057;710;26;62;39;4;35;.897;3890000;0
24057;1239;26;0;0;0;0;.00nan;0;0
24057;2174;18;0;0;0;0;.00nan;0;0
24057;2314;18;77;43;4;39;.907;3900000;0
24018;737;23;100;24;0;24;1.000;3600000;0
24018;783;11;26;20;5;15;.750;889000;0
24018;2375;23;0;0;0;0;.00nan;0;0
24018;2810;11;94;34;1;33;.971;2711000;0
23984;1221;25;0;0;0;0;.00nan;0;0
23984;1406;21;90;42;3;39;.929;3900000;0
23984;1690;21;0;0;0;0;.00nan;0;0
23984;2269;25;88;34;3;31;.912;3900000;0
24095;268;1;0;0;0;0;.00nan;0;0
24095;2016;14;0;0;0;0;.00nan;0;0
24095;2057;14;80;21;1;20;.952;3900000;0
24095;2800;1;100;45;1;44;.978;3900000;0
24009;482;6;49;1;0;1;1.000;212000;0
24009;483;6;41;38;7;31;.816;3388000;0
24009;1149;12;0;0;0;0;.00nan;0;0
24009;1278;12;69;32;3;29;.906;3600000;0
24012;112;13;87;39;4;35;.897;3545000;0
24012;419;20;67;33;3;30;.909;3600000;0
24012;707;20;0;0;0;0;.00nan;0;0
24012;714;13;0;0;0;0;.00nan;0;0
24208;360;16;47;21;3;18;.857;3557000;0
24208;487;27;0;0;0;0;.00nan;0;0
24208;2557;27;82;33;2;31;.939;3600000;0
24208;2687;16;0;0;0;0;.00nan;0;0
24031;429;28;0;0;0;0;.00nan;0;0
24031;1052;9;0;0;0;0;.00nan;0;0
24031;1061;28;99;35;1;34;.971;3600000;0
24031;1332;9;65;30;3;27;.900;3564000;0
24016;727;4;68;30;3;27;.900;3600000;0
24016;998;8;32;17;4;13;.765;1132000;0
24016;1335;4;0;0;0;0;.00nan;0;0
24016;2266;8;44;32;5;27;.844;2468000;0
24058;482;6;47;33;5;28;.848;3600000;0
24058;483;6;0;0;0;0;.00nan;0;0
24058;783;11;24;9;4;5;.556;408000;0
24058;2810;11;88;36;2;34;.944;3148000;0
24052;489;19;0;0;0;0;.00nan;0;0
24052;734;2;0;0;0;0;.00nan;0;0
24052;1056;19;94;42;3;39;.929;3600000;0
24052;1355;2;90;29;1;28;.966;3600000;0
24055;13;7;0;0;0;0;.00nan;0;0
24055;316;7;62;33;4;29;.879;3765000;0
24055;711;3;0;0;0;0;.00nan;0;0
24055;1731;3;89;41;3;38;.927;3765000;0
24049;505;17;0;0;0;0;.00nan;0;0
24049;737;23;62;40;5;35;.875;3600000;0
24049;1333;17;100;28;0;28;1.000;3600000;0
24049;2375;23;0;0;0;0;.00nan;0;0
24045;489;19;0;0;0;0;.00nan;0;0
24045;1056;19;72;21;1;20;.952;3600000;0
24045;2174;18;0;0;0;0;.00nan;0;0
24045;2314;18;97;58;2;56;.966;3600000;0
24072;487;27;100;32;0;32;1.000;3600000;0
24072;711;3;68;34;3;31;.912;3600000;0
24072;1731;3;0;0;0;0;.00nan;0;0
24072;2557;27;0;0;0;0;.00nan;0;0
24025;735;5;0;0;0;0;.00nan;0;0
24025;783;11;100;39;1;38;.974;3600000;0
24025;1361;5;49;21;3;18;.857;3581000;0
24025;2810;11;0;0;0;0;.00nan;0;0
24004;295;24;46;40;6;34;.850;3600000;0
24004;429;28;71;37;3;34;.919;3600000;0
24004;812;24;0;0;0;0;.00nan;0;0
24004;1061;28;0;0;0;0;.00nan;0;0
24050;268;1;91;33;1;32;.970;3600000;0
24050;737;23;0;0;0;0;.00nan;0;0
24050;2375;23;78;40;3;37;.925;3600000;0
24050;2800;1;0;0;0;0;.00nan;0;0
24047;112;13;0;0;0;0;.00nan;0;0
24047;714;13;71;27;2;25;.926;3600000;0
24047;1406;21;0;0;0;0;.00nan;0;0
24047;1690;21;52;33;4;29;.879;3600000;0
24024;318;22;0;0;0;0;.00nan;0;0
24024;505;17;0;0;0;0;.00nan;0;0
24024;1036;22;87;35;2;33;.943;3600000;0
24024;1333;17;65;37;5;32;.865;3600000;0
24116;710;26;0;0;0;0;.00nan;0;0
24116;1052;9;75;39;3;36;.923;3570000;0
24116;1239;26;100;39;1;38;.974;3600000;0
24116;1332;9;0;0;0;0;.00nan;0;0
24087;734;2;29;28;6;22;.786;2484000;0
24087;1355;2;52;14;2;12;.857;1116000;0
24087;2016;14;0;0;0;0;.00nan;0;0
24087;2057;14;99;60;3;57;.950;3600000;0
24080;360;16;0;0;0;0;.00nan;0;0
24080;1021;15;97;39;1;38;.974;3900000;0
24080;1128;15;0;0;0;0;.00nan;0;0
24080;2687;16;98;40;1;39;.975;3900000;0
24235;277;10;0;0;0;0;.00nan;0;0
24235;691;10;70;20;1;19;.950;3812000;0
24235;1149;12;0;0;0;0;.00nan;0;0
24235;1278;12;94;51;2;49;.961;3812000;0
24003;998;8;63;47;6;41;.872;2700000;0
24003;1221;25;0;0;0;0;.00nan;0;0
24003;2266;8;67;10;0;10;1.000;900000;0
24003;2269;25;37;40;7;33;.825;3555000;0
24106;103;30;80;45;5;40;.889;3600000;0
24106;2549;30;0;0;0;0;.00nan;0;0
24106;2834;29;48;44;6;38;.864;3554000;0
24106;2947;29;0;0;0;0;.00nan;0;0
24070;727;4;87;27;1;26;.963;3600000;0
24070;1335;4;0;0;0;0;.00nan;0;0
24070;1406;21;85;38;2;36;.947;3544000;0
24070;1690;21;0;0;0;0;.00nan;0;0
24061;13;7;51;23;3;20;.870;3600000;0
24061;316;7;0;0;0;0;.00nan;0;0
24061;419;20;70;44;5;39;.886;3514000;0
24061;707;20;0;0;0;0;.00nan;0;0
24069;295;24;100;36;0;36;1.000;3600000;0
24069;812;24;0;0;0;0;.00nan;0;0
24069;1163;0;54;35;4;31;.886;3600000;0
24069;2804;0;0;0;0;0;.00nan;0;0
24066;737;23;72;23;1;22;.957;3600000;0
24066;2375;23;0;0;0;0;.00nan;0;0
24066;2834;29;0;0;0;0;.00nan;0;0
24066;2947;29;97;45;2;43;.956;3569000;0
24140;489;19;0;0;0;0;.00nan;0;0
24140;734;2;71;31;3;28;.903;3585000;0
24140;1056;19;92;35;2;33;.943;3600000;0
24140;1355;2;0;0;0;0;.00nan;0;0
24006;1221;25;0;0;0;0;.00nan;0;0
24006;2016;14;85;36;2;34;.944;3900000;0
24006;2057;14;0;0;0;0;.00nan;0;0
24006;2269;25;100;44;2;42;.955;3900000;0
24079;318;22;0;0;0;0;.00nan;0;0
24079;1036;22;33;29;5;24;.828;3600000;0
24079;1149;12;0;0;0;0;.00nan;0;0
24079;1278;12;64;37;4;33;.892;3600000;0
24034;419;20;0;0;0;0;.00nan;0;0
24034;429;28;0;0;0;0;.00nan;0;0
24034;707;20;38;37;6;31;.838;3600000;0
24034;1061;28;75;33;3;30;.909;3600000;0
24017;998;8;0;0;0;0;.00nan;0;0
24017;2174;18;86;31;2;29;.935;3600000;0
24017;2266;8;68;29;3;26;.897;3600000;0
24017;2314;18;0;0;0;0;.00nan;0;0
24089;112;13;94;28;1;27;.964;3600000;0
24089;714;13;0;0;0;0;.00nan;0;0
24089;1021;15;46;22;4;18;.818;3600000;0
24089;1128;15;0;0;0;0;.00nan;0;0
24044;487;27;64;38;5;33;.868;3583000;0
24044;711;3;0;0;0;0;.00nan;0;0
24044;1731;3;65;34;4;30;.882;3600000;0
24044;2557;27;0;0;0;0;.00nan;0;0
24101;268;1;0;0;0;0;.00nan;0;0
24101;710;26;0;0;0;0;.00nan;0;0
24101;1239;26;57;42;5;37;.881;3600000;0
24101;2800;1;97;41;2;39;.951;3600000;0
24051;112;13;0;0;0;0;.00nan;0;0
24051;714;13;68;31;3;28;.903;3589000;0
24051;2174;18;0;0;0;0;.00nan;0;0
24051;2314;18;89;35;1;34;.971;3600000;0
24023;103;30;0;0;0;0;.00nan;0;0
24023;1221;25;82;40;3;37;.925;3900000;0
24023;2269;25;0;0;0;0;.00nan;0;0
24023;2549;30;71;32;3;29;.906;3900000;0
24076;735;5;0;0;0;0;.00nan;0;0
24076;1163;0;0;0;0;0;.00nan;0;0
24076;1361;5;68;24;2;22;.917;3600000;0
24076;2804;0;55;28;4;24;.857;3562000;0
24027;505;17;0;0;0;0;.00nan;0;0
24027;1333;17;86;42;3;39;.929;3900000;0
24027;1406;21;89;38;3;35;.921;3900000;0
24027;1690;21;0;0;0;0;.00nan;0;0
24111;482;6;0;0;0;0;.00nan;0;0
24111;483;6;99;35;1;34;.971;3600000;0
24111;710;26;91;41;2;39;.951;3600000;0
24111;1239;26;0;0;0;0;.00nan;0;0
24197;1021;15;0;0;0;0;.00nan;0;0
24197;1052;9;0;0;0;0;.00nan;0;0
24197;1128;15;58;26;3;23;.885;3600000;0
24197;1332;9;68;38;4;34;.895;3564000;0
24083;727;4;48;33;5;28;.848;3786000;0
24083;1335;4;0;0;0;0;.00nan;0;0
24083;2834;29;71;37;4;33;.892;3748000;0
24083;2947;29;0;0;0;0;.00nan;0;0
24040;277;10;0;0;0;0;.00nan;0;0
24040;691;10;69;20;1;19;.950;3600000;0
24040;783;11;45;31;5;26;.839;3600000;0
24040;2810;11;0;0;0;0;.00nan;0;0
24110;268;1;70;31;3;28;.903;3900000;0
24110;735;5;76;34;3;31;.912;3900000;0
24110;1361;5;0;0;0;0;.00nan;0;0
24110;2800;1;0;0;0;0;.00nan;0;0
24090;13;7;0;0;0;0;.00nan;0;0
24090;103;30;82;24;1;23;.958;3600000;0
24090;316;7;72;25;2;23;.920;3579000;0
24090;2549;30;0;0;0;0;.00nan;0;0
24102;295;24;38;39;7;32;.821;3600000;0
24102;482;6;84;33;2;31;.939;3600000;0
24102;483;6;0;0;0;0;.00nan;0;0
24102;812;24;0;0;0;0;.00nan;0;0
24077;419;20;88;23;1;22;.957;3600000;0
24077;707;20;0;0;0;0;.00nan;0;0
24077;2016;14;62;34;4;30;.882;2594000;0
24077;2057;14;33;11;4;7;.636;1006000;0
24100;13;7;63;24;4;20;.833;3600000;0
24100;316;7;0;0;0;0;.00nan;0;0
24100;711;3;55;3;0;3;1.000;566000;0
24100;1731;3;26;25;6;19;.760;2988000;0
24075;734;2;0;0;0;0;.00nan;0;0
24075;1355;2;29;18;5;13;.722;3600000;0
24075;2174;18;0;0;0;0;.00nan;0;0
24075;2314;18;81;35;2;33;.943;3600000;0
24093;360;16;0;0;0;0;.00nan;0;0
24093;998;8;0;0;0;0;.00nan;0;0
24093;2266;8;91;47;4;43;.915;3600000;0
24093;2687;16;44;34;5;29;.853;3555000;0
24094;318;22;0;0;0;0;.00nan;0;0
24094;783;11;0;0;0;0;.00nan;0;0
24094;1036;22;90;32;2;30;.938;3600000;0
24094;2810;11;88;46;3;43;.935;3591000;0
24115;103;30;69;26;2;24;.923;3722000;0
24115;482;6;0;0;0;0;.00nan;0;0
24115;483;6;94;50;3;47;.940;3722000;0
24115;2549;30;0;0;0;0;.00nan;0;0
24037;1221;25;41;11;2;9;.818;2258000;0
24037;2269;25;9;18;6;12;.667;1342000;0
24037;2834;29;74;34;2;32;.941;3600000;0
24037;2947;29;0;0;0;0;.00nan;0;0
24161;295;24;0;0;0;0;.00nan;0;0
24161;812;24;77;27;1;26;.963;3600000;0
24161;1406;21;68;41;5;36;.878;3600000;0
24161;1690;21;0;0;0;0;.00nan;0;0
24081;419;20;65;46;5;41;.891;3805000;0
24081;707;20;0;0;0;0;.00nan;0;0
24081;1021;15;48;38;6;32;.842;3805000;0
24081;1128;15;0;0;0;0;.00nan;0;0
24257;268;1;0;0;0;0;.00nan;0;0
24257;1149;12;0;0;0;0;.00nan;0;0
24257;1278;12;78;31;2;29;.935;3600000;0
24257;2800;1;90;29;1;28;.966;3600000;0
24099;783;11;100;60;4;56;.933;3900000;0
24099;2174;18;52;29;4;25;.862;3900000;0
24099;2314;18;0;0;0;0;.00nan;0;0
24099;2810;11;0;0;0;0;.00nan;0;0
24078;737;23;44;39;7;32;.821;3672000;0
24078;1052;9;0;0;0;0;.00nan;0;0
24078;1332;9;43;36;6;30;.833;3672000;0
24078;2375;23;0;0;0;0;.00nan;0;0
24064;13;7;0;0;0;0;.00nan;0;0
24064;316;7;90;32;1;31;.969;3600000;0
24064;505;17;0;0;0;0;.00nan;0;0
24064;1333;17;94;40;3;37;.925;3588000;0
24085;710;26;0;0;0;0;.00nan;0;0
24085;1239;26;48;26;4;22;.846;3543000;0
24085;1406;21;0;0;0;0;.00nan;0;0
24085;1690;21;87;38;3;35;.921;3600000;0
24041;277;10;0;0;0;0;.00nan;0;0
24041;429;28;0;0;0;0;.00nan;0;0
24041;691;10;54;34;5;29;.853;3533000;0
24041;1061;28;51;22;3;19;.864;3600000;0
24134;727;4;43;28;4;24;.857;3543000;0
24134;1335;4;0;0;0;0;.00nan;0;0
24134;2834;29;0;0;0;0;.00nan;0;0
24134;2947;29;99;51;3;48;.941;3600000;0
24136;482;6;93;36;1;35;.972;3600000;0
24136;483;6;0;0;0;0;.00nan;0;0
24136;1163;0;50;19;3;16;.842;3536000;0
24136;2804;0;0;0;0;0;.00nan;0;0
24158;1021;15;64;7;0;7;1.000;469000;0
24158;1128;15;57;36;5;31;.861;3131000;0
24158;2016;14;0;0;0;0;.00nan;0;0
24158;2057;14;84;30;2;28;.933;3600000;0
24068;277;10;57;27;3;24;.889;3570000;0
24068;505;17;81;27;2;25;.926;3600000;0
24068;691;10;0;0;0;0;.00nan;0;0
24068;1333;17;0;0;0;0;.00nan;0;0
24107;710;26;77;41;4;37;.902;3513000;0
24107;711;3;0;0;0;0;.00nan;0;0
24107;1239;26;0;0;0;0;.00nan;0;0
24107;1731;3;85;39;2;37;.949;3600000;0
24109;318;22;0;0;0;0;.00nan;0;0
24109;735;5;0;0;0;0;.00nan;0;0
24109;1036;22;62;46;6;40;.870;3600000;0
24109;1361;5;78;28;2;26;.929;3600000;0
24142;295;24;62;18;2;16;.889;3600000;0
24142;812;24;0;0;0;0;.00nan;0;0
24142;2016;14;89;44;4;40;.909;3572000;0
24142;2057;14;0;0;0;0;.00nan;0;0
24130;112;13;86;36;2;34;.944;3900000;0
24130;360;16;81;27;2;25;.926;3900000;0
24130;714;13;0;0;0;0;.00nan;0;0
24130;2687;16;0;0;0;0;.00nan;0;0
24067;429;28;0;0;0;0;.00nan;0;0
24067;737;23;82;43;4;39;.907;3900000;0
24067;1061;28;70;31;4;27;.871;3900000;0
24067;2375;23;0;0;0;0;.00nan;0;0
24096;1163;0;62;27;3;24;.889;3570000;0
24096;2804;0;0;0;0;0;.00nan;0;0
24096;2834;29;96;51;2;49;.961;3600000;0
24096;2947;29;0;0;0;0;.00nan;0;0
24112;482;6;0;0;0;0;.00nan;0;0
24112;483;6;54;42;6;36;.857;3600000;0
24112;489;19;0;0;0;0;.00nan;0;0
24112;1056;19;61;27;3;24;.889;3600000;0
24113;487;27;0;0;0;0;.00nan;0;0
24113;711;3;67;32;3;29;.906;3600000;0
24113;1731;3;0;0;0;0;.00nan;0;0
24113;2557;27;73;28;2;26;.929;3600000;0
24175;734;2;0;0;0;0;.00nan;0;0
24175;998;8;98;43;1;42;.977;3576000;0
24175;1355;2;100;22;0;22;1.000;3600000;0
24175;2266;8;0;0;0;0;.00nan;0;0
24084;1052;9;37;6;2;4;.667;746000;0
24084;1332;9;25;27;6;21;.778;2854000;0
24084;2174;18;0;0;0;0;.00nan;0;0
24084;2314;18;78;37;3;34;.919;3600000;0
24129;735;5;63;28;3;25;.893;3572000;0
24129;1361;5;0;0;0;0;.00nan;0;0
24129;1406;21;89;28;1;27;.964;3600000;0
24129;1690;21;0;0;0;0;.00nan;0;0
24119;103;30;91;31;1;30;.968;3600000;0
24119;429;28;75;27;2;25;.926;3550000;0
24119;1061;28;0;0;0;0;.00nan;0;0
24119;2549;30;0;0;0;0;.00nan;0;0
24121;295;24;0;0;0;0;.00nan;0;0
24121;812;24;52;30;4;26;.867;3600000;0
24121;1021;15;0;0;0;0;.00nan;0;0
24121;1128;15;54;34;5;29;.853;3578000;0
24201;112;13;0;0;0;0;.00nan;0;0
24201;419;20;33;31;6;25;.806;2438000;0
24201;707;20;50;9;1;8;.889;1162000;0
24201;714;13;78;23;1;22;.957;3600000;0
24122;727;4;36;20;5;15;.750;3576000;0
24122;783;11;83;60;6;54;.900;3629000;0
24122;1335;4;0;0;0;0;.00nan;0;0
24122;2810;11;0;0;0;0;.00nan;0;0
24105;737;23;0;0;0;0;.00nan;0;0
24105;1052;9;94;41;2;39;.951;3549000;0
24105;1332;9;0;0;0;0;.00nan;0;0
24105;2375;23;100;38;1;37;.974;3600000;0
24137;268;1;72;33;3;30;.909;3643000;0
24137;277;10;0;0;0;0;.00nan;0;0
24137;691;10;67;31;4;27;.871;3643000;0
24137;2800;1;0;0;0;0;.00nan;0;0
24125;103;30;0;0;0;0;.00nan;0;0
24125;1149;12;0;0;0;0;.00nan;0;0
24125;1278;12;53;30;3;27;.900;3600000;0
24125;2549;30;41;19;4;15;.789;3572000;0
24162;735;5;77;26;1;25;.962;3600000;0
24162;998;8;0;0;0;0;.00nan;0;0
24162;1361;5;0;0;0;0;.00nan;0;0
24162;2266;8;98;48;2;46;.958;3563000;0
24147;268;1;0;0;0;0;.00nan;0;0
24147;727;4;0;0;0;0;.00nan;0;0
24147;1335;4;84;35;3;32;.914;3600000;0
24147;2800;1;100;33;0;33;1.000;3600000;0
24141;360;16;81;38;3;35;.921;3600000;0
24141;2016;14;0;0;0;0;.00nan;0;0
24141;2057;14;44;30;5;25;.833;3582000;0
24141;2687;16;0;0;0;0;.00nan;0;0
24139;1163;0;85;34;2;32;.941;3570000;0
24139;1221;25;0;0;0;0;.00nan;0;0
24139;2269;25;72;23;1;22;.957;3600000;0
24139;2804;0;0;0;0;0;.00nan;0;0
24264;419;20;0;0;0;0;.00nan;0;0
24264;489;19;0;0;0;0;.00nan;0;0
24264;707;20;94;49;2;47;.959;3600000;0
24264;1056;19;44;24;4;20;.833;3600000;0
24071;318;22;0;0;0;0;.00nan;0;0
24071;505;17;0;0;0;0;.00nan;0;0
24071;1036;22;100;26;0;26;1.000;3600000;0
24071;1333;17;62;22;2;20;.909;3539000;0
24118;13;7;44;21;4;17;.810;2264000;0
24118;316;7;70;14;1;13;.929;1336000;0
24118;710;26;0;0;0;0;.00nan;0;0
24118;1239;26;94;35;1;34;.971;3600000;0
24124;783;11;74;40;4;36;.900;3600000;0
24124;1406;21;82;38;2;36;.947;3600000;0
24124;1690;21;0;0;0;0;.00nan;0;0
24124;2810;11;0;0;0;0;.00nan;0;0
24150;112;13;100;36;2;34;.944;3600000;0
24150;714;13;0;0;0;0;.00nan;0;0
24150;2834;29;48;43;7;36;.837;3281000;0
24150;2947;29;36;6;2;4;.667;319000;0
24171;429;28;47;21;3;18;.857;1702000;0
24171;1061;28;32;22;5;17;.773;1898000;0
24171;1221;25;0;0;0;0;.00nan;0;0
24171;2269;25;71;44;5;39;.886;3600000;0
24224;1149;12;0;0;0;0;.00nan;0;0
24224;1278;12;72;24;2;22;.917;3628000;0
24224;2016;14;0;0;0;0;.00nan;0;0
24224;2057;14;97;34;1;33;.971;3628000;0
24133;103;30;51;33;6;27;.818;3206000;0
24133;482;6;0;0;0;0;.00nan;0;0
24133;483;6;100;40;2;38;.950;3600000;0
24133;2549;30;40;8;2;6;.750;394000;0
24126;268;1;0;0;0;0;.00nan;0;0
24126;711;3;0;0;0;0;.00nan;0;0
24126;1731;3;71;30;2;28;.933;3600000;0
24126;2800;1;66;39;4;35;.897;3600000;0
24213;735;5;99;34;1;33;.971;3600000;0
24213;1221;25;50;40;6;34;.850;3600000;0
24213;1361;5;0;0;0;0;.00nan;0;0
24213;2269;25;0;0;0;0;.00nan;0;0
24218;1021;15;60;31;3;28;.903;3900000;0
24218;1128;15;0;0;0;0;.00nan;0;0
24218;1149;12;54;20;3;17;.850;3900000;0
24218;1278;12;0;0;0;0;.00nan;0;0
24176;489;19;65;33;3;30;.909;3900000;0
24176;727;4;91;39;3;36;.923;3900000;0
24176;1056;19;0;0;0;0;.00nan;0;0
24176;1335;4;0;0;0;0;.00nan;0;0
24164;103;30;29;14;4;10;.714;1163000;0
24164;998;8;77;31;2;29;.935;3600000;0
24164;2266;8;0;0;0;0;.00nan;0;0
24164;2549;30;98;31;0;31;1.000;2369000;0
24117;318;22;0;0;0;0;.00nan;0;0
24117;737;23;100;34;1;33;.971;3600000;0
24117;1036;22;95;44;3;41;.932;3520000;0
24117;2375;23;0;0;0;0;.00nan;0;0
24174;360;16;0;0;0;0;.00nan;0;0
24174;1406;21;0;0;0;0;.00nan;0;0
24174;1690;21;63;29;3;26;.897;3600000;0
24174;2687;16;62;34;4;30;.882;3580000;0
24194;112;13;0;0;0;0;.00nan;0;0
24194;714;13;94;36;2;34;.944;3600000;0
24194;2016;14;0;0;0;0;.00nan;0;0
24194;2057;14;88;47;3;44;.936;3559000;0
24073;295;24;91;48;3;45;.938;3600000;0
24073;505;17;0;0;0;0;.00nan;0;0
24073;812;24;0;0;0;0;.00nan;0;0
24073;1333;17;43;26;4;22;.846;3574000;0
24143;1163;0;0;0;0;0;.00nan;0;0
24143;2174;18;0;0;0;0;.00nan;0;0
24143;2314;18;67;28;3;25;.893;3600000;0
24143;2804;0;70;46;5;41;.891;3600000;0
24132;13;7;60;30;4;26;.867;3600000;0
24132;316;7;0;0;0;0;.00nan;0;0
24132;783;11;55;4;0;4;1.000;385000;0
24132;2810;11;40;33;7;26;.788;3215000;0
24123;711;3;0;0;0;0;.00nan;0;0
24123;737;23;50;1;0;1;1.000;265000;0
24123;1731;3;59;30;4;26;.867;3600000;0
24123;2375;23;69;51;6;45;.882;3326000;0
24168;295;24;0;0;0;0;.00nan;0;0
24168;812;24;80;33;2;31;.939;3600000;0
24168;1052;9;0;0;0;0;.00nan;0;0
24168;1332;9;36;34;6;28;.824;3600000;0
24170;360;16;98;40;2;38;.950;3900000;0
24170;998;8;0;0;0;0;.00nan;0;0
24170;2266;8;89;28;2;26;.929;3900000;0
24170;2687;16;0;0;0;0;.00nan;0;0
24196;277;10;0;0;0;0;.00nan;0;0
24196;489;19;0;0;0;0;.00nan;0;0
24196;691;10;35;20;5;15;.750;3600000;0
24196;1056;19;76;33;3;30;.909;3600000;0
24138;429;28;0;0;0;0;.00nan;0;0
24138;710;26;0;0;0;0;.00nan;0;0
24138;1061;28;84;37;3;34;.919;3724000;0
24138;1239;26;86;52;4;48;.923;3724000;0
24097;419;20;48;31;4;27;.871;3600000;0
24097;505;17;28;24;6;18;.750;2290000;0
24097;707;20;0;0;0;0;.00nan;0;0
24097;1333;17;31;8;3;5;.625;1310000;0
24246;735;5;64;36;4;32;.889;3600000;0
24246;1149;12;0;0;0;0;.00nan;0;0
24246;1278;12;92;32;1;31;.969;3600000;0
24246;1361;5;0;0;0;0;.00nan;0;0
24152;727;4;64;37;4;33;.892;3895000;0
24152;734;2;0;0;0;0;.00nan;0;0
24152;1335;4;0;0;0;0;.00nan;0;0
24152;1355;2;92;40;3;37;.925;3895000;0
24144;429;28;43;33;5;28;.848;3680000;0
24144;1061;28;0;0;0;0;.00nan;0;0
24144;2174;18;0;0;0;0;.00nan;0;0
24144;2314;18;67;42;4;38;.905;3680000;0
24212;487;27;54;23;3;20;.870;3711000;0
24212;710;26;99;44;2;42;.955;3711000;0
24212;1239;26;0;0;0;0;.00nan;0;0
24212;2557;27;0;0;0;0;.00nan;0;0
24241;268;1;22;8;4;4;.500;1375000;0
24241;1052;9;89;45;3;42;.933;3600000;0
24241;1332;9;0;0;0;0;.00nan;0;0
24241;2800;1;57;16;2;14;.875;2225000;0
24127;318;22;0;0;0;0;.00nan;0;0
24127;783;11;60;26;3;23;.885;3900000;0
24127;1036;22;97;50;3;47;.940;3900000;0
24127;2810;11;0;0;0;0;.00nan;0;0
24131;13;7;0;0;0;0;.00nan;0;0
24131;277;10;52;17;3;14;.824;3556000;0
24131;316;7;93;29;1;28;.966;3600000;0
24131;691;10;0;0;0;0;.00nan;0;0
24205;2016;14;0;0;0;0;.00nan;0;0
24205;2057;14;98;42;1;41;.976;3900000;0
24205;2834;29;88;36;1;35;.972;3900000;0
24205;2947;29;0;0;0;0;.00nan;0;0
24260;360;16;100;26;0;26;1.000;3600000;0
24260;1221;25;0;0;0;0;.00nan;0;0
24260;2269;25;73;27;2;25;.926;3525000;0
24260;2687;16;0;0;0;0;.00nan;0;0
24114;505;17;0;0;0;0;.00nan;0;0
24114;1333;17;61;26;3;23;.885;3561000;0
24114;2174;18;74;29;2;27;.931;3600000;0
24114;2314;18;0;0;0;0;.00nan;0;0
24146;737;23;0;0;0;0;.00nan;0;0
24146;2375;23;90;29;1;28;.966;3723000;0
24146;2834;29;0;0;0;0;.00nan;0;0
24146;2947;29;83;30;2;28;.933;3723000;0
24179;482;6;0;0;0;0;.00nan;0;0
24179;483;6;82;41;3;38;.927;3600000;0
24179;487;27;0;0;0;0;.00nan;0;0
24179;2557;27;77;29;2;27;.931;3600000;0
24135;13;7;36;32;6;26;.813;3112000;0
24135;316;7;57;3;0;3;1.000;488000;0
24135;1021;15;81;39;3;36;.923;3600000;0
24135;1128;15;0;0;0;0;.00nan;0;0
24251;112;13;0;0;0;0;.00nan;0;0
24251;710;26;0;0;0;0;.00nan;0;0
24251;714;13;100;28;0;28;1.000;3600000;0
24251;1239;26;98;42;2;40;.952;3540000;0
24178;103;30;98;32;1;31;.969;3600000;0
24178;727;4;67;39;5;34;.872;3600000;0
24178;1335;4;0;0;0;0;.00nan;0;0
24178;2549;30;0;0;0;0;.00nan;0;0
24154;711;3;0;0;0;0;.00nan;0;0
24154;1163;0;70;36;3;33;.917;3600000;0
24154;1731;3;27;18;5;13;.722;3577000;0
24154;2804;0;0;0;0;0;.00nan;0;0
24165;482;6;0;0;0;0;.00nan;0;0
24165;483;6;59;39;5;34;.872;3513000;0
24165;734;2;0;0;0;0;.00nan;0;0
24165;1355;2;46;17;3;14;.824;3600000;0
24265;277;10;0;0;0;0;.00nan;0;0
24265;691;10;88;32;2;30;.938;3600000;0
24265;1021;15;0;0;0;0;.00nan;0;0
24265;1128;15;62;27;3;24;.889;3564000;0
24166;998;8;0;0;0;0;.00nan;0;0
24166;1406;21;100;24;0;24;1.000;3600000;0
24166;1690;21;0;0;0;0;.00nan;0;0
24166;2266;8;88;29;1;28;.966;3578000;0
24188;295;24;72;30;3;27;.900;3548000;0
24188;489;19;0;0;0;0;.00nan;0;0
24188;812;24;0;0;0;0;.00nan;0;0
24188;1056;19;94;39;2;37;.949;3600000;0
24155;318;22;0;0;0;0;.00nan;0;0
24155;1036;22;55;35;5;30;.857;3569000;0
24155;1163;0;0;0;0;0;.00nan;0;0
24155;2804;0;96;47;3;44;.936;3600000;0
24193;318;22;100;38;0;38;1.000;3600000;0
24193;482;6;0;0;0;0;.00nan;0;0
24193;483;6;45;32;5;27;.844;3600000;0
24193;1036;22;0;0;0;0;.00nan;0;0
24191;103;30;61;40;4;36;.900;3900000;0
24191;735;5;58;34;4;30;.882;3900000;0
24191;1361;5;0;0;0;0;.00nan;0;0
24191;2549;30;0;0;0;0;.00nan;0;0
24149;13;7;39;5;2;3;.600;303000;0
24149;316;7;42;36;6;30;.833;3297000;0
24149;487;27;0;0;0;0;.00nan;0;0
24149;2557;27;100;22;0;22;1.000;3600000;0
24183;998;8;68;44;5;39;.886;3542000;0
24183;1052;9;87;35;2;33;.943;3600000;0
24183;1332;9;0;0;0;0;.00nan;0;0
24183;2266;8;0;0;0;0;.00nan;0;0
24182;505;17;0;0;0;0;.00nan;0;0
24182;1149;12;0;0;0;0;.00nan;0;0
24182;1278;12;56;27;3;24;.889;3531000;0
24182;1333;17;93;29;1;28;.966;3600000;0
24254;268;1;0;0;0;0;.00nan;0;0
24254;737;23;100;35;0;35;1.000;3600000;0
24254;2375;23;0;0;0;0;.00nan;0;0
24254;2800;1;70;39;3;36;.923;3600000;0
24245;360;16;100;34;0;34;1.000;3600000;0
24245;429;28;0;0;0;0;.00nan;0;0
24245;1061;28;81;31;3;28;.903;3600000;0
24245;2687;16;0;0;0;0;.00nan;0;0
24157;711;3;0;0;0;0;.00nan;0;0
24157;1406;21;100;33;1;32;.970;3600000;0
24157;1690;21;0;0;0;0;.00nan;0;0
24157;1731;3;73;33;3;30;.909;3530000;0
24262;727;4;53;35;5;30;.857;3600000;0
24262;1335;4;0;0;0;0;.00nan;0;0
24262;2016;14;0;0;0;0;.00nan;0;0
24262;2057;14;50;35;6;29;.829;3563000;0
24270;710;26;43;22;4;18;.818;3585000;0
24270;1221;25;0;0;0;0;.00nan;0;0
24270;1239;26;0;0;0;0;.00nan;0;0
24270;2269;25;78;25;2;23;.920;3600000;0
24285;429;28;71;45;4;41;.911;3900000;0
24285;1061;28;0;0;0;0;.00nan;0;0
24285;2016;14;55;30;4;26;.867;3900000;0
24285;2057;14;0;0;0;0;.00nan;0;0
24167;727;4;0;0;0;0;.00nan;0;0
24167;1335;4;100;42;1;41;.976;3600000;0
24167;2174;18;0;0;0;0;.00nan;0;0
24167;2314;18;87;41;2;39;.951;3564000;0
24169;734;2;0;0;0;0;.00nan;0;0
24169;1052;9;0;0;0;0;.00nan;0;0
24169;1332;9;71;36;3;33;.917;3900000;0
24169;1355;2;64;26;3;23;.885;3893000;0
24156;487;27;0;0;0;0;.00nan;0;0
24156;711;3;57;31;4;27;.871;3600000;0
24156;1731;3;0;0;0;0;.00nan;0;0
24156;2557;27;84;41;3;38;.927;3600000;0
24203;277;10;0;0;0;0;.00nan;0;0
24203;482;6;42;41;6;35;.854;3088000;0
24203;483;6;54;12;1;11;.917;512000;0
24203;691;10;84;16;0;16;1.000;3600000;0
24200;268;1;100;43;0;43;1.000;3600000;0
24200;998;8;0;0;0;0;.00nan;0;0
24200;2266;8;83;34;3;31;.912;3600000;0
24200;2800;1;0;0;0;0;.00nan;0;0
24222;295;24;90;40;2;38;.950;3600000;0
24222;489;19;0;0;0;0;.00nan;0;0
24222;812;24;0;0;0;0;.00nan;0;0
24222;1056;19;70;35;3;32;.914;3544000;0
24189;735;5;81;32;1;31;.969;3294000;0
24189;1163;0;58;39;5;34;.872;3663000;0
24189;1361;5;27;5;3;2;.400;369000;0
24189;2804;0;0;0;0;0;.00nan;0;0
24177;419;20;0;0;0;0;.00nan;0;0
24177;707;20;65;36;4;32;.889;3548000;0
24177;1406;21;0;0;0;0;.00nan;0;0
24177;1690;21;74;34;3;31;.912;3600000;0
24160;505;17;0;0;0;0;.00nan;0;0
24160;1333;17;58;26;3;23;.885;3600000;0
24160;2834;29;64;26;2;24;.923;3600000;0
24160;2947;29;0;0;0;0;.00nan;0;0
24187;318;22;100;46;2;44;.957;3600000;0
24187;710;26;0;0;0;0;.00nan;0;0
24187;1036;22;0;0;0;0;.00nan;0;0
24187;1239;26;55;32;4;28;.875;3549000;0
24198;419;20;82;54;6;48;.889;3892000;0
24198;707;20;0;0;0;0;.00nan;0;0
24198;2174;18;0;0;0;0;.00nan;0;0
24198;2314;18;35;31;7;24;.774;3892000;0
24159;711;3;0;0;0;0;.00nan;0;0
24159;1149;12;0;0;0;0;.00nan;0;0
24159;1278;12;68;27;3;24;.889;3600000;0
24159;1731;3;56;33;4;29;.879;3600000;0
24180;998;8;77;39;4;35;.897;3569000;0
24180;1163;0;92;42;2;40;.952;3600000;0
24180;2266;8;0;0;0;0;.00nan;0;0
24180;2804;0;0;0;0;0;.00nan;0;0
24199;13;7;0;0;0;0;.00nan;0;0
24199;316;7;86;34;2;32;.941;3572000;0
24199;735;5;95;35;1;34;.971;3600000;0
24199;1361;5;0;0;0;0;.00nan;0;0
24207;112;13;0;0;0;0;.00nan;0;0
24207;714;13;75;40;5;35;.875;3566000;0
24207;783;11;58;30;4;26;.867;3600000;0
24207;2810;11;0;0;0;0;.00nan;0;0
24248;277;10;0;0;0;0;.00nan;0;0
24248;691;10;57;23;3;20;.870;3721000;0
24248;1406;21;99;47;2;45;.957;3714000;0
24248;1690;21;0;0;0;0;.00nan;0;0
24216;103;30;67;30;2;28;.933;3546000;0
24216;489;19;0;0;0;0;.00nan;0;0
24216;1056;19;96;35;1;34;.971;3600000;0
24216;2549;30;0;0;0;0;.00nan;0;0
24242;737;23;74;34;2;32;.941;3900000;0
24242;1221;25;0;0;0;0;.00nan;0;0
24242;2269;25;89;32;2;30;.938;3900000;0
24242;2375;23;0;0;0;0;.00nan;0;0
24277;727;4;56;34;5;29;.853;3600000;0
24277;1335;4;0;0;0;0;.00nan;0;0
24277;2016;14;0;0;0;0;.00nan;0;0
24277;2057;14;76;54;6;48;.889;3538000;0
24239;103;30;0;0;0;0;.00nan;0;0
24239;419;20;0;0;0;0;.00nan;0;0
24239;707;20;64;23;2;21;.913;3600000;0
24239;2549;30;67;37;3;34;.919;3548000;0
24209;1149;12;0;0;0;0;.00nan;0;0
24209;1278;12;76;34;3;31;.912;3600000;0
24209;2834;29;45;36;6;30;.833;3600000;0
24209;2947;29;0;0;0;0;.00nan;0;0
24210;360;16;66;16;1;15;.938;3600000;0
24210;1163;0;0;0;0;0;.00nan;0;0
24210;2687;16;0;0;0;0;.00nan;0;0
24210;2804;0;71;42;4;38;.905;3600000;0
24151;505;17;0;0;0;0;.00nan;0;0
24151;1021;15;84;28;2;26;.929;3600000;0
24151;1128;15;0;0;0;0;.00nan;0;0
24151;1333;17;43;30;5;25;.833;3600000;0
24186;482;6;0;0;0;0;.00nan;0;0
24186;483;6;74;36;3;33;.917;3520000;0
24186;487;27;0;0;0;0;.00nan;0;0
24186;2557;27;87;32;1;31;.969;3600000;0
24192;783;11;0;0;0;0;.00nan;0;0
24192;1221;25;100;26;0;26;1.000;3600000;0
24192;2269;25;0;0;0;0;.00nan;0;0
24192;2810;11;89;34;1;33;.971;3572000;0
24220;268;1;86;32;2;30;.938;3900000;0
24220;318;22;0;0;0;0;.00nan;0;0
24220;1036;22;100;48;2;46;.958;3900000;0
24220;2800;1;0;0;0;0;.00nan;0;0
24223;13;7;0;0;0;0;.00nan;0;0
24223;316;7;42;28;5;23;.821;3600000;0
24223;710;26;0;0;0;0;.00nan;0;0
24223;1239;26;56;44;6;38;.864;3591000;0
24240;112;13;59;19;2;17;.895;3600000;0
24240;295;24;100;34;1;33;.971;3600000;0
24240;714;13;0;0;0;0;.00nan;0;0
24240;812;24;0;0;0;0;.00nan;0;0
24163;734;2;0;0;0;0;.00nan;0;0
24163;737;23;89;45;4;41;.911;3513000;0
24163;1355;2;88;31;2;29;.935;3600000;0
24163;2375;23;0;0;0;0;.00nan;0;0
24173;1052;9;71;19;1;18;.947;3600000;0
24173;1332;9;0;0;0;0;.00nan;0;0
24173;2174;18;0;0;0;0;.00nan;0;0
24173;2314;18;45;36;5;31;.861;3600000;0
24243;734;2;84;49;5;44;.898;3600000;0
24243;783;11;36;19;4;15;.789;1170000;0
24243;1355;2;0;0;0;0;.00nan;0;0
24243;2810;11;69;25;2;23;.920;2430000;0
24225;112;13;0;0;0;0;.00nan;0;0
24225;429;28;0;0;0;0;.00nan;0;0
24225;714;13;80;39;4;35;.897;3600000;0
24225;1061;28;92;43;3;40;.930;3600000;0
24289;318;22;63;47;6;41;.872;3691000;0
24289;1036;22;0;0;0;0;.00nan;0;0
24289;1962;58;63;44;5;39;.886;3691000;0
24289;2800;1;0;0;0;0;.00nan;0;0
24291;13;7;0;0;0;0;.00nan;0;0
24291;316;7;71;34;3;31;.912;3674000;0
24291;727;4;0;0;0;0;.00nan;0;0
24291;2846;41;57;26;4;22;.846;3674000;0
24293;429;28;32;15;4;11;.733;1868000;0
24293;534;38;57;14;1;13;.929;1732000;0
24293;2016;14;0;0;0;0;.00nan;0;0
24293;2057;14;91;44;2;42;.955;3600000;0
24295;360;16;58;36;4;32;.889;3538000;0
24295;734;2;0;0;0;0;.00nan;0;0
24295;1355;2;67;25;2;23;.920;3600000;0
24295;2687;16;0;0;0;0;.00nan;0;0
24297;735;5;85;48;4;44;.917;3593000;0
24297;1021;15;63;29;3;26;.897;3600000;0
24297;2751;50;0;0;0;0;.00nan;0;0
24297;2841;37;0;0;0;0;.00nan;0;0
24299;277;10;39;31;6;25;.806;3600000;0
24299;812;24;0;0;0;0;.00nan;0;0
24299;1163;0;97;27;0;27;1.000;3600000;0
24299;2804;0;0;0;0;0;.00nan;0;0
24301;737;23;0;0;0;0;.00nan;0;0
24301;2174;18;97;31;1;30;.968;3600000;0
24301;2314;18;0;0;0;0;.00nan;0;0
24301;2375;23;56;40;6;34;.850;3600000;0
24303;112;13;91;31;1;30;.968;3600000;0
24303;482;6;0;0;0;0;.00nan;0;0
24303;483;6;87;39;3;36;.923;3514000;0
24303;1221;25;0;0;0;0;.00nan;0;0
24305;710;26;37;25;5;20;.800;3600000;0
24305;783;11;91;41;3;38;.927;3600000;0
24305;1239;26;0;0;0;0;.00nan;0;0
24305;1344;34;0;0;0;0;.00nan;0;0
24307;487;27;59;26;3;23;.885;3600000;0
24307;1149;12;79;45;5;40;.889;3543000;0
24307;1278;12;0;0;0;0;.00nan;0;0
24307;2557;27;0;0;0;0;.00nan;0;0
24309;0;48;0;0;0;0;.00nan;0;0
24309;998;8;92;49;4;45;.918;3600000;0
24309;2266;8;0;0;0;0;.00nan;0;0
24309;2947;29;100;37;0;37;1.000;3600000;0
24311;103;30;81;36;3;33;.917;3900000;0
24311;1204;43;0;0;0;0;.00nan;0;0
24311;1332;9;92;42;3;39;.929;3900000;0
24311;2848;54;0;0;0;0;.00nan;0;0
24313;711;3;76;26;1;25;.962;3553000;0
24313;1406;21;100;39;0;39;1.000;3600000;0
24313;1690;21;0;0;0;0;.00nan;0;0
24313;1731;3;0;0;0;0;.00nan;0;0
24315;419;20;0;0;0;0;.00nan;0;0
24315;505;17;50;42;6;36;.857;3600000;0
24315;707;20;68;38;3;35;.921;3600000;0
24315;1333;17;0;0;0;0;.00nan;0;0
24317;295;24;74;33;3;30;.909;3600000;0
24317;578;36;58;39;5;34;.872;3600000;0
24317;593;57;0;0;0;0;.00nan;0;0
24317;2269;25;0;0;0;0;.00nan;0;0
24319;112;13;58;29;3;26;.897;3594000;0
24319;489;19;0;0;0;0;.00nan;0;0
24319;1056;19;100;44;2;42;.955;3600000;0
24319;1221;25;0;0;0;0;.00nan;0;0
24321;710;26;51;36;5;31;.861;3600000;0
24321;737;23;76;23;1;22;.957;3600000;0
24321;1239;26;0;0;0;0;.00nan;0;0
24321;2375;23;0;0;0;0;.00nan;0;0
24323;13;7;84;31;2;29;.935;3600000;0
24323;316;7;0;0;0;0;.00nan;0;0
24323;2016;14;59;26;3;23;.885;3595000;0
24323;2057;14;0;0;0;0;.00nan;0;0
24325;482;6;60;33;4;29;.879;3543000;0
24325;483;6;0;0;0;0;.00nan;0;0
24325;727;4;0;0;0;0;.00nan;0;0
24325;2846;41;79;39;3;36;.923;3600000;0
24327;429;28;80;28;2;26;.929;3600000;0
24327;534;38;0;0;0;0;.00nan;0;0
24327;2174;18;60;39;4;35;.897;3526000;0
24327;2314;18;0;0;0;0;.00nan;0;0
24329;0;48;53;3;0;3;1.000;371000;0
24329;360;16;74;22;1;21;.955;3600000;0
24329;2687;16;0;0;0;0;.00nan;0;0
24329;2947;29;28;34;7;27;.794;3229000;0
24331;295;24;0;0;0;0;.00nan;0;0
24331;593;57;68;39;4;35;.897;3565000;0
24331;1149;12;59;24;3;21;.875;3600000;0
24331;1278;12;0;0;0;0;.00nan;0;0
24333;783;11;0;0;0;0;.00nan;0;0
24333;1332;9;54;44;5;39;.886;3600000;0
24333;1344;34;91;23;1;22;.957;3600000;0
24333;2848;54;0;0;0;0;.00nan;0;0
24335;578;36;0;0;0;0;.00nan;0;0
24335;998;8;80;29;2;27;.931;3515000;0
24335;2266;8;0;0;0;0;.00nan;0;0
24335;2269;25;100;54;0;54;1.000;3600000;0
24337;277;10;0;0;0;0;.00nan;0;0
24337;812;24;94;34;1;33;.971;3600000;0
24337;1163;0;36;31;6;25;.806;3600000;0
24337;2804;0;0;0;0;0;.00nan;0;0
24339;318;22;92;18;0;18;1.000;3600000;0
24339;505;17;67;43;5;38;.884;3600000;0
24339;1036;22;0;0;0;0;.00nan;0;0
24339;1333;17;0;0;0;0;.00nan;0;0
24341;419;20;81;51;5;46;.902;3600000;0
24341;707;20;0;0;0;0;.00nan;0;0
24341;734;2;64;15;1;14;.933;3600000;0
24341;1355;2;0;0;0;0;.00nan;0;0
24343;103;30;0;0;0;0;.00nan;0;0
24343;487;27;21;11;4;7;.636;941000;0
24343;1204;43;73;29;3;26;.897;3600000;0
24343;2557;27;70;30;2;28;.933;2659000;0
24345;1406;21;80;21;1;20;.952;3600000;0
24345;1690;21;0;0;0;0;.00nan;0;0
24345;1962;58;0;0;0;0;.00nan;0;0
24345;2800;1;86;49;4;45;.918;3600000;0
24347;735;5;59;33;4;29;.879;2977000;0
24347;1021;15;56;33;4;29;.879;3600000;0
24347;2751;50;0;0;0;0;.00nan;0;0
24347;2841;37;49;12;1;11;.917;588000;0
24349;112;13;0;0;0;0;.00nan;0;0
24349;998;8;0;0;0;0;.00nan;0;0
24349;1221;25;74;42;4;38;.905;3694000;0
24349;2266;8;70;36;3;33;.917;3694000;0
24351;710;26;0;0;0;0;.00nan;0;0
24351;711;3;79;54;5;49;.907;3600000;0
24351;1239;26;77;24;1;23;.958;3600000;0
24351;1731;3;0;0;0;0;.00nan;0;0
24353;1021;15;0;0;0;0;.00nan;0;0
24353;1406;21;0;0;0;0;.00nan;0;0
24353;1690;21;56;37;5;32;.865;3600000;0
24353;2751;50;95;24;0;24;1.000;3600000;0
24355;783;11;100;30;0;30;1.000;3600000;0
24355;1149;12;0;0;0;0;.00nan;0;0
24355;1278;12;91;41;2;39;.951;3536000;0
24355;1344;34;0;0;0;0;.00nan;0;0
24357;505;17;0;0;0;0;.00nan;0;0
24357;578;36;100;36;1;35;.972;3900000;0
24357;1333;17;97;44;1;43;.977;3900000;0
24357;2269;25;0;0;0;0;.00nan;0;0
24359;13;7;0;0;0;0;.00nan;0;0
24359;316;7;82;33;2;31;.939;3600000;0
24359;735;5;0;0;0;0;.00nan;0;0
24359;2841;37;47;44;6;38;.864;3600000;0
24361;360;16;0;0;0;0;.00nan;0;0
24361;1332;9;50;1;0;1;1.000;119000;0
24361;2687;16;40;27;5;22;.815;3600000;0
24361;2848;54;46;42;6;36;.857;3456000;0
24363;0;48;100;35;1;34;.971;3600000;0
24363;734;2;0;0;0;0;.00nan;0;0
24363;1355;2;31;22;5;17;.773;3600000;0
24363;2947;29;0;0;0;0;.00nan;0;0
24365;489;19;71;37;3;34;.919;3600000;0
24365;1056;19;0;0;0;0;.00nan;0;0
24365;2174;18;0;0;0;0;.00nan;0;0
24365;2314;18;67;29;2;27;.931;3600000;0
24367;295;24;60;23;2;21;.913;3539000;0
24367;593;57;0;0;0;0;.00nan;0;0
24367;727;4;100;42;0;42;1.000;3600000;0
24367;2846;41;0;0;0;0;.00nan;0;0
24369;482;6;0;0;0;0;.00nan;0;0
24369;483;6;86;47;4;43;.915;3807000;0
24369;2016;14;0;0;0;0;.00nan;0;0
24369;2057;14;93;46;3;43;.935;3807000;0
24371;487;27;97;44;1;43;.977;3894000;0
24371;1962;58;65;20;2;18;.900;3894000;0
24371;2557;27;0;0;0;0;.00nan;0;0
24371;2800;1;0;0;0;0;.00nan;0;0
24373;419;20;0;0;0;0;.00nan;0;0
24373;429;28;0;0;0;0;.00nan;0;0
24373;534;38;81;21;1;20;.952;3600000;0
24373;707;20;77;43;4;39;.907;3600000;0
24375;318;22;70;36;4;32;.889;3861000;0
24375;737;23;0;0;0;0;.00nan;0;0
24375;1036;22;0;0;0;0;.00nan;0;0
24375;2375;23;96;45;3;42;.933;3831000;0
24377;103;30;100;25;0;25;1.000;3600000;0
24377;1163;0;0;0;0;0;.00nan;0;0
24377;1204;43;0;0;0;0;.00nan;0;0
24377;2804;0;90;39;2;37;.949;3577000;0
24379;711;3;0;0;0;0;.00nan;0;0
24379;1731;3;47;27;4;23;.852;3600000;0
24379;2016;14;77;33;2;31;.939;3600000;0
24379;2057;14;0;0;0;0;.00nan;0;0
24381;1149;12;61;26;2;24;.923;3600000;0
24381;1163;0;53;30;4;26;.867;3574000;0
24381;1278;12;0;0;0;0;.00nan;0;0
24381;2804;0;0;0;0;0;.00nan;0;0
24383;318;22;0;0;0;0;.00nan;0;0
24383;1036;22;87;34;2;32;.941;3600000;0
24383;1962;58;0;0;0;0;.00nan;0;0
24383;2800;1;89;49;3;46;.939;3600000;0
24385;295;24;89;22;0;22;1.000;3600000;0
24385;593;57;0;0;0;0;.00nan;0;0
24385;737;23;88;37;2;35;.946;3569000;0
24385;2375;23;0;0;0;0;.00nan;0;0
24387;419;20;0;0;0;0;.00nan;0;0
24387;707;20;72;37;3;34;.919;3600000;0
24387;783;11;93;39;2;37;.949;3600000;0
24387;1344;34;0;0;0;0;.00nan;0;0
24389;487;27;90;39;3;36;.923;3600000;0
24389;578;36;0;0;0;0;.00nan;0;0
24389;2269;25;69;35;4;31;.886;3545000;0
24389;2557;27;0;0;0;0;.00nan;0;0
24391;505;17;0;0;0;0;.00nan;0;0
24391;1021;15;0;0;0;0;.00nan;0;0
24391;1333;17;80;34;3;31;.912;3600000;0
24391;2751;50;40;20;4;16;.800;3558000;0
24393;727;4;70;40;4;36;.900;3693000;0
24393;1332;9;74;47;5;42;.894;3693000;0
24393;2846;41;0;0;0;0;.00nan;0;0
24393;2848;54;0;0;0;0;.00nan;0;0
24395;13;7;88;27;1;26;.963;3600000;0
24395;316;7;0;0;0;0;.00nan;0;0
24395;998;8;84;40;3;37;.925;3572000;0
24395;2266;8;0;0;0;0;.00nan;0;0
24397;0;48;0;0;0;0;.00nan;0;0
24397;489;19;0;0;0;0;.00nan;0;0
24397;1056;19;55;34;5;29;.853;3600000;0
24397;2947;29;89;32;2;30;.938;3600000;0
24399;112;13;58;33;4;29;.879;3533000;0
24399;734;2;84;35;2;33;.943;3600000;0
24399;1221;25;0;0;0;0;.00nan;0;0
24399;1355;2;0;0;0;0;.00nan;0;0
24401;429;28;0;0;0;0;.00nan;0;0
24401;534;38;55;34;4;30;.882;3600000;0
24401;2174;18;59;22;3;19;.864;3600000;0
24401;2314;18;0;0;0;0;.00nan;0;0
24403;277;10;0;0;0;0;.00nan;0;0
24403;812;24;79;32;2;30;.938;3900000;0
24403;1406;21;82;36;2;34;.944;3900000;0
24403;1690;21;0;0;0;0;.00nan;0;0
24405;103;30;78;36;3;33;.917;3575000;0
24405;482;6;88;40;2;38;.950;3600000;0
24405;483;6;0;0;0;0;.00nan;0;0
24405;1204;43;0;0;0;0;.00nan;0;0
24407;360;16;49;15;3;12;.800;3600000;0
24407;735;5;49;43;7;36;.837;3600000;0
24407;2687;16;0;0;0;0;.00nan;0;0
24407;2841;37;0;0;0;0;.00nan;0;0
24409;277;10;89;21;0;21;1.000;3600000;0
24409;711;3;57;31;3;28;.903;3600000;0
24409;812;24;0;0;0;0;.00nan;0;0
24409;1731;3;0;0;0;0;.00nan;0;0
24411;710;26;91;34;2;32;.941;3600000;0
24411;1021;15;67;28;3;25;.893;3577000;0
24411;1239;26;0;0;0;0;.00nan;0;0
24411;2751;50;0;0;0;0;.00nan;0;0
24413;295;24;89;33;2;31;.939;3600000;0
24413;487;27;0;0;0;0;.00nan;0;0
24413;593;57;0;0;0;0;.00nan;0;0
24413;2557;27;92;39;3;36;.923;3551000;0
24415;318;22;64;29;3;26;.897;3600000;0
24415;998;8;54;28;3;25;.893;3110000;0
24415;1036;22;0;0;0;0;.00nan;0;0
24415;2266;8;34;10;3;7;.700;490000;0
24417;103;30;0;0;0;0;.00nan;0;0
24417;360;16;0;0;0;0;.00nan;0;0
24417;1204;43;41;31;5;26;.839;3600000;0
24417;2687;16;94;41;2;39;.951;3600000;0
24419;429;28;55;31;4;27;.871;3571000;0
24419;534;38;0;0;0;0;.00nan;0;0
24419;735;5;0;0;0;0;.00nan;0;0
24419;2841;37;80;32;2;30;.938;3600000;0
24421;0;48;74;36;3;33;.917;3585000;0
24421;112;13;0;0;0;0;.00nan;0;0
24421;1221;25;85;34;2;32;.941;3600000;0
24421;2947;29;0;0;0;0;.00nan;0;0
24423;419;20;78;35;3;32;.914;3515000;0
24423;707;20;0;0;0;0;.00nan;0;0
24423;1332;9;0;0;0;0;.00nan;0;0
24423;2848;54;95;33;1;32;.970;3600000;0
24425;13;7;0;0;0;0;.00nan;0;0
24425;316;7;97;45;3;42;.933;3600000;0
24425;727;4;0;0;0;0;.00nan;0;0
24425;2846;41;28;27;6;21;.778;3600000;0
24427;578;36;100;40;2;38;.950;3900000;0
24427;734;2;0;0;0;0;.00nan;0;0
24427;1355;2;97;31;2;29;.935;3900000;0
24427;2269;25;0;0;0;0;.00nan;0;0
24429;737;23;0;0;0;0;.00nan;0;0
24429;1406;21;0;0;0;0;.00nan;0;0
24429;1690;21;68;36;5;31;.861;3534000;0
24429;2375;23;67;32;3;29;.906;3600000;0
24431;505;17;100;50;3;47;.940;3900000;0
24431;1333;17;0;0;0;0;.00nan;0;0
24431;2174;18;0;0;0;0;.00nan;0;0
24431;2314;18;75;33;3;30;.909;3900000;0
24433;482;6;0;0;0;0;.00nan;0;0
24433;483;6;69;27;2;25;.926;3600000;0
24433;1962;58;88;47;3;44;.936;3579000;0
24433;2800;1;0;0;0;0;.00nan;0;0
24435;489;19;59;30;4;26;.867;3600000;0
24435;783;11;0;0;0;0;.00nan;0;0
24435;1056;19;0;0;0;0;.00nan;0;0
24435;1344;34;99;35;1;34;.971;3600000;0
24437;1149;12;0;0;0;0;.00nan;0;0
24437;1163;0;0;0;0;0;.00nan;0;0
24437;1278;12;67;29;3;26;.897;3600000;0
24437;2804;0;64;35;4;31;.886;3565000;0
24439;295;24;0;0;0;0;.00nan;0;0
24439;593;57;74;24;2;22;.917;3600000;0
24439;711;3;70;42;4;38;.905;3585000;0
24439;1731;3;0;0;0;0;.00nan;0;0
24441;735;5;58;39;5;34;.872;3582000;0
24441;2016;14;0;0;0;0;.00nan;0;0
24441;2057;14;68;31;3;28;.903;3600000;0
24441;2841;37;0;0;0;0;.00nan;0;0
24443;505;17;82;28;1;27;.964;3600000;0
24443;578;36;0;0;0;0;.00nan;0;0
24443;1333;17;0;0;0;0;.00nan;0;0
24443;2269;25;70;37;4;33;.892;3600000;0
24445;710;26;100;46;0;46;1.000;3600000;0
24445;783;11;63;33;4;29;.879;3600000;0
24445;1239;26;0;0;0;0;.00nan;0;0
24445;1344;34;0;0;0;0;.00nan;0;0
24447;360;16;72;27;2;25;.926;3600000;0
24447;727;4;44;28;4;24;.857;3566000;0
24447;2687;16;0;0;0;0;.00nan;0;0
24447;2846;41;0;0;0;0;.00nan;0;0
24449;318;22;54;21;3;18;.857;3900000;0
24449;1036;22;0;0;0;0;.00nan;0;0
24449;2174;18;88;49;3;46;.939;3900000;0
24449;2314;18;0;0;0;0;.00nan;0;0
24451;277;10;64;33;4;29;.879;3531000;0
24451;812;24;0;0;0;0;.00nan;0;0
24451;998;8;0;0;0;0;.00nan;0;0
24451;2266;8;69;24;2;22;.917;3600000;0
24453;482;6;100;43;3;40;.930;3600000;0
24453;483;6;0;0;0;0;.00nan;0;0
24453;734;2;55;42;5;37;.881;3538000;0
24453;1355;2;0;0;0;0;.00nan;0;0
24455;429;28;67;19;2;17;.895;3600000;0
24455;534;38;0;0;0;0;.00nan;0;0
24455;1406;21;0;0;0;0;.00nan;0;0
24455;1690;21;81;43;3;40;.930;3600000;0
24457;419;20;45;33;6;27;.818;2659000;0
24457;487;27;0;0;0;0;.00nan;0;0
24457;707;20;52;9;1;8;.889;941000;0
24457;2557;27;100;32;0;32;1.000;3600000;0
24459;13;7;100;47;1;46;.979;3600000;0
24459;316;7;0;0;0;0;.00nan;0;0
24459;1021;15;0;0;0;0;.00nan;0;0
24459;2751;50;76;29;2;27;.931;3598000;0
24461;112;13;72;30;3;27;.900;3555000;0
24461;489;19;0;0;0;0;.00nan;0;0
24461;1056;19;80;28;2;26;.929;3600000;0
24461;1221;25;0;0;0;0;.00nan;0;0
24463;103;30;0;0;0;0;.00nan;0;0
24463;1204;43;73;27;2;25;.926;3600000;0
24463;1332;9;69;39;4;35;.897;3555000;0
24463;2848;54;0;0;0;0;.00nan;0;0
24465;737;23;82;50;4;46;.920;3593000;0
24465;1962;58;0;0;0;0;.00nan;0;0
24465;2375;23;0;0;0;0;.00nan;0;0
24465;2800;1;65;28;3;25;.893;3600000;0
24467;0;48;0;0;0;0;.00nan;0;0
24467;1149;12;66;34;4;30;.882;3541000;0
24467;1278;12;0;0;0;0;.00nan;0;0
24467;2947;29;63;23;2;21;.913;3600000;0
24469;489;19;64;31;3;28;.903;3600000;0
24469;1056;19;0;0;0;0;.00nan;0;0
24469;2016;14;69;48;5;43;.896;3600000;0
24469;2057;14;0;0;0;0;.00nan;0;0
24471;419;20;0;0;0;0;.00nan;0;0
24471;707;20;82;40;3;37;.925;3600000;0
24471;2174;18;0;0;0;0;.00nan;0;0
24471;2314;18;38;24;4;20;.833;3543000;0
24473;0;48;92;34;2;32;.941;3600000;0
24473;112;13;0;0;0;0;.00nan;0;0
24473;1221;25;61;34;4;30;.882;3513000;0
24473;2947;29;0;0;0;0;.00nan;0;0
24475;711;3;0;0;0;0;.00nan;0;0
24475;783;11;0;0;0;0;.00nan;0;0
24475;1344;34;100;27;0;27;1.000;3600000;0
24475;1731;3;79;46;4;42;.913;3600000;0
24477;737;23;53;3;0;3;1.000;264000;0
24477;1332;9;0;0;0;0;.00nan;0;0
24477;2375;23;30;30;6;24;.800;3308000;0
24477;2848;54;75;42;4;38;.905;3600000;0
24479;277;10;0;0;0;0;.00nan;0;0
24479;710;26;82;52;5;47;.904;3525000;0
24479;812;24;52;21;3;18;.857;3600000;0
24479;1239;26;0;0;0;0;.00nan;0;0
24481;103;30;100;36;1;35;.972;3897000;0
24481;487;27;0;0;0;0;.00nan;0;0
24481;1204;43;0;0;0;0;.00nan;0;0
24481;2557;27;93;32;2;30;.938;3897000;0
24483;1406;21;74;24;1;23;.958;3600000;0
24483;1690;21;0;0;0;0;.00nan;0;0
24483;1962;58;59;30;3;27;.900;3529000;0
24483;2800;1;0;0;0;0;.00nan;0;0
24485;734;2;0;0;0;0;.00nan;0;0
24485;1021;15;66;44;6;38;.864;3600000;0
24485;1355;2;76;28;2;26;.929;3600000;0
24485;2751;50;0;0;0;0;.00nan;0;0
24487;505;17;0;0;0;0;.00nan;0;0
24487;1163;0;64;26;3;23;.885;3600000;0
24487;1333;17;46;33;6;27;.818;3600000;0
24487;2804;0;0;0;0;0;.00nan;0;0
24489;360;16;0;0;0;0;.00nan;0;0
24489;1149;12;0;0;0;0;.00nan;0;0
24489;1278;12;59;40;5;35;.875;3600000;0
24489;2687;16;89;31;1;30;.968;3600000;0
24491;295;24;32;19;4;15;.789;1673000;0
24491;429;28;48;7;1;6;.857;789000;0
24491;534;38;18;21;6;15;.714;2923000;0
24491;593;57;49;24;4;20;.833;2039000;0
24493;578;36;91;36;1;35;.972;3600000;0
24493;735;5;0;0;0;0;.00nan;0;0
24493;2269;25;0;0;0;0;.00nan;0;0
24493;2841;37;89;37;2;35;.946;3562000;0
24495;482;6;0;0;0;0;.00nan;0;0
24495;483;6;84;56;5;51;.911;3600000;0
24495;727;4;0;0;0;0;.00nan;0;0
24495;2846;41;68;19;2;17;.895;3600000;0
24497;318;22;0;0;0;0;.00nan;0;0
24497;998;8;81;38;3;35;.921;3600000;0
24497;1036;22;68;45;5;40;.889;3520000;0
24497;2266;8;0;0;0;0;.00nan;0;0
28590;429;28;0;0;0;0;.00nan;0;0
28590;1061;28;69;23;2;21;.913;3600000;0
28590;1163;0;75;37;3;34;.919;3600000;0
28590;2804;0;0;0;0;0;.00nan;0;0
28591;1021;15;84;30;2;28;.933;3600000;0
28591;1128;15;0;0;0;0;.00nan;0;0
28591;2174;18;0;0;0;0;.00nan;0;0
28591;2314;18;84;27;1;26;.963;3600000;0
28592;268;1;0;0;0;0;.00nan;0;0
28592;734;2;0;0;0;0;.00nan;0;0
28592;1355;2;84;28;1;27;.964;3600000;0
28592;2800;1;72;37;3;34;.919;3571000;0
28593;727;4;75;52;5;47;.904;3600000;0
28593;1221;25;0;0;0;0;.00nan;0;0
28593;1335;4;0;0;0;0;.00nan;0;0
28593;2269;25;63;25;2;23;.920;3600000;0
28594;112;13;0;0;0;0;.00nan;0;0
28594;277;10;0;0;0;0;.00nan;0;0
28594;691;10;69;19;2;17;.895;3600000;0
28594;714;13;88;40;3;37;.925;3543000;0
28595;489;19;0;0;0;0;.00nan;0;0
28595;1056;19;77;25;1;24;.960;3600000;0
28595;2834;29;94;42;3;39;.929;3575000;0
28595;2947;29;0;0;0;0;.00nan;0;0
28596;295;24;37;27;5;22;.815;3600000;0
28596;487;27;55;15;2;13;.867;1326000;0
28596;812;24;0;0;0;0;.00nan;0;0
28596;2557;27;24;28;6;22;.786;2274000;0
28597;103;30;81;49;3;46;.939;5231000;0
28597;1149;12;0;0;0;0;.00nan;0;0
28597;1278;12;92;48;4;44;.917;5231000;0
28597;2549;30;0;0;0;0;.00nan;0;0
28598;429;28;0;0;0;0;.00nan;0;0
28598;1061;28;65;18;1;17;.944;4473000;0
28598;1163;0;78;39;2;37;.949;4473000;0
28598;2804;0;0;0;0;0;.00nan;0;0
28599;1021;15;100;50;2;48;.960;3600000;0
28599;1128;15;0;0;0;0;.00nan;0;0
28599;2174;18;0;0;0;0;.00nan;0;0
28599;2314;18;56;26;4;22;.846;3524000;0
28600;268;1;60;6;0;6;1.000;682000;0
28600;734;2;0;0;0;0;.00nan;0;0
28600;1355;2;57;29;4;25;.862;3600000;0
28600;2800;1;35;31;6;25;.806;2855000;0
28601;727;4;38;42;7;35;.833;3298000;0
28601;1221;25;0;0;0;0;.00nan;0;0
28601;1335;4;62;7;0;7;1.000;302000;0
28601;2269;25;75;37;4;33;.892;3600000;0
28602;112;13;64;17;1;16;.941;937000;0
28602;277;10;0;0;0;0;.00nan;0;0
28602;691;10;62;26;3;23;.885;3600000;0
28602;714;13;45;35;6;29;.829;2663000;0
28603;489;19;81;32;2;30;.938;3265000;0
28603;1056;19;22;4;3;1;.250;335000;0
28603;2834;29;62;25;2;23;.920;3600000;0
28603;2947;29;0;0;0;0;.00nan;0;0
28604;295;24;64;31;4;27;.871;3600000;0
28604;487;27;0;0;0;0;.00nan;0;0
28604;812;24;0;0;0;0;.00nan;0;0
28604;2557;27;100;33;1;32;.970;3600000;0
28605;103;30;100;37;0;37;1.000;3600000;0
28605;1149;12;0;0;0;0;.00nan;0;0
28605;1278;12;98;42;2;40;.952;3568000;0
28605;2549;30;0;0;0;0;.00nan;0;0
28606;429;28;0;0;0;0;.00nan;0;0
28606;1061;28;100;28;2;26;.929;3600000;0
28606;1163;0;65;40;5;35;.875;3600000;0
28606;2804;0;0;0;0;0;.00nan;0;0
28607;1021;15;68;16;1;15;.938;3600000;0
28607;1128;15;0;0;0;0;.00nan;0;0
28607;2174;18;0;0;0;0;.00nan;0;0
28607;2314;18;82;36;3;33;.917;3547000;0
28608;268;1;0;0;0;0;.00nan;0;0
28608;734;2;0;0;0;0;.00nan;0;0
28608;1355;2;83;39;3;36;.923;3554000;0
28608;2800;1;80;29;2;27;.931;3600000;0
28609;727;4;0;0;0;0;.00nan;0;0
28609;1221;25;0;0;0;0;.00nan;0;0
28609;1335;4;78;28;2;26;.929;3576000;0
28609;2269;25;97;36;1;35;.972;3600000;0
28610;112;13;0;0;0;0;.00nan;0;0
28610;277;10;0;0;0;0;.00nan;0;0
28610;691;10;56;18;2;16;.889;3750000;0
28610;714;13;86;39;3;36;.923;3750000;0
28611;489;19;0;0;0;0;.00nan;0;0
28611;1056;19;71;29;3;26;.897;3600000;0
28611;2834;29;65;36;5;31;.861;3584000;0
28611;2947;29;0;0;0;0;.00nan;0;0
28612;295;24;100;31;0;31;1.000;3600000;0
28612;487;27;0;0;0;0;.00nan;0;0
28612;812;24;0;0;0;0;.00nan;0;0
28612;2557;27;60;38;5;33;.868;3600000;0
28613;103;30;85;31;1;30;.968;3600000;0
28613;1149;12;0;0;0;0;.00nan;0;0
28613;1278;12;66;29;3;26;.897;3562000;0
28613;2549;30;0;0;0;0;.00nan;0;0
28614;429;28;0;0;0;0;.00nan;0;0
28614;1061;28;93;26;1;25;.962;3600000;0
28614;1163;0;57;39;5;34;.872;3600000;0
28614;2804;0;0;0;0;0;.00nan;0;0
28615;1021;15;84;27;1;26;.963;3600000;0
28615;1128;15;0;0;0;0;.00nan;0;0
28615;2174;18;0;0;0;0;.00nan;0;0
28615;2314;18;83;37;3;34;.919;3541000;0
28616;268;1;0;0;0;0;.00nan;0;0
28616;734;2;0;0;0;0;.00nan;0;0
28616;1355;2;80;29;2;27;.931;3600000;0
28616;2800;1;90;44;3;41;.932;3574000;0
28617;727;4;0;0;0;0;.00nan;0;0
28617;1221;25;0;0;0;0;.00nan;0;0
28617;1335;4;69;32;3;29;.906;3600000;0
28617;2269;25;94;55;4;51;.927;3559000;0
28618;112;13;0;0;0;0;.00nan;0;0
28618;277;10;0;0;0;0;.00nan;0;0
28618;691;10;55;13;2;11;.846;3600000;0
28618;714;13;61;35;4;31;.886;3531000;0
28619;489;19;0;0;0;0;.00nan;0;0
28619;1056;19;58;34;5;29;.853;3787000;0
28619;2834;29;69;41;5;36;.878;3515000;0
28619;2947;29;46;5;1;4;.800;272000;0
28620;295;24;63;30;4;26;.867;3595000;0
28620;487;27;0;0;0;0;.00nan;0;0
28620;812;24;0;0;0;0;.00nan;0;0
28620;2557;27;99;49;3;46;.939;3600000;0
28621;103;30;80;26;1;25;.962;3600000;0
28621;1149;12;38;33;6;27;.818;3283000;0
28621;1278;12;27;9;3;6;.667;317000;0
28621;2549;30;0;0;0;0;.00nan;0;0
28670;1021;15;43;32;5;27;.844;4087000;0
28670;1128;15;0;0;0;0;.00nan;0;0
28670;2174;18;0;0;0;0;.00nan;0;0
28670;2314;18;44;41;6;35;.854;4087000;0
28671;268;1;0;0;0;0;.00nan;0;0
28671;734;2;0;0;0;0;.00nan;0;0
28671;1355;2;57;29;4;25;.862;5814000;0
28671;2800;1;84;62;5;57;.919;5814000;0
28672;727;4;0;0;0;0;.00nan;0;0
28672;1221;25;0;0;0;0;.00nan;0;0
28672;1335;4;100;40;2;38;.950;3600000;0
28672;2269;25;53;24;3;21;.875;3584000;0
28673;489;19;0;0;0;0;.00nan;0;0
28673;1056;19;67;36;3;33;.917;3600000;0
28673;2834;29;50;29;4;25;.862;3575000;0
28673;2947;29;0;0;0;0;.00nan;0;0
28674;295;24;48;24;4;20;.833;3600000;0
28674;487;27;0;0;0;0;.00nan;0;0
28674;812;24;0;0;0;0;.00nan;0;0
28674;2557;27;56;38;5;33;.868;3600000;0
28679;727;4;0;0;0;0;.00nan;0;0
28679;1221;25;0;0;0;0;.00nan;0;0
28679;1335;4;100;47;1;46;.979;3600000;0
28679;2269;25;55;35;5;30;.857;3600000;0
28680;295;24;88;33;2;31;.939;3587000;0
28680;487;27;0;0;0;0;.00nan;0;0
28680;812;24;0;0;0;0;.00nan;0;0
28680;2557;27;92;37;1;36;.973;3600000;0
28683;727;4;0;0;0;0;.00nan;0;0
28683;1221;25;0;0;0;0;.00nan;0;0
28683;1335;4;60;32;4;28;.875;3567000;0
28683;2269;25;88;47;3;44;.936;3600000;0
28684;295;24;68;21;1;20;.952;3600000;0
28684;487;27;0;0;0;0;.00nan;0;0
28684;812;24;0;0;0;0;.00nan;0;0
28684;2557;27;82;33;2;31;.939;3600000;0
28695;429;28;0;0;0;0;.00nan;0;0
28695;1021;15;67;33;4;29;.879;3917000;0
28695;1061;28;46;32;5;27;.844;3917000;0
28695;1128;15;0;0;0;0;.00nan;0;0
28696;734;2;0;0;0;0;.00nan;0;0
28696;1221;25;0;0;0;0;.00nan;0;0
28696;1355;2;100;39;1;38;.974;3600000;0
28696;2269;25;62;27;3;24;.889;3549000;0
28697;277;10;0;0;0;0;.00nan;0;0
28697;489;19;0;0;0;0;.00nan;0;0
28697;691;10;74;30;3;27;.900;3600000;0
28697;1056;19;100;24;0;24;1.000;3600000;0
28698;103;30;55;32;5;27;.844;3555000;0
28698;295;24;66;33;4;29;.879;3600000;0
28698;812;24;0;0;0;0;.00nan;0;0
28698;2549;30;0;0;0;0;.00nan;0;0
28699;429;28;0;0;0;0;.00nan;0;0
28699;1021;15;78;38;3;35;.921;3579000;0
28699;1061;28;71;27;2;25;.926;3600000;0
28699;1128;15;0;0;0;0;.00nan;0;0
28700;734;2;0;0;0;0;.00nan;0;0
28700;1221;25;0;0;0;0;.00nan;0;0
28700;1355;2;72;33;3;30;.909;3600000;0
28700;2269;25;83;56;5;51;.911;3568000;0
28701;277;10;0;0;0;0;.00nan;0;0
28701;489;19;0;0;0;0;.00nan;0;0
28701;691;10;42;24;4;20;.833;3745000;0
28701;1056;19;58;35;5;30;.857;3745000;0
28702;103;30;45;20;3;17;.850;3600000;0
28702;295;24;75;48;5;43;.896;3574000;0
28702;812;24;0;0;0;0;.00nan;0;0
28702;2549;30;0;0;0;0;.00nan;0;0
28703;429;28;0;0;0;0;.00nan;0;0
28703;1021;15;69;35;4;31;.886;4161000;0
28703;1061;28;72;46;5;41;.891;4161000;0
28703;1128;15;0;0;0;0;.00nan;0;0
28704;734;2;49;1;0;1;1.000;348000;0
28704;1221;25;0;0;0;0;.00nan;0;0
28704;1355;2;51;36;6;30;.833;3234000;0
28704;2269;25;52;34;5;29;.853;3600000;0
28705;277;10;0;0;0;0;.00nan;0;0
28705;489;19;0;0;0;0;.00nan;0;0
28705;691;10;64;14;1;13;.929;3600000;0
28705;1056;19;98;54;2;52;.963;3578000;0
28706;103;30;79;34;3;31;.912;3600000;0
28706;295;24;53;33;4;29;.879;3544000;0
28706;812;24;0;0;0;0;.00nan;0;0
28706;2549;30;0;0;0;0;.00nan;0;0
28707;429;28;0;0;0;0;.00nan;0;0
28707;1021;15;62;23;2;21;.913;3600000;0
28707;1061;28;40;28;4;24;.857;3516000;0
28707;1128;15;0;0;0;0;.00nan;0;0
28708;734;2;0;0;0;0;.00nan;0;0
28708;1221;25;0;0;0;0;.00nan;0;0
28708;1355;2;92;37;3;34;.919;3571000;0
28708;2269;25;97;36;1;35;.972;3600000;0
28709;277;10;0;0;0;0;.00nan;0;0
28709;489;19;0;0;0;0;.00nan;0;0
28709;691;10;60;13;1;12;.923;3600000;0
28709;1056;19;79;34;3;31;.912;3570000;0
28710;103;30;86;41;4;37;.902;3556000;0
28710;295;24;76;29;2;27;.931;3600000;0
28710;812;24;0;0;0;0;.00nan;0;0
28710;2549;30;0;0;0;0;.00nan;0;0
28731;429;28;0;0;0;0;.00nan;0;0
28731;1021;15;42;34;6;28;.824;2823000;0
28731;1061;28;100;24;0;24;1.000;3600000;0
28731;1128;15;54;7;1;6;.857;777000;0
28732;734;2;0;0;0;0;.00nan;0;0
28732;1221;25;0;0;0;0;.00nan;0;0
28732;1355;2;96;36;1;35;.972;3900000;0
28732;2269;25;79;34;2;32;.941;3900000;0
28733;277;10;0;0;0;0;.00nan;0;0
28733;489;19;0;0;0;0;.00nan;0;0
28733;691;10;80;24;2;22;.917;3681000;0
28733;1056;19;93;45;3;42;.933;3681000;0
28734;103;30;34;23;5;18;.783;3565000;0
28734;295;24;94;53;4;49;.925;3600000;0
28734;812;24;0;0;0;0;.00nan;0;0
28734;2549;30;50;0;0;0;.00nan;9000;0
28739;429;28;0;0;0;0;.00nan;0;0
28739;1021;15;0;0;0;0;.00nan;0;0
28739;1061;28;59;36;5;31;.861;4288000;0
28739;1128;15;50;33;4;29;.879;4292000;0
28740;734;2;0;0;0;0;.00nan;0;0
28740;1221;25;0;0;0;0;.00nan;0;0
28740;1355;2;47;38;6;32;.842;3600000;0
28740;2269;25;80;29;1;28;.966;3600000;0
28741;103;30;76;24;2;22;.917;3600000;0
28741;295;24;69;47;5;42;.894;3600000;0
28741;812;24;0;0;0;0;.00nan;0;0
28741;2549;30;0;0;0;0;.00nan;0;0
28744;734;2;0;0;0;0;.00nan;0;0
28744;1221;25;0;0;0;0;.00nan;0;0
28744;1355;2;52;28;4;24;.857;3600000;0
28744;2269;25;49;37;5;32;.865;3600000;0
28745;103;30;62;36;5;31;.861;3570000;0
28745;295;24;91;37;3;34;.919;3600000;0
28745;812;24;0;0;0;0;.00nan;0;0
28745;2549;30;0;0;0;0;.00nan;0;0
28750;734;2;0;0;0;0;.00nan;0;0
28750;1021;15;0;0;0;0;.00nan;0;0
28750;1128;15;51;29;5;24;.828;3600000;0
28750;1355;2;100;37;1;36;.973;3600000;0
28751;277;10;0;0;0;0;.00nan;0;0
28751;295;24;42;31;5;26;.839;3533000;0
28751;691;10;76;29;3;26;.897;3600000;0
28751;812;24;0;0;0;0;.00nan;0;0
28752;734;2;0;0;0;0;.00nan;0;0
28752;1021;15;0;0;0;0;.00nan;0;0
28752;1128;15;79;30;2;28;.933;3600000;0
28752;1355;2;73;32;3;29;.906;3543000;0
28753;277;10;0;0;0;0;.00nan;0;0
28753;295;24;77;41;4;37;.902;3553000;0
28753;691;10;66;27;3;24;.889;3600000;0
28753;812;24;0;0;0;0;.00nan;0;0
28754;734;2;0;0;0;0;.00nan;0;0
28754;1021;15;0;0;0;0;.00nan;0;0
28754;1128;15;68;20;1;19;.950;3600000;0
28754;1355;2;74;40;4;36;.900;3600000;0
28755;277;10;0;0;0;0;.00nan;0;0
28755;295;24;97;60;3;57;.950;3600000;0
28755;691;10;96;19;0;19;1.000;3600000;0
28755;812;24;0;0;0;0;.00nan;0;0
28756;734;2;0;0;0;0;.00nan;0;0
28756;1021;15;0;0;0;0;.00nan;0;0
28756;1128;15;95;30;0;30;1.000;3600000;0
28756;1355;2;97;46;2;44;.957;3557000;0
28757;277;10;0;0;0;0;.00nan;0;0
28757;295;24;74;48;5;43;.896;3600000;0
28757;691;10;75;24;1;23;.958;3600000;0
28757;812;24;0;0;0;0;.00nan;0;0
28767;734;2;0;0;0;0;.00nan;0;0
28767;1021;15;0;0;0;0;.00nan;0;0
28767;1128;15;51;25;3;22;.880;3600000;0
28767;1355;2;81;55;6;49;.891;3600000;0
28768;277;10;0;0;0;0;.00nan;0;0
28768;691;10;71;24;2;22;.917;3600000;0
28768;1021;15;0;0;0;0;.00nan;0;0
28768;1128;15;72;43;5;38;.884;3600000;0
28769;277;10;0;0;0;0;.00nan;0;0
28769;691;10;100;24;0;24;1.000;3600000;0
28769;1021;15;0;0;0;0;.00nan;0;0
28769;1128;15;87;30;1;29;.967;3578000;0
28770;277;10;0;0;0;0;.00nan;0;0
28770;691;10;84;28;1;27;.964;3600000;0
28770;1021;15;0;0;0;0;.00nan;0;0
28770;1128;15;68;29;2;27;.931;3600000;0
28771;277;10;0;0;0;0;.00nan;0;0
28771;691;10;63;27;3;24;.889;3600000;0
28771;1021;15;0;0;0;0;.00nan;0;0
28771;1128;15;28;29;6;23;.793;3600000;0
24509;2033;51;87;24;1;23;.958;3600000;0
24509;2035;32;60;41;5;36;.878;3600000;0
24509;2458;32;0;0;0;0;.00nan;0;0
24509;2940;51;0;0;0;0;.00nan;0;0
24515;35;59;83;35;2;33;.943;3900000;0
24515;2598;50;98;43;2;41;.953;3900000;0
24515;2670;59;0;0;0;0;.00nan;0;0
24515;5398;50;0;0;0;0;.00nan;0;0
24506;771;34;38;25;5;20;.800;3545000;0
24506;1002;34;0;0;0;0;.00nan;0;0
24506;1911;31;56;30;4;26;.867;3600000;0
24506;2936;31;0;0;0;0;.00nan;0;0
24536;281;57;100;36;0;36;1.000;3600000;0
24536;427;54;0;0;0;0;.00nan;0;0
24536;1875;37;25;5;3;2;.400;381000;0
24536;2591;37;48;37;5;32;.865;3219000;0
24546;1865;61;54;38;5;33;.868;3546000;0
24546;1890;61;0;0;0;0;.00nan;0;0
24546;2840;46;68;36;3;33;.917;3600000;0
24546;4916;46;0;0;0;0;.00nan;0;0
24551;430;56;64;20;2;18;.900;3600000;0
24551;2081;56;0;0;0;0;.00nan;0;0
24551;2641;48;48;29;4;25;.862;3548000;0
24551;4977;48;0;0;0;0;.00nan;0;0
24539;534;38;0;0;0;0;.00nan;0;0
24539;1040;49;75;48;4;44;.917;3789000;0
24539;4968;41;47;34;5;29;.853;3789000;0
24539;6353;41;0;0;0;0;.00nan;0;0
24578;2246;42;72;26;2;24;.923;3900000;0
24578;2615;40;0;0;0;0;.00nan;0;0
24578;2878;42;0;0;0;0;.00nan;0;0
24578;2954;40;100;49;2;47;.959;3900000;0
24498;1016;33;63;29;3;26;.897;3550000;0
24498;2192;60;67;21;1;20;.952;3600000;0
24498;2654;60;0;0;0;0;.00nan;0;0
24498;3987;33;0;0;0;0;.00nan;0;0
24501;691;10;100;31;0;31;1.000;3600000;0
24501;1279;49;70;21;1;20;.952;3569000;0
24501;2273;49;0;0;0;0;.00nan;0;0
24501;2538;53;0;0;0;0;.00nan;0;0
24502;1234;39;77;20;1;19;.950;2718000;0
24502;1901;39;16;8;4;4;.500;882000;0
24502;2079;44;0;0;0;0;.00nan;0;0
24502;2916;44;87;34;2;32;.941;3600000;0
24505;578;36;63;22;3;19;.864;3559000;0
24505;599;36;0;0;0;0;.00nan;0;0
24505;907;57;77;27;1;26;.963;3600000;0
24505;1694;57;0;0;0;0;.00nan;0;0
24504;1820;58;0;0;0;0;.00nan;0;0
24504;1934;45;0;0;0;0;.00nan;0;0
24504;2532;58;73;39;3;36;.923;3600000;0
24504;2834;29;59;38;4;34;.895;3563000;0
24611;35;59;0;0;0;0;.00nan;0;0
24611;2246;42;0;0;0;0;.00nan;0;0
24611;2670;59;92;48;3;45;.938;3711000;0
24611;2878;42;64;25;2;23;.920;3711000;0
24581;2598;50;0;0;0;0;.00nan;0;0
24581;2840;46;0;0;0;0;.00nan;0;0
24581;4916;46;58;25;2;23;.920;3600000;0
24581;5398;50;38;30;5;25;.833;3600000;0
24500;281;57;99;42;2;40;.952;3600000;0
24500;427;54;0;0;0;0;.00nan;0;0
24500;1204;43;20;21;6;15;.714;3600000;0
24500;1988;43;0;0;0;0;.00nan;0;0
24544;534;38;50;31;4;27;.871;3550000;0
24544;578;36;0;0;0;0;.00nan;0;0
24544;599;36;60;29;3;26;.897;3600000;0
24544;1040;49;0;0;0;0;.00nan;0;0
24499;771;34;0;0;0;0;.00nan;0;0
24499;1002;34;47;29;5;24;.828;3600000;0
24499;2192;60;0;0;0;0;.00nan;0;0
24499;2654;60;77;26;2;24;.923;3600000;0
24507;2033;51;0;0;0;0;.00nan;0;0
24507;2079;44;38;25;5;20;.800;3600000;0
24507;2916;44;0;0;0;0;.00nan;0;0
24507;2940;51;84;41;4;37;.902;3600000;0
24548;691;10;100;33;0;33;1.000;3600000;0
24548;2538;53;0;0;0;0;.00nan;0;0
24548;4839;54;0;0;0;0;.00nan;0;0
24548;7142;54;63;36;4;32;.889;3600000;0
24893;401;47;0;0;0;0;.00nan;0;0
24893;1016;33;0;0;0;0;.00nan;0;0
24893;1060;47;77;29;2;27;.931;3541000;0
24893;3987;33;77;29;1;28;.966;3600000;0
24511;1820;58;70;36;4;32;.889;3714000;0
24511;2035;32;0;0;0;0;.00nan;0;0
24511;2458;32;69;40;5;35;.875;3714000;0
24511;2532;58;0;0;0;0;.00nan;0;0
24508;1875;37;29;19;6;13;.684;1512000;0
24508;2591;37;32;19;4;15;.789;2088000;0
24508;2615;40;100;33;0;33;1.000;3600000;0
24508;2954;40;0;0;0;0;.00nan;0;0
24510;692;35;0;0;0;0;.00nan;0;0
24510;769;35;90;28;1;27;.964;3600000;0
24510;1911;31;0;0;0;0;.00nan;0;0
24510;2936;31;61;26;2;24;.923;3600000;0
24517;1234;39;0;0;0;0;.00nan;0;0
24517;1311;55;100;21;0;21;1.000;3600000;0
24517;1901;39;72;29;2;27;.931;3546000;0
24517;1971;55;0;0;0;0;.00nan;0;0
24514;907;57;0;0;0;0;.00nan;0;0
24514;1279;49;0;0;0;0;.00nan;0;0
24514;1694;57;58;35;4;31;.886;3543000;0
24514;2273;49;82;39;3;36;.923;3600000;0
24555;692;35;98;51;1;50;.980;3586000;0
24555;769;35;0;0;0;0;.00nan;0;0
24555;2641;48;0;0;0;0;.00nan;0;0
24555;4977;48;99;25;0;25;1.000;3600000;0
24728;401;47;73;41;3;38;.927;3581000;0
24728;1060;47;0;0;0;0;.00nan;0;0
24728;4839;54;77;24;1;23;.958;3600000;0
24728;7142;54;0;0;0;0;.00nan;0;0
24564;1204;43;0;0;0;0;.00nan;0;0
24564;1988;43;54;28;3;25;.893;3524000;0
24564;4968;41;0;0;0;0;.00nan;0;0
24564;6353;41;94;36;1;35;.972;3600000;0
24519;430;56;73;28;2;26;.929;3600000;0
24519;1865;61;75;34;3;31;.912;3588000;0
24519;1890;61;0;0;0;0;.00nan;0;0
24519;2081;56;0;0;0;0;.00nan;0;0
24538;1234;39;71;37;3;34;.919;3646000;0
24538;1901;39;0;0;0;0;.00nan;0;0
24538;2615;40;64;31;4;27;.871;3646000;0
24538;2954;40;0;0;0;0;.00nan;0;0
25626;578;36;72;21;2;19;.905;3600000;0
25626;599;36;0;0;0;0;.00nan;0;0
25626;2641;48;0;0;0;0;.00nan;0;0
25626;4977;48;57;34;4;30;.882;3588000;0
24516;907;57;100;30;0;30;1.000;3600000;0
24516;1016;33;90;31;1;30;.968;3574000;0
24516;1694;57;0;0;0;0;.00nan;0;0
24516;3987;33;0;0;0;0;.00nan;0;0
25607;534;38;76;20;1;19;.950;3600000;0
25607;1040;49;0;0;0;0;.00nan;0;0
25607;2079;44;49;19;2;17;.895;3560000;0
25607;2916;44;0;0;0;0;.00nan;0;0
24522;281;57;49;35;6;29;.829;3549000;0
24522;427;54;50;0;0;0;.00nan;15000;0
24522;771;34;42;27;5;22;.815;3600000;0
24522;1002;34;0;0;0;0;.00nan;0;0
24569;1311;55;88;32;3;29;.906;3600000;0
24569;1875;37;0;0;0;0;.00nan;0;0
24569;1971;55;0;0;0;0;.00nan;0;0
24569;2591;37;34;42;7;35;.833;3600000;0
25610;430;56;0;0;0;0;.00nan;0;0
25610;2081;56;47;31;5;26;.839;3600000;0
25610;2840;46;100;21;0;21;1.000;3600000;0
25610;4916;46;0;0;0;0;.00nan;0;0
24668;578;36;0;0;0;0;.00nan;0;0
24668;599;36;73;25;1;24;.960;3600000;0
24668;2598;50;57;34;4;30;.882;3600000;0
24668;5398;50;0;0;0;0;.00nan;0;0
24567;1016;33;0;0;0;0;.00nan;0;0
24567;2615;40;0;0;0;0;.00nan;0;0
24567;2954;40;45;25;4;21;.840;3600000;0
24567;3987;33;78;30;2;28;.933;3600000;0
24561;1279;49;0;0;0;0;.00nan;0;0
24561;1875;37;32;27;6;21;.778;1715000;0
24561;2273;49;66;31;4;27;.871;3600000;0
24561;2591;37;26;13;4;9;.692;1885000;0
24907;1911;31;64;35;4;31;.886;3518000;0
24907;2840;46;0;0;0;0;.00nan;0;0
24907;2936;31;0;0;0;0;.00nan;0;0
24907;4916;46;66;25;2;23;.920;3600000;0
24574;1311;55;0;0;0;0;.00nan;0;0
24574;1971;55;78;22;1;21;.955;3600000;0
24574;4968;41;57;23;2;21;.913;3544000;0
24574;6353;41;0;0;0;0;.00nan;0;0
24503;2192;60;52;22;3;19;.864;3600000;0
24503;2246;42;47;32;5;27;.844;3211000;0
24503;2654;60;0;0;0;0;.00nan;0;0
24503;2878;42;49;1;0;1;1.000;320000;0
24526;1204;43;89;50;4;46;.920;3600000;0
24526;1234;39;0;0;0;0;.00nan;0;0
24526;1901;39;50;40;5;35;.875;3600000;0
24526;1988;43;0;0;0;0;.00nan;0;0
24520;907;57;17;31;7;24;.774;3539000;0
24520;1694;57;49;1;0;1;1.000;61000;0
24520;4839;54;0;0;0;0;.00nan;0;0
24520;7142;54;91;36;2;34;.944;3600000;0
24535;692;35;61;36;5;31;.861;3600000;0
24535;769;35;0;0;0;0;.00nan;0;0
24535;1934;45;50;0;0;0;.00nan;16000;0
24535;2834;29;49;33;6;27;.818;3578000;0
24534;401;47;0;0;0;0;.00nan;0;0
24534;1060;47;71;36;3;33;.917;3600000;0
24534;2079;44;0;0;0;0;.00nan;0;0
24534;2916;44;51;26;4;22;.846;3554000;0
24512;771;34;0;0;0;0;.00nan;0;0
24512;1002;34;71;38;3;35;.921;3900000;0
24512;1865;61;84;33;3;30;.909;3900000;0
24512;1890;61;0;0;0;0;.00nan;0;0
24518;35;59;72;36;3;33;.917;3600000;0
24518;1820;58;0;0;0;0;.00nan;0;0
24518;2532;58;45;28;4;24;.857;3543000;0
24518;2670;59;0;0;0;0;.00nan;0;0
24537;281;57;0;0;0;0;.00nan;0;0
24537;427;54;66;30;3;27;.900;3578000;0
24537;2033;51;68;19;1;18;.947;3600000;0
24537;2940;51;0;0;0;0;.00nan;0;0
24560;430;56;0;0;0;0;.00nan;0;0
24560;2081;56;89;49;4;45;.918;3600000;0
24560;2192;60;61;15;1;14;.933;3600000;0
24560;2654;60;0;0;0;0;.00nan;0;0
24757;2598;50;0;0;0;0;.00nan;0;0
24757;4839;54;88;40;2;38;.950;3900000;0
24757;5398;50;96;43;2;41;.953;3900000;0
24757;7142;54;0;0;0;0;.00nan;0;0
24531;1279;49;89;41;3;38;.927;3579000;0
24531;2273;49;0;0;0;0;.00nan;0;0
24531;4968;41;0;0;0;0;.00nan;0;0
24531;6353;41;79;26;2;24;.923;3600000;0
24513;1865;61;0;0;0;0;.00nan;0;0
24513;1890;61;91;29;1;28;.966;3600000;0
24513;2035;32;0;0;0;0;.00nan;0;0
24513;2458;32;62;31;3;28;.903;3600000;0
24562;2033;51;0;0;0;0;.00nan;0;0
24562;2641;48;50;19;3;16;.842;3600000;0
24562;2940;51;68;40;4;36;.900;3583000;0
24562;4977;48;0;0;0;0;.00nan;0;0
24521;691;10;37;33;6;27;.818;3600000;0
24521;1820;58;0;0;0;0;.00nan;0;0
24521;2532;58;83;47;3;44;.936;3600000;0
24521;2538;53;0;0;0;0;.00nan;0;0
24523;35;59;81;45;3;42;.933;3600000;0
24523;1911;31;53;33;4;29;.879;3581000;0
24523;2670;59;0;0;0;0;.00nan;0;0
24523;2936;31;0;0;0;0;.00nan;0;0
25641;281;57;93;35;1;34;.971;3600000;0
25641;427;54;0;0;0;0;.00nan;0;0
25641;2840;46;67;43;5;38;.884;3600000;0
25641;4916;46;0;0;0;0;.00nan;0;0
24524;1202;37;0;0;0;0;.00nan;0;0
24524;1875;37;50;18;3;15;.833;3600000;0
24524;2035;32;75;53;5;48;.906;3600000;0
24524;2458;32;0;0;0;0;.00nan;0;0
24598;578;36;0;0;0;0;.00nan;0;0
24598;599;36;91;22;0;22;1.000;3600000;0
24598;2246;42;88;37;2;35;.946;3544000;0
24598;2878;42;0;0;0;0;.00nan;0;0
24547;401;47;0;0;0;0;.00nan;0;0
24547;534;38;67;15;1;14;.933;3600000;0
24547;1040;49;0;0;0;0;.00nan;0;0
24547;1060;47;68;36;3;33;.917;3579000;0
24605;1934;45;60;34;4;30;.882;3900000;0
24605;2641;48;0;0;0;0;.00nan;0;0
24605;2834;29;0;0;0;0;.00nan;0;0
24605;4977;48;94;48;4;44;.917;3900000;0
24532;771;34;84;48;3;45;.938;3600000;0
24532;907;57;0;0;0;0;.00nan;0;0
24532;1002;34;0;0;0;0;.00nan;0;0
24532;1694;57;88;22;0;22;1.000;3600000;0
24577;1204;43;0;0;0;0;.00nan;0;0
24577;1311;55;67;37;4;33;.892;3555000;0
24577;1971;55;0;0;0;0;.00nan;0;0
24577;1988;43;85;35;2;33;.943;3600000;0
24836;430;56;78;37;3;34;.919;3669000;0
24836;2081;56;0;0;0;0;.00nan;0;0
24836;4839;54;0;0;0;0;.00nan;0;0
24836;7142;54;51;31;4;27;.871;3669000;0
24527;1820;58;100;36;1;35;.972;3600000;0
24527;2033;51;62;37;5;32;.865;3600000;0
24527;2532;58;0;0;0;0;.00nan;0;0
24527;2940;51;0;0;0;0;.00nan;0;0
24528;692;35;0;0;0;0;.00nan;0;0
24528;769;35;100;53;1;52;.981;3600000;0
24528;1865;61;39;28;6;22;.786;3600000;0
24528;1890;61;0;0;0;0;.00nan;0;0
24579;1016;33;98;40;2;38;.950;3545000;0
24579;2615;40;89;27;1;26;.963;3600000;0
24579;2954;40;0;0;0;0;.00nan;0;0
24579;3987;33;0;0;0;0;.00nan;0;0
25167;907;57;0;0;0;0;.00nan;0;0
25167;1202;37;84;30;2;28;.933;3900000;0
25167;1694;57;62;24;2;22;.917;3900000;0
25167;1875;37;0;0;0;0;.00nan;0;0
24563;401;47;75;30;2;28;.933;3600000;0
24563;534;38;0;0;0;0;.00nan;0;0
24563;1040;49;60;32;3;29;.906;3551000;0
24563;1060;47;0;0;0;0;.00nan;0;0
24550;691;10;0;0;0;0;.00nan;0;0
24550;771;34;0;0;0;0;.00nan;0;0
24550;1002;34;82;29;2;27;.931;3900000;0
24550;2538;53;57;21;2;19;.905;3900000;0
24559;1234;39;56;25;4;21;.840;3600000;0
24559;1901;39;0;0;0;0;.00nan;0;0
24559;2192;60;61;33;5;28;.848;3600000;0
24559;2654;60;0;0;0;0;.00nan;0;0
24650;35;59;0;0;0;0;.00nan;0;0
24650;578;36;0;0;0;0;.00nan;0;0
24650;599;36;79;19;1;18;.947;3600000;0
24650;2670;59;87;41;2;39;.951;3575000;0
24529;1204;43;88;35;1;34;.971;3600000;0
24529;1911;31;0;0;0;0;.00nan;0;0
24529;1988;43;0;0;0;0;.00nan;0;0
24529;2936;31;73;33;3;30;.909;3592000;0
24566;1279;49;91;39;3;36;.923;3900000;0
24566;2273;49;0;0;0;0;.00nan;0;0
24566;4968;41;55;24;3;21;.875;3900000;0
24566;6353;41;0;0;0;0;.00nan;0;0
24684;2035;32;0;0;0;0;.00nan;0;0
24684;2458;32;98;47;2;45;.957;3900000;0
24684;2840;46;0;0;0;0;.00nan;0;0
24684;4916;46;71;25;2;23;.920;3900000;0
24632;2246;42;94;36;1;35;.972;3579000;0
24632;2641;48;100;23;0;23;1.000;3600000;0
24632;2878;42;0;0;0;0;.00nan;0;0
24632;4977;48;0;0;0;0;.00nan;0;0
25620;1279;49;0;0;0;0;.00nan;0;0
25620;1934;45;0;0;0;0;.00nan;0;0
25620;2273;49;52;41;5;36;.878;3600000;0
25620;2834;29;63;20;1;19;.950;3600000;0
25633;1016;33;0;0;0;0;.00nan;0;0
25633;2192;60;0;0;0;0;.00nan;0;0
25633;2654;60;85;16;0;16;1.000;3600000;0
25633;3987;33;70;33;3;30;.909;3600000;0
24541;281;57;0;0;0;0;.00nan;0;0
24541;427;54;45;25;4;21;.840;3600000;0
24541;692;35;43;30;5;25;.833;3597000;0
24541;769;35;0;0;0;0;.00nan;0;0
24558;2079;44;0;0;0;0;.00nan;0;0
24558;2598;50;73;32;3;29;.906;3525000;0
24558;2916;44;95;36;1;35;.972;3600000;0
24558;5398;50;0;0;0;0;.00nan;0;0
24571;534;38;74;26;2;24;.923;3600000;0
24571;1040;49;0;0;0;0;.00nan;0;0
24571;2079;44;70;39;3;36;.923;3551000;0
24571;2916;44;0;0;0;0;.00nan;0;0
25654;1911;31;47;33;5;28;.848;3600000;0
25654;2033;51;81;25;1;24;.960;3600000;0
25654;2936;31;0;0;0;0;.00nan;0;0
25654;2940;51;0;0;0;0;.00nan;0;0
24623;691;10;100;24;0;24;1.000;3900000;0
24623;1934;45;97;33;0;33;1.000;3900000;0
24623;2538;53;0;0;0;0;.00nan;0;0
24623;2834;29;0;0;0;0;.00nan;0;0
25642;1311;55;69;24;2;22;.917;3600000;0
25642;1971;55;0;0;0;0;.00nan;0;0
25642;2035;32;88;41;3;38;.927;3587000;0
25642;2458;32;0;0;0;0;.00nan;0;0
25598;1234;39;0;0;0;0;.00nan;0;0
25598;1901;39;99;37;1;36;.973;3600000;0
25598;2246;42;98;30;1;29;.967;2873000;0
25598;2878;42;30;15;4;11;.733;727000;0
24636;534;38;0;0;0;0;.00nan;0;0
24636;1040;49;68;43;5;38;.884;3883000;0
24636;2598;50;0;0;0;0;.00nan;0;0
24636;5398;50;55;29;4;25;.862;3883000;0
24609;430;56;0;0;0;0;.00nan;0;0
24609;1204;43;55;28;4;24;.857;3527000;0
24609;1988;43;0;0;0;0;.00nan;0;0
24609;2081;56;83;31;2;29;.935;3600000;0
24540;281;57;0;0;0;0;.00nan;0;0
24540;427;54;66;23;2;21;.913;3600000;0
24540;907;57;75;37;4;33;.892;3513000;0
24540;1694;57;0;0;0;0;.00nan;0;0
24552;401;47;0;0;0;0;.00nan;0;0
24552;1060;47;66;39;5;34;.872;3786000;0
24552;1820;58;0;0;0;0;.00nan;0;0
24552;2532;58;54;36;4;32;.889;3786000;0
24570;692;35;100;34;0;34;1.000;3600000;0
24570;769;35;0;0;0;0;.00nan;0;0
24570;2840;46;58;31;3;28;.903;3600000;0
24570;4916;46;0;0;0;0;.00nan;0;0
24662;1865;61;73;39;4;35;.897;3900000;0
24662;1890;61;0;0;0;0;.00nan;0;0
24662;4839;54;0;0;0;0;.00nan;0;0
24662;7142;54;65;28;4;24;.857;3900000;0
24530;35;59;65;22;2;20;.909;3600000;0
24530;907;57;47;9;2;7;.778;1352000;0
24530;1694;57;24;28;7;21;.750;2248000;0
24530;2670;59;0;0;0;0;.00nan;0;0
24583;771;34;0;0;0;0;.00nan;0;0
24583;1002;34;63;29;4;25;.862;3600000;0
24583;2615;40;28;28;6;22;.786;2788000;0
24583;2954;40;60;9;0;9;1.000;749000;0
24773;2035;32;0;0;0;0;.00nan;0;0
24773;2246;42;71;31;3;28;.903;3730000;0
24773;2458;32;95;52;2;50;.962;3730000;0
24773;2878;42;0;0;0;0;.00nan;0;0
24703;691;10;62;24;3;21;.875;3900000;0
24703;2538;53;0;0;0;0;.00nan;0;0
24703;2598;50;67;29;3;26;.897;3900000;0
24703;5398;50;0;0;0;0;.00nan;0;0
24576;2192;60;0;0;0;0;.00nan;0;0
24576;2654;60;20;18;5;13;.722;3593000;0
24576;4968;41;0;0;0;0;.00nan;0;0
24576;6353;41;60;31;4;27;.871;3600000;0
24575;1204;43;0;0;0;0;.00nan;0;0
24575;1279;49;74;27;2;25;.926;3600000;0
24575;1988;43;74;37;3;34;.919;3600000;0
24575;2273;49;0;0;0;0;.00nan;0;0
24553;1820;58;93;44;3;41;.932;3544000;0
24553;1934;45;69;22;2;20;.909;3600000;0
24553;2532;58;0;0;0;0;.00nan;0;0
24553;2834;29;0;0;0;0;.00nan;0;0
24599;1234;39;79;29;1;28;.966;3600000;0
24599;1901;39;0;0;0;0;.00nan;0;0
24599;2641;48;75;39;3;36;.923;3556000;0
24599;4977;48;0;0;0;0;.00nan;0;0
24673;430;56;90;34;1;33;.971;3600000;0
24673;2079;44;0;0;0;0;.00nan;0;0
24673;2081;56;0;0;0;0;.00nan;0;0
24673;2916;44;32;15;4;11;.733;3600000;0
24616;578;36;35;24;5;19;.792;3550000;0
24616;599;36;0;0;0;0;.00nan;0;0
24616;1311;55;64;32;4;28;.875;3600000;0
24616;1971;55;0;0;0;0;.00nan;0;0
24596;401;47;62;17;2;15;.882;3600000;0
24596;1060;47;0;0;0;0;.00nan;0;0
24596;1911;31;0;0;0;0;.00nan;0;0
24596;2936;31;73;45;5;40;.889;3600000;0
24693;1202;37;0;0;0;0;.00nan;0;0
24693;1875;37;64;25;3;22;.880;3541000;0
24693;4839;54;83;34;2;32;.941;3600000;0
24693;7142;54;0;0;0;0;.00nan;0;0
24584;2033;51;0;0;0;0;.00nan;0;0
24584;2840;46;0;0;0;0;.00nan;0;0
24584;2940;51;98;47;3;44;.936;3600000;0
24584;4916;46;30;23;5;18;.783;3511000;0
24557;673;35;0;0;0;0;.00nan;0;0
24557;692;35;76;25;1;24;.960;3600000;0
24557;771;34;65;36;5;31;.861;3600000;0
24557;1002;34;0;0;0;0;.00nan;0;0
25632;534;38;99;31;1;30;.968;3600000;0
25632;1345;38;0;0;0;0;.00nan;0;0
25632;2615;40;0;0;0;0;.00nan;0;0
25632;2954;40;64;35;4;31;.886;3600000;0
24626;35;59;25;28;6;22;.786;3571000;0
24626;349;59;0;0;0;0;.00nan;0;0
24626;1202;37;61;25;3;22;.880;3600000;0
24626;1875;37;0;0;0;0;.00nan;0;0
24601;1458;61;0;0;0;0;.00nan;0;0
24601;1865;61;46;37;6;31;.838;3600000;0
24601;2846;41;0;0;0;0;.00nan;0;0
24601;4968;41;70;33;3;30;.909;3600000;0
24543;923;32;45;43;6;37;.860;3128000;0
24543;1016;33;70;23;2;21;.913;3600000;0
24543;2458;32;61;8;0;8;1.000;472000;0
24543;3987;33;0;0;0;0;.00nan;0;0
24748;691;10;0;0;0;0;.00nan;0;0
24748;1234;39;0;0;0;0;.00nan;0;0
24748;1901;39;50;34;6;28;.824;3600000;0
24748;2538;53;90;41;2;39;.951;3600000;0
24612;401;47;0;0;0;0;.00nan;0;0
24612;1060;47;69;35;3;32;.914;3565000;0
24612;1279;49;77;23;2;21;.913;3600000;0
24612;2273;49;0;0;0;0;.00nan;0;0
24613;896;43;46;34;5;29;.853;3600000;0
24613;1458;61;61;16;2;14;.875;3600000;0
24613;1865;61;0;0;0;0;.00nan;0;0
24613;1988;43;0;0;0;0;.00nan;0;0
24525;831;44;0;0;0;0;.00nan;0;0
24525;856;48;0;0;0;0;.00nan;0;0
24525;2641;48;54;26;3;23;.885;3768000;0
24525;2916;44;55;38;4;34;.895;3768000;0
24585;335;60;0;0;0;0;.00nan;0;0
24585;2033;51;63;36;4;32;.889;3600000;0
24585;2192;60;27;20;5;15;.750;3562000;0
24585;2940;51;0;0;0;0;.00nan;0;0
24676;430;56;0;0;0;0;.00nan;0;0
24676;706;42;100;28;0;28;1.000;3600000;0
24676;2081;56;32;33;7;26;.788;3600000;0
24676;2246;42;0;0;0;0;.00nan;0;0
24573;673;35;61;46;6;40;.870;3203000;0
24573;692;35;51;2;0;2;1.000;397000;0
24573;1016;33;0;0;0;0;.00nan;0;0
24573;3987;33;59;22;3;19;.864;3600000;0
24663;1875;37;0;0;0;0;.00nan;0;0
24663;2591;37;77;33;3;30;.909;3600000;0
24663;2598;50;89;22;0;22;1.000;3600000;0
24663;2751;50;0;0;0;0;.00nan;0;0
25635;401;47;98;37;1;36;.973;3541000;0
25635;778;54;100;24;0;24;1.000;3600000;0
25635;1060;47;0;0;0;0;.00nan;0;0
25635;2848;54;0;0;0;0;.00nan;0;0
24542;281;57;0;0;0;0;.00nan;0;0
24542;427;54;58;32;4;28;.875;3600000;0
24542;907;57;75;26;1;25;.962;3600000;0
24542;1266;57;0;0;0;0;.00nan;0;0
25643;896;43;0;0;0;0;.00nan;0;0
25643;1234;39;34;31;6;25;.806;3576000;0
25643;1901;39;0;0;0;0;.00nan;0;0
25643;1988;43;65;50;5;45;.900;3600000;0
24533;1288;58;48;0;0;0;.00nan;432000;0
24533;1911;31;78;42;4;38;.905;3600000;0
24533;2532;58;40;25;5;20;.800;3121000;0
24533;2936;31;0;0;0;0;.00nan;0;0
24792;706;42;66;23;2;21;.913;3900000;0
24792;831;44;100;39;2;37;.949;3900000;0
24792;2246;42;0;0;0;0;.00nan;0;0
24792;2916;44;0;0;0;0;.00nan;0;0
24696;2615;40;90;21;0;21;1.000;3600000;0
24696;2846;41;62;41;4;37;.902;3600000;0
24696;2954;40;0;0;0;0;.00nan;0;0
24696;4968;41;0;0;0;0;.00nan;0;0
24586;35;59;89;41;3;38;.927;3562000;0
24586;349;59;0;0;0;0;.00nan;0;0
24586;534;38;74;28;2;26;.929;3600000;0
24586;1345;38;0;0;0;0;.00nan;0;0
24568;352;45;44;31;5;26;.839;3565000;0
24568;1934;45;0;0;0;0;.00nan;0;0
24568;2033;51;0;0;0;0;.00nan;0;0
24568;2940;51;70;42;4;38;.905;3600000;0
24593;335;60;68;26;2;24;.923;3900000;0
24593;485;36;0;0;0;0;.00nan;0;0
24593;599;36;61;26;2;24;.923;3900000;0
24593;2192;60;0;0;0;0;.00nan;0;0
25013;815;55;0;0;0;0;.00nan;0;0
25013;923;32;87;44;3;41;.932;3600000;0
25013;1311;55;42;7;2;5;.714;3600000;0
25013;2458;32;0;0;0;0;.00nan;0;0
24580;352;45;0;0;0;0;.00nan;0;0
24580;771;34;0;0;0;0;.00nan;0;0
24580;1002;34;65;23;2;21;.913;3561000;0
24580;1934;45;100;33;0;33;1.000;3600000;0
24671;534;38;0;0;0;0;.00nan;0;0
24671;1279;49;99;43;1;42;.977;3600000;0
24671;1345;38;67;22;2;20;.909;3551000;0
24671;2273;49;0;0;0;0;.00nan;0;0
25595;430;56;0;0;0;0;.00nan;0;0
25595;2081;56;96;43;2;41;.953;3600000;0
25595;2598;50;0;0;0;0;.00nan;0;0
25595;2751;50;43;18;3;15;.833;3544000;0
24751;1234;39;0;0;0;0;.00nan;0;0
24751;1901;39;60;20;2;18;.900;3556000;0
24751;2615;40;100;35;1;34;.971;3600000;0
24751;2954;40;0;0;0;0;.00nan;0;0
24591;778;54;64;18;1;17;.944;3544000;0
24591;1911;31;0;0;0;0;.00nan;0;0
24591;2848;54;0;0;0;0;.00nan;0;0
24591;2936;31;100;41;0;41;1.000;3600000;0
25636;673;35;0;0;0;0;.00nan;0;0
25636;692;35;61;34;4;30;.882;3600000;0
25636;815;55;65;24;3;21;.875;3600000;0
25636;1311;55;0;0;0;0;.00nan;0;0
24995;907;57;0;0;0;0;.00nan;0;0
24995;1266;57;83;36;2;34;.944;3786000;0
24995;1875;37;81;39;3;36;.923;3790000;0
24995;2591;37;0;0;0;0;.00nan;0;0
24545;281;57;79;26;1;25;.962;3900000;0
24545;427;54;0;0;0;0;.00nan;0;0
24545;856;48;84;28;1;27;.964;3900000;0
24545;2641;48;0;0;0;0;.00nan;0;0
24589;485;36;79;23;1;22;.957;3600000;0
24589;599;36;0;0;0;0;.00nan;0;0
24589;1016;33;60;36;4;32;.889;3600000;0
24589;3987;33;0;0;0;0;.00nan;0;0
25660;35;59;89;38;1;37;.974;3575000;0
25660;349;59;0;0;0;0;.00nan;0;0
25660;831;44;0;0;0;0;.00nan;0;0
25660;2916;44;99;22;0;22;1.000;3600000;0
24640;346;46;100;43;1;42;.977;3900000;0
24640;691;10;94;34;1;33;.971;3900000;0
24640;2538;53;0;0;0;0;.00nan;0;0
24640;4916;46;0;0;0;0;.00nan;0;0
25648;335;60;0;0;0;0;.00nan;0;0
25648;1288;58;0;0;0;0;.00nan;0;0
25648;2192;60;70;30;3;27;.900;3556000;0
25648;2532;58;76;37;2;35;.946;3600000;0
24694;907;57;0;0;0;0;.00nan;0;0
24694;1266;57;90;38;2;36;.947;3555000;0
24694;2598;50;87;29;1;28;.966;3600000;0
24694;2751;50;0;0;0;0;.00nan;0;0
24625;856;48;0;0;0;0;.00nan;0;0
24625;2033;51;0;0;0;0;.00nan;0;0
24625;2641;48;82;38;3;35;.921;3900000;0
24625;2940;51;84;42;3;39;.929;3900000;0
24619;352;45;52;10;1;9;.900;1384000;0
24619;534;38;65;23;2;21;.913;3600000;0
24619;1345;38;0;0;0;0;.00nan;0;0
24619;1934;45;49;26;4;22;.846;2216000;0
25638;35;59;0;0;0;0;.00nan;0;0
25638;349;59;98;38;2;36;.947;3522000;0
25638;401;47;87;18;0;18;1.000;3600000;0
25638;1060;47;0;0;0;0;.00nan;0;0
24734;485;36;0;0;0;0;.00nan;0;0
24734;599;36;74;36;3;33;.917;3600000;0
24734;778;54;0;0;0;0;.00nan;0;0
24734;2848;54;55;36;5;31;.861;3558000;0
24620;1016;33;49;40;6;34;.850;3524000;0
24620;2846;41;74;29;2;27;.931;3600000;0
24620;3987;33;48;0;0;0;.00nan;76000;0
24620;4968;41;0;0;0;0;.00nan;0;0
25666;923;32;0;0;0;0;.00nan;0;0
25666;2458;32;82;31;2;29;.935;3600000;0
25666;2615;40;0;0;0;0;.00nan;0;0
25666;2954;40;48;22;3;19;.864;3600000;0
24639;706;42;0;0;0;0;.00nan;0;0
24639;896;43;93;33;1;32;.970;3600000;0
24639;1988;43;0;0;0;0;.00nan;0;0
24639;2246;42;63;39;5;34;.872;3600000;0
24565;430;56;86;28;1;27;.964;3600000;0
24565;1288;58;96;40;2;38;.950;3545000;0
24565;2081;56;0;0;0;0;.00nan;0;0
24565;2532;58;0;0;0;0;.00nan;0;0
24680;1279;49;63;37;3;34;.919;3600000;0
24680;1875;37;100;21;0;21;1.000;3600000;0
24680;2273;49;0;0;0;0;.00nan;0;0
24680;2591;37;0;0;0;0;.00nan;0;0
24592;335;60;47;22;3;19;.864;3615000;0
24592;352;45;72;34;4;30;.882;3615000;0
24592;1934;45;0;0;0;0;.00nan;0;0
24592;2192;60;0;0;0;0;.00nan;0;0
24549;281;57;100;29;0;29;1.000;3600000;0
24549;427;54;0;0;0;0;.00nan;0;0
24549;706;42;48;30;4;26;.867;3600000;0
24549;2246;42;0;0;0;0;.00nan;0;0
24689;346;46;0;0;0;0;.00nan;0;0
24689;1234;39;97;35;2;33;.943;3600000;0
24689;1901;39;0;0;0;0;.00nan;0;0
24689;4916;46;74;49;5;44;.898;3600000;0
24634;691;10;100;36;1;35;.972;3600000;0
24634;1016;33;0;0;0;0;.00nan;0;0
24634;2538;53;0;0;0;0;.00nan;0;0
24634;3987;33;71;32;3;29;.906;3538000;0
24617;896;43;0;0;0;0;.00nan;0;0
24617;1988;43;80;48;4;44;.917;3900000;0
24617;2615;40;78;42;4;38;.905;3900000;0
24617;2954;40;0;0;0;0;.00nan;0;0
24628;1911;31;0;0;0;0;.00nan;0;0
24628;2846;41;0;0;0;0;.00nan;0;0
24628;2936;31;90;30;1;29;.967;3600000;0
24628;4968;41;60;21;2;19;.905;3600000;0
24604;771;34;61;27;3;24;.889;3600000;0
24604;923;32;55;38;5;33;.868;3581000;0
24604;1002;34;0;0;0;0;.00nan;0;0
24604;2458;32;0;0;0;0;.00nan;0;0
24637;815;55;0;0;0;0;.00nan;0;0
24637;1311;55;67;26;2;24;.923;3900000;0
24637;1458;61;0;0;0;0;.00nan;0;0
24637;1865;61;83;35;2;33;.943;3900000;0
24642;856;48;82;35;2;33;.943;3753000;0
24642;1279;49;0;0;0;0;.00nan;0;0
24642;2273;49;53;21;3;18;.857;3753000;0
24642;2641;48;0;0;0;0;.00nan;0;0
24708;831;44;0;0;0;0;.00nan;0;0
24708;1875;37;57;21;2;19;.905;3583000;0
24708;2591;37;0;0;0;0;.00nan;0;0
24708;2916;44;93;18;0;18;1.000;3600000;0
24556;430;56;0;0;0;0;.00nan;0;0
24556;907;57;90;37;2;35;.946;3810000;0
24556;1266;57;0;0;0;0;.00nan;0;0
24556;2081;56;74;32;3;29;.906;3810000;0
24644;485;36;0;0;0;0;.00nan;0;0
24644;599;36;71;31;3;28;.903;3765000;0
24644;2033;51;91;35;2;33;.943;3765000;0
24644;2940;51;0;0;0;0;.00nan;0;0
24572;771;34;0;0;0;0;.00nan;0;0
24572;1002;34;89;37;2;35;.946;3600000;0
24572;1288;58;0;0;0;0;.00nan;0;0
24572;2532;58;75;30;3;27;.900;3531000;0
24654;1016;33;71;25;2;23;.920;3600000;0
24654;1911;31;55;43;6;37;.860;3367000;0
24654;2936;31;51;2;0;2;1.000;233000;0
24654;3987;33;0;0;0;0;.00nan;0;0
24806;346;46;77;31;3;28;.903;3600000;0
24806;401;47;42;37;6;31;.838;3521000;0
24806;1060;47;41;2;1;1;.500;79000;0
24806;4916;46;0;0;0;0;.00nan;0;0
24701;831;44;39;27;5;22;.815;3613000;0
24701;1458;61;0;0;0;0;.00nan;0;0
24701;1865;61;78;40;4;36;.900;3613000;0
24701;2916;44;0;0;0;0;.00nan;0;0
24627;35;59;68;30;4;26;.867;3600000;0
24627;349;59;0;0;0;0;.00nan;0;0
24627;1234;39;78;32;2;30;.938;3600000;0
24627;1901;39;0;0;0;0;.00nan;0;0
25649;352;45;0;0;0;0;.00nan;0;0
25649;856;48;0;0;0;0;.00nan;0;0
25649;1934;45;66;25;2;23;.920;3600000;0
25649;2641;48;53;33;5;28;.848;3600000;0
24582;673;35;0;0;0;0;.00nan;0;0
24582;692;35;62;34;4;30;.882;3543000;0
24582;2615;40;76;30;2;28;.933;3600000;0
24582;2954;40;0;0;0;0;.00nan;0;0
24594;335;60;0;0;0;0;.00nan;0;0
24594;815;55;48;0;0;0;.00nan;540000;0
24594;1311;55;42;38;6;32;.842;3060000;0
24594;2192;60;79;24;1;23;.958;3600000;0
24554;281;57;51;31;5;26;.839;3577000;0
24554;427;54;0;0;0;0;.00nan;0;0
24554;2598;50;52;21;3;18;.857;3600000;0
24554;2751;50;0;0;0;0;.00nan;0;0
25611;485;36;72;25;2;23;.920;3600000;0
25611;599;36;0;0;0;0;.00nan;0;0
25611;907;57;0;0;0;0;.00nan;0;0
25611;1266;57;92;42;3;39;.929;3557000;0
24590;691;10;49;35;5;30;.857;3600000;0
24590;1288;58;100;34;0;34;1.000;3600000;0
24590;2532;58;0;0;0;0;.00nan;0;0
24590;2538;53;0;0;0;0;.00nan;0;0
25062;896;43;0;0;0;0;.00nan;0;0
25062;1875;37;0;0;0;0;.00nan;0;0
25062;1988;43;82;24;1;23;.958;3600000;0
25062;2591;37;47;23;4;19;.826;3600000;0
24622;2615;40;0;0;0;0;.00nan;0;0
24622;2846;41;0;0;0;0;.00nan;0;0
24622;2954;40;100;38;1;37;.974;3900000;0
24622;4968;41;69;22;1;21;.955;3900000;0
24647;706;42;0;0;0;0;.00nan;0;0
24647;2033;51;41;32;6;26;.813;2782000;0
24647;2246;42;76;44;5;39;.886;3600000;0
24647;2940;51;60;6;0;6;1.000;754000;0
24645;35;59;0;0;0;0;.00nan;0;0
24645;349;59;74;31;3;28;.903;3554000;0
24645;815;55;72;26;2;24;.923;3600000;0
24645;1311;55;0;0;0;0;.00nan;0;0
25674;430;56;85;39;2;37;.949;3585000;0
25674;1016;33;0;0;0;0;.00nan;0;0
25674;2081;56;0;0;0;0;.00nan;0;0
25674;3987;33;81;29;1;28;.966;3600000;0
24714;534;38;70;16;1;15;.938;3900000;0
24714;1345;38;0;0;0;0;.00nan;0;0
24714;1458;61;84;29;1;28;.966;3900000;0
24714;1865;61;0;0;0;0;.00nan;0;0
24643;778;54;88;27;1;26;.963;3600000;0
24643;856;48;52;27;3;24;.889;3536000;0
24643;2641;48;0;0;0;0;.00nan;0;0
24643;2848;54;0;0;0;0;.00nan;0;0
25147;771;34;0;0;0;0;.00nan;0;0
25147;1002;34;54;32;4;28;.875;3540000;0
25147;1279;49;72;27;2;25;.926;3600000;0
25147;2273;49;0;0;0;0;.00nan;0;0
24801;831;44;0;0;0;0;.00nan;0;0
24801;2598;50;0;0;0;0;.00nan;0;0
24801;2751;50;50;36;5;31;.861;3600000;0
24801;2916;44;100;26;1;25;.962;3600000;0
24614;430;56;0;0;0;0;.00nan;0;0
24614;771;34;85;27;1;26;.963;3600000;0
24614;1002;34;0;0;0;0;.00nan;0;0
24614;2081;56;53;40;5;35;.875;3600000;0
24720;401;47;64;8;0;8;1.000;731000;0
24720;1060;47;48;41;6;35;.854;2862000;0
24720;1234;39;0;0;0;0;.00nan;0;0
24720;1901;39;46;24;4;20;.833;3600000;0
24587;673;35;0;0;0;0;.00nan;0;0
24587;692;35;89;35;1;34;.971;3900000;0
24587;923;32;0;0;0;0;.00nan;0;0
24587;2458;32;95;51;1;50;.980;3900000;0
25617;346;46;0;0;0;0;.00nan;0;0
25617;706;42;70;49;5;44;.898;3600000;0
25617;2246;42;0;0;0;0;.00nan;0;0
25617;4916;46;62;18;1;17;.944;3600000;0
24610;352;45;0;0;0;0;.00nan;0;0
24610;907;57;0;0;0;0;.00nan;0;0
24610;1266;57;86;39;3;36;.923;3573000;0
24610;1934;45;77;28;1;27;.964;3600000;0
24602;335;60;51;1;0;1;1.000;42000;0
24602;691;10;66;28;3;25;.893;3600000;0
24602;2192;60;25;37;8;29;.784;3558000;0
24602;2538;53;0;0;0;0;.00nan;0;0
24915;778;54;0;0;0;0;.00nan;0;0
24915;1875;37;71;41;4;37;.902;3585000;0
24915;2591;37;0;0;0;0;.00nan;0;0
24915;2848;54;59;24;2;22;.917;3600000;0
24606;281;57;87;33;2;31;.939;3900000;0
24606;427;54;0;0;0;0;.00nan;0;0
24606;485;36;0;0;0;0;.00nan;0;0
24606;599;36;66;23;2;21;.913;3900000;0
25662;2033;51;0;0;0;0;.00nan;0;0
25662;2598;50;68;23;1;22;.957;3600000;0
25662;2751;50;0;0;0;0;.00nan;0;0
25662;2940;51;54;38;5;33;.868;3600000;0
24743;534;38;100;30;0;30;1.000;3600000;0
24743;1345;38;0;0;0;0;.00nan;0;0
24743;1911;31;88;28;1;27;.964;3565000;0
24743;2936;31;0;0;0;0;.00nan;0;0
24669;401;47;62;33;4;29;.879;3580000;0
24669;923;32;79;33;3;30;.909;3600000;0
24669;1060;47;0;0;0;0;.00nan;0;0
24669;2458;32;0;0;0;0;.00nan;0;0
24588;673;35;0;0;0;0;.00nan;0;0
24588;692;35;52;25;3;22;.880;3546000;0
24588;1279;49;71;22;2;20;.909;3600000;0
24588;2273;49;0;0;0;0;.00nan;0;0
24653;35;59;57;35;4;31;.886;3573000;0
24653;349;59;0;0;0;0;.00nan;0;0
24653;896;43;0;0;0;0;.00nan;0;0
24653;1988;43;65;27;2;25;.926;3600000;0
24716;691;10;72;34;3;31;.912;3900000;0
24716;1458;61;0;0;0;0;.00nan;0;0
24716;1865;61;96;41;3;38;.927;3900000;0
24716;2538;53;0;0;0;0;.00nan;0;0
24670;815;55;0;0;0;0;.00nan;0;0
24670;856;48;72;24;1;23;.958;3137000;0
24670;1311;55;42;18;3;15;.833;3600000;0
24670;2641;48;29;9;3;6;.667;432000;0
25297;778;54;49;48;8;40;.833;3523000;0
25297;1911;31;0;0;0;0;.00nan;0;0
25297;2848;54;39;1;1;0;.000;77000;0
25297;2936;31;75;41;3;38;.927;3600000;0
24685;335;60;100;36;0;36;1.000;3600000;0
24685;346;46;67;25;2;23;.920;3513000;0
24685;2192;60;0;0;0;0;.00nan;0;0
24685;4916;46;0;0;0;0;.00nan;0;0
24607;771;34;26;15;4;11;.733;895000;0
24607;1002;34;56;23;3;20;.870;2705000;0
24607;1016;33;60;23;3;20;.870;3600000;0
24607;3987;33;0;0;0;0;.00nan;0;0
24707;896;43;49;27;4;23;.852;3575000;0
24707;1988;43;0;0;0;0;.00nan;0;0
24707;2846;41;82;32;2;30;.938;3600000;0
24707;4968;41;0;0;0;0;.00nan;0;0
24739;831;44;90;37;1;36;.973;3600000;0
24739;907;57;49;16;2;14;.875;1394000;0
24739;1266;57;38;22;4;18;.818;2206000;0
24739;2916;44;0;0;0;0;.00nan;0;0
24629;534;38;37;19;4;15;.789;3600000;0
24629;1288;58;99;41;1;40;.976;3600000;0
24629;1345;38;0;0;0;0;.00nan;0;0
24629;2532;58;0;0;0;0;.00nan;0;0
24767;335;60;75;24;2;22;.917;3900000;0
24767;1875;37;95;37;2;35;.946;3900000;0
24767;2192;60;0;0;0;0;.00nan;0;0
24767;2591;37;0;0;0;0;.00nan;0;0
24595;771;34;79;30;2;28;.933;3600000;0
24595;1002;34;0;0;0;0;.00nan;0;0
24595;1288;58;76;15;0;15;1.000;2207000;0
24595;2532;58;9;19;6;13;.684;1393000;0
24600;673;35;83;50;4;46;.920;3600000;0
24600;692;35;0;0;0;0;.00nan;0;0
24600;1234;39;91;32;1;31;.969;3600000;0
24600;1901;39;0;0;0;0;.00nan;0;0
24608;281;57;0;0;0;0;.00nan;0;0
24608;427;54;63;41;5;36;.878;3600000;0
24608;2598;50;100;25;0;25;1.000;3600000;0
24608;2751;50;0;0;0;0;.00nan;0;0
24713;430;56;0;0;0;0;.00nan;0;0
24713;907;57;0;0;0;0;.00nan;0;0
24713;1266;57;93;27;1;26;.963;3600000;0
24713;2081;56;70;26;2;24;.923;3577000;0
24624;352;45;96;32;2;30;.938;3600000;0
24624;1279;49;81;35;3;32;.914;3545000;0
24624;1934;45;0;0;0;0;.00nan;0;0
24624;2273;49;0;0;0;0;.00nan;0;0
24681;815;55;67;32;4;28;.875;3600000;0
24681;1311;55;0;0;0;0;.00nan;0;0
24681;1458;61;73;23;1;22;.957;3600000;0
24681;1865;61;0;0;0;0;.00nan;0;0
24656;35;59;50;29;5;24;.828;3589000;0
24656;349;59;0;0;0;0;.00nan;0;0
24656;2846;41;0;0;0;0;.00nan;0;0
24656;4968;41;47;29;4;25;.862;3600000;0
24698;856;48;0;0;0;0;.00nan;0;0
24698;923;32;0;0;0;0;.00nan;0;0
24698;2458;32;50;35;5;30;.857;3600000;0
24698;2641;48;99;43;2;41;.953;3600000;0
24672;401;47;0;0;0;0;.00nan;0;0
24672;706;42;89;17;0;17;1.000;3600000;0
24672;1060;47;66;39;4;35;.897;3600000;0
24672;2246;42;0;0;0;0;.00nan;0;0
24649;1016;33;0;0;0;0;.00nan;0;0
24649;2033;51;0;0;0;0;.00nan;0;0
24649;2940;51;100;24;0;24;1.000;3600000;0
24649;3987;33;59;35;4;31;.886;3600000;0
24679;352;45;0;0;0;0;.00nan;0;0
24679;896;43;0;0;0;0;.00nan;0;0
24679;1934;45;67;23;2;21;.913;3600000;0
24679;1988;43;100;54;0;54;1.000;3600000;0
24641;401;47;92;38;2;36;.947;3600000;0
24641;691;10;69;32;3;29;.906;3543000;0
24641;1060;47;0;0;0;0;.00nan;0;0
24641;2538;53;0;0;0;0;.00nan;0;0
24929;534;38;63;22;2;20;.909;3600000;0
24929;1345;38;0;0;0;0;.00nan;0;0
24929;1875;37;0;0;0;0;.00nan;0;0
24929;2591;37;65;50;5;45;.900;3600000;0
24621;673;35;0;0;0;0;.00nan;0;0
24621;692;35;67;52;6;46;.885;3600000;0
24621;2615;40;69;23;2;21;.913;3600000;0
24621;2954;40;0;0;0;0;.00nan;0;0
24678;706;42;57;17;2;15;.882;3600000;0
24678;856;48;0;0;0;0;.00nan;0;0
24678;2246;42;0;0;0;0;.00nan;0;0
24678;2641;48;57;29;4;25;.862;3600000;0
24780;831;44;50;1;0;1;1.000;597000;0
24780;1234;39;0;0;0;0;.00nan;0;0
24780;1901;39;75;27;1;26;.963;3600000;0
24780;2916;44;36;28;6;22;.786;3003000;0
24615;281;57;100;30;0;30;1.000;3600000;0
24615;427;54;0;0;0;0;.00nan;0;0
24615;2615;40;0;0;0;0;.00nan;0;0
24615;2954;40;46;38;6;32;.842;3600000;0
24603;1288;58;65;49;5;44;.898;3796000;0
24603;2532;58;0;0;0;0;.00nan;0;0
24603;2598;50;40;31;6;25;.806;3796000;0
24603;2751;50;0;0;0;0;.00nan;0;0
24825;923;32;72;29;2;27;.931;3600000;0
24825;1911;31;0;0;0;0;.00nan;0;0
24825;2458;32;0;0;0;0;.00nan;0;0
24825;2936;31;66;34;4;30;.882;3551000;0
24911;346;46;63;24;2;22;.917;3600000;0
24911;896;43;0;0;0;0;.00nan;0;0
24911;1988;43;72;42;5;37;.881;3600000;0
24911;4916;46;0;0;0;0;.00nan;0;0
24752;430;56;70;27;2;25;.926;3575000;0
24752;815;55;0;0;0;0;.00nan;0;0
24752;1311;55;77;24;1;23;.958;3600000;0
24752;2081;56;0;0;0;0;.00nan;0;0
24633;485;36;0;0;0;0;.00nan;0;0
24633;599;36;100;25;0;25;1.000;3600000;0
24633;771;34;0;0;0;0;.00nan;0;0
24633;1002;34;97;49;2;47;.959;3586000;0
24667;35;59;0;0;0;0;.00nan;0;0
24667;349;59;92;34;1;33;.971;3600000;0
24667;1279;49;43;30;5;25;.833;3600000;0
24667;2273;49;0;0;0;0;.00nan;0;0
24618;1016;33;85;33;2;31;.939;3600000;0
24618;1259;53;0;0;0;0;.00nan;0;0
24618;2538;53;53;27;4;23;.852;3516000;0
24618;3987;33;0;0;0;0;.00nan;0;0
24719;1458;61;0;0;0;0;.00nan;0;0
24719;1865;61;55;40;5;35;.875;3600000;0
24719;2033;51;0;0;0;0;.00nan;0;0
24719;2940;51;74;30;2;28;.933;3600000;0
24597;593;57;44;25;4;21;.840;3515000;0
24597;673;35;0;0;0;0;.00nan;0;0
24597;692;35;87;36;2;34;.944;3600000;0
24597;907;57;0;0;0;0;.00nan;0;0
25076;1875;37;87;31;1;30;.968;3600000;0
25076;1911;31;79;37;4;33;.892;3600000;0
25076;2591;37;0;0;0;0;.00nan;0;0
25076;2936;31;0;0;0;0;.00nan;0;0
25019;778;54;58;33;4;29;.879;3600000;0
25019;831;44;30;20;5;15;.750;3191000;0
25019;2848;54;0;0;0;0;.00nan;0;0
25019;2916;44;53;3;0;3;1.000;356000;0
24890;346;46;0;0;0;0;.00nan;0;0
24890;534;38;83;26;1;25;.962;3600000;0
24890;1345;38;0;0;0;0;.00nan;0;0
24890;4916;46;79;29;2;27;.931;3562000;0
24790;430;56;0;0;0;0;.00nan;0;0
24790;1234;39;76;28;2;26;.929;3900000;0
24790;1901;39;0;0;0;0;.00nan;0;0
24790;2081;56;90;36;2;34;.944;3900000;0
25646;706;42;0;0;0;0;.00nan;0;0
25646;1016;33;0;0;0;0;.00nan;0;0
25646;2246;42;64;34;4;30;.882;3600000;0
25646;3987;33;53;23;3;20;.870;3600000;0
24630;335;60;93;18;0;18;1.000;3600000;0
24630;2192;60;0;0;0;0;.00nan;0;0
24630;2598;50;0;0;0;0;.00nan;0;0
24630;2751;50;97;40;1;39;.975;3597000;0
24631;281;57;85;32;2;30;.938;3600000;0
24631;427;54;0;0;0;0;.00nan;0;0
24631;485;36;0;0;0;0;.00nan;0;0
24631;599;36;43;18;3;15;.833;3581000;0
24688;352;45;87;42;3;39;.929;3600000;0
24688;923;32;0;0;0;0;.00nan;0;0
24688;1934;45;0;0;0;0;.00nan;0;0
24688;2458;32;68;27;2;25;.926;3600000;0
25673;1259;53;50;30;4;26;.867;3600000;0
25673;2033;51;56;22;3;19;.864;3600000;0
25673;2538;53;0;0;0;0;.00nan;0;0
25673;2940;51;0;0;0;0;.00nan;0;0
25367;593;57;0;0;0;0;.00nan;0;0
25367;856;48;0;0;0;0;.00nan;0;0
25367;907;57;40;27;5;22;.815;3600000;0
25367;2641;48;75;35;3;32;.914;3600000;0
24766;1279;49;40;29;5;24;.828;3547000;0
24766;2273;49;0;0;0;0;.00nan;0;0
24766;2615;40;59;26;3;23;.885;3600000;0
24766;2954;40;0;0;0;0;.00nan;0;0
24666;35;59;70;39;4;35;.897;3600000;0
24666;349;59;0;0;0;0;.00nan;0;0
24666;2846;41;35;28;5;23;.821;3562000;0
24666;4968;41;0;0;0;0;.00nan;0;0
25651;346;46;80;21;2;19;.905;3600000;0
25651;2615;40;0;0;0;0;.00nan;0;0
25651;2954;40;62;37;4;33;.892;3589000;0
25651;4916;46;0;0;0;0;.00nan;0;0
24651;335;60;76;33;3;30;.909;3785000;0
24651;401;47;0;0;0;0;.00nan;0;0
24651;1060;47;68;33;4;29;.879;3785000;0
24651;2192;60;0;0;0;0;.00nan;0;0
25667;352;45;0;0;0;0;.00nan;0;0
25667;923;32;73;53;6;47;.887;3754000;0
25667;1934;45;61;36;5;31;.861;3754000;0
25667;2458;32;0;0;0;0;.00nan;0;0
25661;1875;37;0;0;0;0;.00nan;0;0
25661;2591;37;62;33;3;30;.909;3600000;0
25661;2846;41;0;0;0;0;.00nan;0;0
25661;4968;41;38;21;4;17;.810;3541000;0
24788;815;55;0;0;0;0;.00nan;0;0
24788;1311;55;62;25;2;23;.920;3600000;0
24788;2033;51;0;0;0;0;.00nan;0;0
24788;2940;51;84;35;3;32;.914;3549000;0
24692;485;36;89;16;0;16;1.000;3600000;0
24692;599;36;0;0;0;0;.00nan;0;0
24692;706;42;62;44;5;39;.886;3600000;0
24692;2246;42;0;0;0;0;.00nan;0;0
24664;1234;39;0;0;0;0;.00nan;0;0
24664;1288;58;28;15;4;11;.733;611000;0
24664;1901;39;52;25;4;21;.840;3600000;0
24664;2532;58;35;35;6;29;.829;2989000;0
24700;485;36;81;15;0;15;1.000;3600000;0
24700;599;36;0;0;0;0;.00nan;0;0
24700;896;43;50;7;1;6;.857;321000;0
24700;1988;43;67;54;7;47;.870;3279000;0
24711;673;35;0;0;0;0;.00nan;0;0
24711;692;35;39;41;7;34;.829;3573000;0
24711;831;44;40;21;4;17;.810;1567000;0
24711;2916;44;52;14;2;12;.857;2033000;0
24731;856;48;0;0;0;0;.00nan;0;0
24731;2598;50;71;28;2;26;.929;3574000;0
24731;2641;48;97;44;1;43;.977;3600000;0
24731;2751;50;0;0;0;0;.00nan;0;0
24652;35;59;70;37;3;34;.919;3516000;0
24652;349;59;0;0;0;0;.00nan;0;0
24652;1016;33;0;0;0;0;.00nan;0;0
24652;3987;33;76;26;1;25;.962;3600000;0
24749;430;56;0;0;0;0;.00nan;0;0
24749;1259;53;64;19;2;17;.895;3900000;0
24749;2081;56;90;27;2;25;.926;3900000;0
24749;2538;53;0;0;0;0;.00nan;0;0
24864;923;32;0;0;0;0;.00nan;0;0
24864;1875;37;94;24;0;24;1.000;3600000;0
24864;2458;32;71;37;4;33;.892;3600000;0
24864;2591;37;0;0;0;0;.00nan;0;0
24657;593;57;79;27;1;26;.963;3600000;0
24657;771;34;0;0;0;0;.00nan;0;0
24657;907;57;0;0;0;0;.00nan;0;0
24657;1002;34;69;32;3;29;.906;3582000;0
24697;335;60;0;0;0;0;.00nan;0;0
24697;778;54;72;30;2;28;.933;3900000;0
24697;2192;60;86;35;2;33;.943;3900000;0
24697;2848;54;0;0;0;0;.00nan;0;0
24721;1279;49;0;0;0;0;.00nan;0;0
24721;1458;61;69;25;2;23;.920;3600000;0
24721;1865;61;0;0;0;0;.00nan;0;0
24721;2273;49;46;27;4;23;.852;3588000;0
24852;706;42;59;38;5;33;.868;3576000;0
24852;2033;51;69;34;4;30;.882;3600000;0
24852;2246;42;0;0;0;0;.00nan;0;0
24852;2940;51;0;0;0;0;.00nan;0;0
24771;815;55;34;28;5;23;.821;3519000;0
24771;1311;55;0;0;0;0;.00nan;0;0
24771;1911;31;65;28;3;25;.893;3600000;0
24771;2936;31;0;0;0;0;.00nan;0;0
24812;346;46;0;0;0;0;.00nan;0;0
24812;1279;49;46;28;5;23;.821;3600000;0
24812;2273;49;0;0;0;0;.00nan;0;0
24812;4916;46;100;32;0;32;1.000;3600000;0
24660;281;57;81;15;0;15;1.000;3600000;0
24660;427;54;0;0;0;0;.00nan;0;0
24660;430;56;89;56;5;51;.911;3521000;0
24660;2081;56;48;0;0;0;.00nan;79000;0
24706;593;57;0;0;0;0;.00nan;0;0
24706;856;48;0;0;0;0;.00nan;0;0
24706;907;57;71;38;4;34;.895;3600000;0
24706;2641;48;74;30;2;28;.933;3600000;0
24638;673;35;91;50;4;46;.920;3900000;0
24638;692;35;0;0;0;0;.00nan;0;0
24638;2846;41;78;38;4;34;.895;3900000;0
24638;4968;41;0;0;0;0;.00nan;0;0
24635;896;43;97;45;2;43;.956;3900000;0
24635;1288;58;91;38;2;36;.947;3900000;0
24635;1988;43;0;0;0;0;.00nan;0;0
24635;2532;58;0;0;0;0;.00nan;0;0
24690;1016;33;81;32;2;30;.938;3600000;0
24690;2598;50;0;0;0;0;.00nan;0;0
24690;2751;50;72;28;3;25;.893;3562000;0
24690;3987;33;0;0;0;0;.00nan;0;0
24658;534;38;65;29;4;25;.862;3900000;0
24658;771;34;90;47;4;43;.915;3900000;0
24658;1002;34;0;0;0;0;.00nan;0;0
24658;1345;38;0;0;0;0;.00nan;0;0
24674;35;59;0;0;0;0;.00nan;0;0
24674;349;59;59;44;5;39;.886;3600000;0
24674;1458;61;0;0;0;0;.00nan;0;0
24674;1865;61;65;24;2;22;.917;3600000;0
24822;346;46;50;0;0;0;.00nan;56000;0
24822;2615;40;54;24;3;21;.875;3600000;0
24822;2954;40;0;0;0;0;.00nan;0;0
24822;4916;46;59;46;6;40;.870;3544000;0
24687;335;60;35;22;5;17;.773;3565000;0
24687;534;38;0;0;0;0;.00nan;0;0
24687;1345;38;69;33;4;29;.879;3600000;0
24687;2192;60;0;0;0;0;.00nan;0;0
24772;401;47;0;0;0;0;.00nan;0;0
24772;1060;47;57;27;3;24;.889;3577000;0
24772;1911;31;0;0;0;0;.00nan;0;0
24772;2936;31;70;23;2;21;.913;3600000;0
24897;1234;39;63;22;2;20;.909;3600000;0
24897;1901;39;0;0;0;0;.00nan;0;0
24897;2033;51;0;0;0;0;.00nan;0;0
24897;2940;51;76;49;5;44;.898;3600000;0
24702;352;45;0;0;0;0;.00nan;0;0
24702;778;54;88;39;3;36;.923;3900000;0
24702;1934;45;82;35;3;32;.914;3900000;0
24702;2848;54;0;0;0;0;.00nan;0;0
24646;281;57;98;24;0;24;1.000;3600000;0
24646;401;47;54;24;3;21;.875;3600000;0
24646;427;54;0;0;0;0;.00nan;0;0
24646;1060;47;0;0;0;0;.00nan;0;0
24686;673;35;0;0;0;0;.00nan;0;0
24686;692;35;69;28;2;26;.929;3600000;0
24686;923;32;0;0;0;0;.00nan;0;0
24686;2458;32;79;50;5;45;.900;3600000;0
25194;815;55;0;0;0;0;.00nan;0;0
25194;1311;55;56;35;5;30;.857;3600000;0
25194;1875;37;98;23;0;23;1.000;3600000;0
25194;2591;37;0;0;0;0;.00nan;0;0
24768;896;43;0;0;0;0;.00nan;0;0
24768;1988;43;75;27;2;25;.926;3600000;0
24768;2615;40;0;0;0;0;.00nan;0;0
24768;2954;40;76;34;3;31;.912;3580000;0
24659;335;60;0;0;0;0;.00nan;0;0
24659;2192;60;42;24;4;20;.833;3546000;0
24659;2846;41;71;30;3;27;.900;3600000;0
24659;4968;41;0;0;0;0;.00nan;0;0
24727;706;42;44;34;6;28;.824;3600000;0
24727;1458;61;0;0;0;0;.00nan;0;0
24727;1865;61;85;40;2;38;.950;3600000;0
24727;2246;42;0;0;0;0;.00nan;0;0
25591;856;48;0;0;0;0;.00nan;0;0
25591;1288;58;0;0;0;0;.00nan;0;0
25591;2532;58;63;34;4;30;.882;3600000;0
25591;2641;48;41;28;5;23;.821;3555000;0
24655;430;56;0;0;0;0;.00nan;0;0
24655;1288;58;55;42;5;37;.881;3554000;0
24655;2081;56;57;31;4;27;.871;3600000;0
24655;2532;58;0;0;0;0;.00nan;0;0
25663;1279;49;73;34;3;31;.912;3900000;0
25663;1458;61;69;31;3;28;.903;3900000;0
25663;1865;61;0;0;0;0;.00nan;0;0
25663;2273;49;0;0;0;0;.00nan;0;0
24661;771;34;82;42;4;38;.905;3600000;0
24661;1002;34;0;0;0;0;.00nan;0;0
24661;1259;53;0;0;0;0;.00nan;0;0
24661;2538;53;52;23;3;20;.870;3600000;0
24799;815;55;42;40;6;34;.850;2629000;0
24799;1234;39;0;0;0;0;.00nan;0;0
24799;1311;55;41;24;4;20;.833;971000;0
24799;1901;39;74;28;2;26;.929;3600000;0
25478;1875;37;85;31;2;29;.935;3556000;0
25478;2033;51;0;0;0;0;.00nan;0;0
25478;2591;37;0;0;0;0;.00nan;0;0
25478;2940;51;99;42;1;41;.976;3600000;0
25653;346;46;68;31;3;28;.903;3569000;0
25653;593;57;95;38;2;36;.947;3600000;0
25653;907;57;0;0;0;0;.00nan;0;0
25653;4916;46;0;0;0;0;.00nan;0;0
24754;534;38;52;16;2;14;.875;3600000;0
24754;1345;38;0;0;0;0;.00nan;0;0
24754;2598;50;74;40;4;36;.900;3546000;0
24754;2751;50;0;0;0;0;.00nan;0;0
24648;281;57;100;31;1;30;.968;3600000;0
24648;427;54;0;0;0;0;.00nan;0;0
24648;1016;33;43;25;4;21;.840;3600000;0
24648;3987;33;0;0;0;0;.00nan;0;0
24823;485;36;55;23;3;20;.870;3600000;0
24823;599;36;0;0;0;0;.00nan;0;0
24823;831;44;0;0;0;0;.00nan;0;0
24823;2916;44;64;40;5;35;.875;3554000;0
24828;346;46;0;0;0;0;.00nan;0;0
24828;485;36;0;0;0;0;.00nan;0;0
24828;599;36;72;34;3;31;.912;3600000;0
24828;4916;46;48;35;5;30;.857;3585000;0
24830;831;44;88;16;0;16;1.000;3600000;0
24830;2615;40;76;31;2;29;.935;3551000;0
24830;2916;44;0;0;0;0;.00nan;0;0
24830;2954;40;0;0;0;0;.00nan;0;0
24874;706;42;72;36;4;32;.889;3591000;0
24874;2246;42;0;0;0;0;.00nan;0;0
24874;2598;50;0;0;0;0;.00nan;0;0
24874;2751;50;79;41;3;38;.927;3600000;0
25675;335;60;59;25;3;22;.880;3600000;0
25675;430;56;82;44;4;40;.909;3545000;0
25675;2081;56;0;0;0;0;.00nan;0;0
25675;2192;60;0;0;0;0;.00nan;0;0
24764;856;48;0;0;0;0;.00nan;0;0
24764;923;32;56;44;6;38;.864;3600000;0
24764;2458;32;0;0;0;0;.00nan;0;0
24764;2641;48;72;17;1;16;.941;3600000;0
24725;1259;53;53;23;3;20;.870;3600000;0
24725;2538;53;0;0;0;0;.00nan;0;0
24725;2846;41;65;23;2;21;.913;3600000;0
24725;4968;41;0;0;0;0;.00nan;0;0
24712;352;45;91;33;2;31;.939;3600000;0
24712;778;54;0;0;0;0;.00nan;0;0
24712;1934;45;0;0;0;0;.00nan;0;0
24712;2848;54;53;27;4;23;.852;3599000;0
24789;1279;49;0;0;0;0;.00nan;0;0
24789;1911;31;18;38;8;30;.789;3600000;0
24789;2273;49;73;35;3;32;.914;3600000;0
24789;2936;31;0;0;0;0;.00nan;0;0
24715;352;45;0;0;0;0;.00nan;0;0
24715;593;57;77;29;2;27;.931;3600000;0
24715;907;57;0;0;0;0;.00nan;0;0
24715;1934;45;50;27;4;23;.852;3584000;0
25659;281;57;32;24;5;19;.792;3600000;0
25659;427;54;0;0;0;0;.00nan;0;0
25659;896;43;0;0;0;0;.00nan;0;0
25659;1988;43;64;38;6;32;.842;3568000;0
24683;35;59;21;28;6;22;.786;3600000;0
24683;349;59;0;0;0;0;.00nan;0;0
24683;401;47;0;0;0;0;.00nan;0;0
24683;1060;47;63;33;4;29;.879;3600000;0
24730;593;57;60;12;1;11;.917;791000;0
24730;706;42;46;23;4;19;.826;3600000;0
24730;907;57;38;32;6;26;.813;2809000;0
24730;2246;42;0;0;0;0;.00nan;0;0
24746;856;48;0;0;0;0;.00nan;0;0
24746;1458;61;0;0;0;0;.00nan;0;0
24746;1865;61;65;31;3;28;.903;3576000;0
24746;2641;48;78;25;1;24;.960;3600000;0
24745;335;60;0;0;0;0;.00nan;0;0
24745;1279;49;87;39;3;36;.923;3659000;0
24745;2192;60;74;33;2;31;.939;3659000;0
24745;2273;49;0;0;0;0;.00nan;0;0
24781;673;35;62;31;4;27;.871;3706000;0
24781;692;35;0;0;0;0;.00nan;0;0
24781;815;55;0;0;0;0;.00nan;0;0
24781;1311;55;62;24;3;21;.875;3706000;0
24742;401;47;58;28;3;25;.893;3900000;0
24742;1060;47;0;0;0;0;.00nan;0;0
24742;2846;41;0;0;0;0;.00nan;0;0
24742;4968;41;66;25;3;22;.880;3900000;0
25600;831;44;50;29;4;25;.862;3900000;0
25600;1234;39;46;27;4;23;.852;3900000;0
25600;1901;39;0;0;0;0;.00nan;0;0
25600;2916;44;0;0;0;0;.00nan;0;0
24819;485;36;39;16;3;13;.813;3544000;0
24819;599;36;0;0;0;0;.00nan;0;0
24819;1911;31;0;0;0;0;.00nan;0;0
24819;2936;31;84;33;2;31;.939;3600000;0
24758;534;38;95;24;0;24;1.000;3600000;0
24758;1288;58;0;0;0;0;.00nan;0;0
24758;1345;38;0;0;0;0;.00nan;0;0
24758;2532;58;64;45;5;40;.889;3600000;0
24800;1259;53;0;0;0;0;.00nan;0;0
24800;2538;53;82;28;1;27;.964;3600000;0
24800;2615;40;91;57;5;52;.912;3600000;0
24800;2954;40;0;0;0;0;.00nan;0;0
24682;430;56;63;10;0;10;1.000;1156000;0
24682;771;34;0;0;0;0;.00nan;0;0
24682;1002;34;78;28;2;26;.929;3600000;0
24682;2081;56;45;24;4;20;.833;2396000;0
24729;1259;53;96;36;1;35;.972;3600000;0
24729;2538;53;0;0;0;0;.00nan;0;0
24729;2598;50;28;17;5;12;.706;3600000;0
24729;2751;50;0;0;0;0;.00nan;0;0
24665;281;57;94;39;2;37;.949;3828000;0
24665;427;54;0;0;0;0;.00nan;0;0
24665;778;54;90;34;1;33;.971;3828000;0
24665;2848;54;0;0;0;0;.00nan;0;0
24735;1458;61;49;28;4;24;.857;3700000;0
24735;1865;61;0;0;0;0;.00nan;0;0
24735;1875;37;0;0;0;0;.00nan;0;0
24735;2591;37;61;28;3;25;.893;3700000;0
24733;35;59;0;0;0;0;.00nan;0;0
24733;349;59;89;33;1;32;.970;3600000;0
24733;2615;40;0;0;0;0;.00nan;0;0
24733;2954;40;94;39;2;37;.949;3543000;0
24814;335;60;55;19;2;17;.895;3600000;0
24814;1911;31;59;23;3;20;.870;3600000;0
24814;2192;60;0;0;0;0;.00nan;0;0
24814;2936;31;0;0;0;0;.00nan;0;0
24872;430;56;46;33;6;27;.818;3529000;0
24872;485;36;0;0;0;0;.00nan;0;0
24872;599;36;100;28;0;28;1.000;3600000;0
24872;2081;56;51;2;0;2;1.000;71000;0
24709;346;46;0;0;0;0;.00nan;0;0
24709;1016;33;0;0;0;0;.00nan;0;0
24709;3987;33;54;23;3;20;.870;3600000;0
24709;4916;46;70;41;4;37;.902;3600000;0
24793;534;38;0;0;0;0;.00nan;0;0
24793;815;55;58;36;5;31;.861;3600000;0
24793;1311;55;0;0;0;0;.00nan;0;0
24793;1345;38;40;16;3;13;.813;3600000;0
24750;673;35;0;0;0;0;.00nan;0;0
24750;692;35;62;38;5;33;.868;3600000;0
24750;2033;51;0;0;0;0;.00nan;0;0
24750;2940;51;73;21;2;19;.905;3600000;0
24740;896;43;65;24;2;22;.917;3600000;0
24740;923;32;51;2;0;2;1.000;168000;0
24740;1988;43;0;0;0;0;.00nan;0;0
24740;2458;32;34;34;6;28;.824;3432000;0
24704;706;42;0;0;0;0;.00nan;0;0
24704;771;34;20;21;6;15;.714;3489000;0
24704;1002;34;50;1;0;1;1.000;111000;0
24704;2246;42;82;37;3;34;.919;3600000;0
24917;346;46;79;26;2;24;.923;3600000;0
24917;831;44;0;0;0;0;.00nan;0;0
24917;2916;44;52;27;4;23;.852;3555000;0
24917;4916;46;0;0;0;0;.00nan;0;0
24774;856;48;89;27;0;27;1.000;2682000;0
24774;2641;48;26;12;4;8;.667;918000;0
24774;2846;41;70;23;1;22;.957;3600000;0
24774;4968;41;0;0;0;0;.00nan;0;0
24818;401;47;0;0;0;0;.00nan;0;0
24818;1060;47;73;31;3;28;.903;3600000;0
24818;2598;50;0;0;0;0;.00nan;0;0
24818;2751;50;30;35;6;29;.829;3600000;0
24695;35;59;60;29;2;27;.931;3900000;0
24695;349;59;0;0;0;0;.00nan;0;0
24695;896;43;0;0;0;0;.00nan;0;0
24695;1988;43;86;37;2;35;.946;3900000;0
24756;593;57;68;26;3;23;.885;3600000;0
24756;907;57;0;0;0;0;.00nan;0;0
24756;2615;40;45;37;6;31;.838;2782000;0
24756;2954;40;56;5;0;5;1.000;818000;0
24776;352;45;0;0;0;0;.00nan;0;0
24776;1259;53;50;27;4;23;.852;3582000;0
24776;1934;45;81;39;3;36;.923;3600000;0
24776;2538;53;0;0;0;0;.00nan;0;0
24675;281;57;96;38;1;37;.974;3600000;0
24675;427;54;0;0;0;0;.00nan;0;0
24675;1234;39;65;36;3;33;.917;3553000;0
24675;1901;39;0;0;0;0;.00nan;0;0
24834;430;56;82;40;4;36;.900;3868000;0
24834;923;32;33;27;5;22;.815;3868000;0
24834;2081;56;0;0;0;0;.00nan;0;0
24834;2458;32;0;0;0;0;.00nan;0;0
24699;1279;49;84;23;1;22;.957;3600000;0
24699;1288;58;0;0;0;0;.00nan;0;0
24699;2273;49;0;0;0;0;.00nan;0;0
24699;2532;58;62;42;5;37;.881;3600000;0
24753;401;47;25;26;6;20;.769;3346000;0
24753;534;38;83;25;1;24;.960;3600000;0
24753;1060;47;49;1;0;1;1.000;254000;0
24753;1345;38;0;0;0;0;.00nan;0;0
24710;771;34;77;51;4;47;.922;3474000;0
24710;1002;34;50;1;0;1;1.000;104000;0
24710;1016;33;0;0;0;0;.00nan;0;0
24710;3987;33;62;20;2;18;.900;3600000;0
24880;706;42;49;23;3;20;.870;3876000;0
24880;815;55;0;0;0;0;.00nan;0;0
24880;1311;55;69;37;4;33;.892;3876000;0
24880;2246;42;0;0;0;0;.00nan;0;0
24738;1875;37;92;34;2;32;.941;3600000;0
24738;2591;37;0;0;0;0;.00nan;0;0
24738;2846;41;0;0;0;0;.00nan;0;0
24738;4968;41;53;42;5;37;.881;3600000;0
25010;335;60;59;24;3;21;.875;3600000;0
25010;2033;51;45;31;5;26;.839;3587000;0
25010;2192;60;0;0;0;0;.00nan;0;0
25010;2940;51;0;0;0;0;.00nan;0;0
24765;673;35;0;0;0;0;.00nan;0;0
24765;692;35;68;29;3;26;.897;3527000;0
24765;856;48;0;0;0;0;.00nan;0;0
24765;2641;48;84;31;1;30;.968;3600000;0
24677;281;57;0;0;0;0;.00nan;0;0
24677;427;54;68;36;4;32;.889;3600000;0
24677;1875;37;0;0;0;0;.00nan;0;0
24677;2591;37;90;21;0;21;1.000;3600000;0
24941;346;46;65;30;3;27;.900;2728000;0
24941;1234;39;0;0;0;0;.00nan;0;0
24941;1901;39;54;22;3;19;.864;3600000;0
24941;4916;46;18;10;4;6;.600;872000;0
24775;778;54;48;30;4;26;.867;3580000;0
24775;1279;49;0;0;0;0;.00nan;0;0
24775;2273;49;76;37;3;34;.919;3600000;0
24775;2848;54;0;0;0;0;.00nan;0;0
25098;771;34;0;0;0;0;.00nan;0;0
25098;1002;34;84;26;1;25;.962;3900000;0
25098;2598;50;88;32;1;31;.969;3900000;0
25098;2751;50;0;0;0;0;.00nan;0;0
24747;896;43;77;39;3;36;.923;3900000;0
24747;1458;61;0;0;0;0;.00nan;0;0
24747;1865;61;100;43;3;40;.930;3900000;0
24747;1988;43;0;0;0;0;.00nan;0;0
24705;35;59;0;0;0;0;.00nan;0;0
24705;349;59;70;41;4;37;.902;3560000;0
24705;352;45;66;26;3;23;.885;3600000;0
24705;1934;45;0;0;0;0;.00nan;0;0
25416;593;57;0;0;0;0;.00nan;0;0
25416;907;57;65;21;2;19;.905;3600000;0
25416;2615;40;62;33;3;30;.909;3600000;0
25416;2954;40;0;0;0;0;.00nan;0;0
25048;706;42;93;34;2;32;.941;3900000;0
25048;1911;31;0;0;0;0;.00nan;0;0
25048;2246;42;0;0;0;0;.00nan;0;0
25048;2936;31;63;25;2;23;.920;3900000;0
24878;485;36;0;0;0;0;.00nan;0;0
24878;599;36;47;23;3;20;.870;3555000;0
24878;2598;50;0;0;0;0;.00nan;0;0
24878;2751;50;66;25;2;23;.920;3600000;0
24762;778;54;0;0;0;0;.00nan;0;0
24762;1288;58;81;53;5;48;.906;3600000;0
24762;2532;58;0;0;0;0;.00nan;0;0
24762;2848;54;73;19;1;18;.947;3600000;0
25480;831;44;34;23;5;18;.783;3600000;0
25480;2033;51;0;0;0;0;.00nan;0;0
25480;2916;44;0;0;0;0;.00nan;0;0
25480;2940;51;71;26;2;24;.923;3600000;0
24831;352;45;0;0;0;0;.00nan;0;0
24831;923;32;49;37;6;31;.838;3576000;0
24831;992;32;0;0;0;0;.00nan;0;0
24831;1934;45;39;26;5;21;.808;3600000;0
24723;593;57;80;36;3;33;.917;3900000;0
24723;907;57;0;0;0;0;.00nan;0;0
24723;1016;33;59;27;3;24;.889;3900000;0
24723;3987;33;0;0;0;0;.00nan;0;0
24724;281;57;65;25;2;23;.920;3600000;0
24724;427;54;0;0;0;0;.00nan;0;0
24724;778;54;46;17;3;14;.824;3600000;0
24724;2848;54;0;0;0;0;.00nan;0;0
24763;534;38;93;19;0;19;1.000;3600000;0
24763;593;57;0;0;0;0;.00nan;0;0
24763;907;57;64;35;3;32;.914;3600000;0
24763;1345;38;0;0;0;0;.00nan;0;0
24718;771;34;81;39;3;36;.923;3600000;0
24718;1002;34;0;0;0;0;.00nan;0;0
24718;1288;58;0;0;0;0;.00nan;0;0
24718;2532;58;53;34;5;29;.853;3516000;0
24881;346;46;75;28;1;27;.964;3600000;0
24881;2598;50;69;38;4;34;.895;3600000;0
24881;2751;50;0;0;0;0;.00nan;0;0
24881;4916;46;0;0;0;0;.00nan;0;0
24990;430;56;61;24;3;21;.875;3573000;0
24990;2033;51;0;0;0;0;.00nan;0;0
24990;2081;56;0;0;0;0;.00nan;0;0
24990;2940;51;90;41;2;39;.951;3600000;0
24835;401;47;0;0;0;0;.00nan;0;0
24835;1060;47;56;17;2;15;.882;3560000;0
24835;2615;40;0;0;0;0;.00nan;0;0
24835;2954;40;81;28;1;27;.964;3600000;0
24856;1259;53;22;25;6;19;.760;3600000;0
24856;1875;37;0;0;0;0;.00nan;0;0
24856;2538;53;0;0;0;0;.00nan;0;0
24856;2591;37;81;34;3;31;.912;3600000;0
24777;673;35;69;37;5;32;.865;3600000;0
24777;692;35;0;0;0;0;.00nan;0;0
24777;1458;61;62;9;0;9;1.000;1162000;0
24777;1865;61;26;33;7;26;.788;2364000;0
25153;485;36;67;30;2;28;.933;3900000;0
25153;599;36;0;0;0;0;.00nan;0;0
25153;831;44;0;0;0;0;.00nan;0;0
25153;2916;44;76;30;2;28;.933;3900000;0
24865;485;36;0;0;0;0;.00nan;0;0
24865;599;36;47;26;4;22;.846;3900000;0
24865;1279;49;73;39;4;35;.897;3900000;0
24865;2273;49;0;0;0;0;.00nan;0;0
25073;815;55;0;0;0;0;.00nan;0;0
25073;1311;55;55;17;2;15;.882;3600000;0
25073;1911;31;0;0;0;0;.00nan;0;0
25073;2936;31;82;43;3;40;.930;3555000;0
24691;281;57;0;0;0;0;.00nan;0;0
24691;427;54;84;36;3;33;.917;3524000;0
24691;2598;50;0;0;0;0;.00nan;0;0
24691;2751;50;91;27;1;26;.963;3600000;0
24717;35;59;0;0;0;0;.00nan;0;0
24717;349;59;50;21;3;18;.857;3553000;0
24717;771;34;0;0;0;0;.00nan;0;0
24717;1002;34;85;24;1;23;.958;3600000;0
24755;778;54;0;0;0;0;.00nan;0;0
24755;1458;61;71;29;2;27;.931;3583000;0
24755;1865;61;0;0;0;0;.00nan;0;0
24755;2848;54;82;21;1;20;.952;3600000;0
24732;534;38;0;0;0;0;.00nan;0;0
24732;1016;33;74;30;3;27;.900;3569000;0
24732;1345;38;88;31;1;30;.968;3600000;0
24732;3987;33;0;0;0;0;.00nan;0;0
24791;346;46;0;0;0;0;.00nan;0;0
24791;856;48;0;0;0;0;.00nan;0;0
24791;2641;48;96;38;1;37;.974;3600000;0
24791;4916;46;100;27;0;27;1.000;3600000;0
24816;673;35;0;0;0;0;.00nan;0;0
24816;692;35;98;47;3;44;.936;3577000;0
24816;706;42;100;29;1;28;.966;3600000;0
24816;2246;42;0;0;0;0;.00nan;0;0
24803;923;32;55;24;4;20;.833;3600000;0
24803;992;32;0;0;0;0;.00nan;0;0
24803;1259;53;48;0;0;0;.00nan;327000;0
24803;2538;53;18;28;7;21;.750;3273000;0
24833;352;45;0;0;0;0;.00nan;0;0
24833;1875;37;57;33;5;28;.848;3583000;0
24833;1934;45;44;27;4;23;.852;3600000;0
24833;2591;37;0;0;0;0;.00nan;0;0
24782;401;47;60;33;4;29;.879;3731000;0
24782;1060;47;0;0;0;0;.00nan;0;0
24782;1288;58;48;33;5;28;.848;3731000;0
24782;2532;58;0;0;0;0;.00nan;0;0
24795;1234;39;40;16;3;13;.813;3524000;0
24795;1901;39;0;0;0;0;.00nan;0;0
24795;2846;41;90;45;2;43;.956;3600000;0
24795;4968;41;0;0;0;0;.00nan;0;0
24802;430;56;0;0;0;0;.00nan;0;0
24802;896;43;0;0;0;0;.00nan;0;0
24802;1988;43;62;29;3;26;.897;3600000;0
24802;2081;56;100;28;0;28;1.000;3600000;0
24845;831;44;28;6;3;3;.500;388000;0
24845;2615;40;70;43;4;39;.907;3555000;0
24845;2916;44;66;18;1;17;.944;3212000;0
24845;2954;40;0;0;0;0;.00nan;0;0
25336;335;60;72;29;3;26;.897;3893000;0
25336;856;48;0;0;0;0;.00nan;0;0
25336;2192;60;0;0;0;0;.00nan;0;0
25336;2641;48;88;45;3;42;.933;3900000;0
24808;1911;31;62;21;2;19;.905;3579000;0
24808;2615;40;100;39;0;39;1.000;3600000;0
24808;2936;31;0;0;0;0;.00nan;0;0
24808;2954;40;0;0;0;0;.00nan;0;0
24785;1016;33;0;0;0;0;.00nan;0;0
24785;1234;39;72;22;1;21;.955;3600000;0
24785;1901;39;0;0;0;0;.00nan;0;0
24785;3987;33;71;36;3;33;.917;3577000;0
24888;401;47;0;0;0;0;.00nan;0;0
24888;1060;47;55;20;3;17;.850;3600000;0
24888;2033;51;0;0;0;0;.00nan;0;0
24888;2940;51;92;33;1;32;.970;3600000;0
24786;896;43;89;50;2;48;.960;3900000;0
24786;1288;58;76;31;2;29;.935;3900000;0
24786;1988;43;0;0;0;0;.00nan;0;0
24786;2532;58;0;0;0;0;.00nan;0;0
24921;485;36;50;0;0;0;.00nan;29000;0
24921;599;36;28;28;6;22;.786;3571000;0
24921;1259;53;0;0;0;0;.00nan;0;0
24921;2538;53;98;22;0;22;1.000;3600000;0
24846;352;45;59;29;3;26;.897;3131000;0
24846;923;32;100;41;1;40;.976;3600000;0
24846;992;32;0;0;0;0;.00nan;0;0
24846;1934;45;25;6;3;3;.500;469000;0
24760;778;54;69;35;3;32;.914;3600000;0
24760;2846;41;0;0;0;0;.00nan;0;0
24760;2848;54;0;0;0;0;.00nan;0;0
24760;4968;41;91;29;1;28;.966;3600000;0
24902;706;42;97;36;2;34;.944;3593000;0
24902;2246;42;0;0;0;0;.00nan;0;0
24902;2598;50;69;23;1;22;.957;3600000;0
24902;2751;50;0;0;0;0;.00nan;0;0
24842;673;35;95;32;1;31;.969;3600000;0
24842;692;35;0;0;0;0;.00nan;0;0
24842;1875;37;67;24;2;22;.917;3554000;0
24842;2591;37;0;0;0;0;.00nan;0;0
24908;815;55;0;0;0;0;.00nan;0;0
24908;831;44;74;20;1;19;.950;3600000;0
24908;1311;55;83;45;4;41;.911;3600000;0
24908;2916;44;0;0;0;0;.00nan;0;0
24736;35;59;0;0;0;0;.00nan;0;0
24736;349;59;59;27;3;24;.889;3543000;0
24736;593;57;100;46;1;45;.978;3600000;0
24736;907;57;0;0;0;0;.00nan;0;0
24810;534;38;66;19;1;18;.947;3600000;0
24810;1345;38;0;0;0;0;.00nan;0;0
24810;2033;51;49;26;4;22;.846;3600000;0
24810;2940;51;0;0;0;0;.00nan;0;0
25655;778;54;0;0;0;0;.00nan;0;0
25655;856;48;0;0;0;0;.00nan;0;0
25655;2641;48;100;46;2;44;.957;3600000;0
25655;2848;54;75;44;5;39;.886;3600000;0
24933;1234;39;0;0;0;0;.00nan;0;0
24933;1279;49;85;43;3;40;.930;3546000;0
24933;1901;39;77;26;1;25;.962;3600000;0
24933;2273;49;0;0;0;0;.00nan;0;0
24838;335;60;55;36;4;32;.889;3600000;0
24838;923;32;49;1;0;1;1.000;68000;0
24838;992;32;59;45;7;38;.844;3532000;0
24838;2192;60;0;0;0;0;.00nan;0;0
25064;430;56;0;0;0;0;.00nan;0;0
25064;815;55;49;26;4;22;.846;3600000;0
25064;1311;55;0;0;0;0;.00nan;0;0
25064;2081;56;73;22;1;21;.955;3600000;0
24824;706;42;0;0;0;0;.00nan;0;0
24824;896;43;58;5;0;5;1.000;508000;0
24824;1988;43;20;29;7;22;.759;3092000;0
24824;2246;42;100;31;0;31;1.000;3600000;0
25671;1288;58;0;0;0;0;.00nan;0;0
25671;1875;37;0;0;0;0;.00nan;0;0
25671;2532;58;66;27;2;25;.926;3600000;0
25671;2591;37;26;28;6;22;.786;3600000;0
24741;35;59;59;26;3;23;.885;3600000;0
24741;349;59;0;0;0;0;.00nan;0;0
24741;352;45;0;0;0;0;.00nan;0;0
24741;1934;45;48;34;6;28;.824;3600000;0
24779;1458;61;97;25;0;25;1.000;3477000;0
24779;1865;61;23;4;3;1;.250;123000;0
24779;2846;41;95;20;0;20;1.000;3600000;0
24779;4968;41;0;0;0;0;.00nan;0;0
24945;1259;53;0;0;0;0;.00nan;0;0
24945;1458;61;0;0;0;0;.00nan;0;0
24945;1865;61;50;30;4;26;.867;3563000;0
24945;2538;53;71;29;2;27;.931;3600000;0
24840;593;57;62;37;4;33;.892;3900000;0
24840;907;57;0;0;0;0;.00nan;0;0
24840;1911;31;0;0;0;0;.00nan;0;0
24840;2936;31;34;28;4;24;.857;3900000;0
24726;281;57;91;42;2;40;.952;3600000;0
24726;427;54;0;0;0;0;.00nan;0;0
24726;1279;49;0;0;0;0;.00nan;0;0
24726;2273;49;52;23;3;20;.870;3541000;0
24844;346;46;0;0;0;0;.00nan;0;0
24844;1016;33;74;27;2;25;.926;3600000;0
24844;3987;33;0;0;0;0;.00nan;0;0
24844;4916;46;68;45;4;41;.911;3516000;0
24722;771;34;0;0;0;0;.00nan;0;0
24722;856;48;0;0;0;0;.00nan;0;0
24722;1002;34;58;31;4;27;.871;3564000;0
24722;2641;48;76;24;2;22;.917;3600000;0
25616;485;36;72;33;2;31;.939;3600000;0
25616;599;36;0;0;0;0;.00nan;0;0
25616;673;35;48;0;0;0;.00nan;210000;0
25616;692;35;42;36;6;30;.833;3390000;0
24797;534;38;100;38;1;37;.974;3600000;0
24797;1288;58;0;0;0;0;.00nan;0;0
24797;1345;38;0;0;0;0;.00nan;0;0
24797;2532;58;77;38;3;35;.921;3558000;0
24778;352;45;0;0;0;0;.00nan;0;0
24778;771;34;66;16;1;15;.938;3600000;0
24778;1002;34;0;0;0;0;.00nan;0;0
24778;1934;45;68;28;2;26;.929;3561000;0
24744;281;57;97;26;1;25;.962;3900000;0
24744;427;54;0;0;0;0;.00nan;0;0
24744;1458;61;95;30;1;29;.967;3900000;0
24744;1865;61;0;0;0;0;.00nan;0;0
24870;593;57;80;33;3;30;.909;3584000;0
24870;907;57;0;0;0;0;.00nan;0;0
24870;2615;40;87;31;1;30;.968;3600000;0
24870;2954;40;0;0;0;0;.00nan;0;0
24769;35;59;0;0;0;0;.00nan;0;0
24769;349;59;61;34;4;30;.882;3600000;0
24769;778;54;54;37;5;32;.865;3566000;0
24769;2848;54;0;0;0;0;.00nan;0;0
24944;815;55;75;42;4;38;.905;3600000;0
24944;1016;33;0;0;0;0;.00nan;0;0
24944;1311;55;0;0;0;0;.00nan;0;0
24944;3987;33;93;21;0;21;1.000;3600000;0
24926;1259;53;72;27;1;26;.963;3548000;0
24926;2033;51;0;0;0;0;.00nan;0;0
24926;2538;53;0;0;0;0;.00nan;0;0
24926;2940;51;100;24;0;24;1.000;3600000;0
24850;896;43;76;44;4;40;.909;3600000;0
24850;1234;39;76;30;2;28;.933;3600000;0
24850;1901;39;0;0;0;0;.00nan;0;0
24850;1988;43;0;0;0;0;.00nan;0;0
24761;778;54;0;0;0;0;.00nan;0;0
24761;1016;33;0;0;0;0;.00nan;0;0
24761;2848;54;42;30;5;25;.833;3600000;0
24761;3987;33;82;32;2;30;.938;3600000;0
24826;534;38;0;0;0;0;.00nan;0;0
24826;815;55;0;0;0;0;.00nan;0;0
24826;1311;55;68;22;2;20;.909;3577000;0
24826;1345;38;83;24;1;23;.958;3600000;0
24971;401;47;0;0;0;0;.00nan;0;0
24971;1060;47;58;34;4;30;.882;3600000;0
24971;1234;39;0;0;0;0;.00nan;0;0
24971;1901;39;63;26;3;23;.885;3600000;0
24837;485;36;61;25;2;23;.920;3600000;0
24837;599;36;0;0;0;0;.00nan;0;0
24837;896;43;0;0;0;0;.00nan;0;0
24837;1988;43;57;40;5;35;.875;3600000;0
24770;281;57;0;0;0;0;.00nan;0;0
24770;427;54;74;31;2;29;.935;3829000;0
24770;430;56;0;0;0;0;.00nan;0;0
24770;2081;56;81;35;3;32;.914;3829000;0
24950;346;46;0;0;0;0;.00nan;0;0
24950;2033;51;0;0;0;0;.00nan;0;0
24950;2940;51;81;34;2;32;.941;3577000;0
24950;4916;46;61;12;1;11;.917;3600000;0
24794;35;59;0;0;0;0;.00nan;0;0
24794;349;59;99;36;1;35;.972;3600000;0
24794;831;44;0;0;0;0;.00nan;0;0
24794;2916;44;69;27;2;25;.926;3559000;0
24839;923;32;96;40;1;39;.975;3890000;0
24839;992;32;0;0;0;0;.00nan;0;0
24839;1279;49;97;37;1;36;.973;3900000;0
24839;2273;49;0;0;0;0;.00nan;0;0
25239;856;48;0;0;0;0;.00nan;0;0
25239;1911;31;74;32;2;30;.938;3555000;0
25239;2641;48;85;28;1;27;.964;3600000;0
25239;2936;31;0;0;0;0;.00nan;0;0
24783;335;60;92;19;1;18;.947;3600000;0
24783;1458;61;0;0;0;0;.00nan;0;0
24783;1865;61;77;32;3;29;.906;3557000;0
24783;2192;60;0;0;0;0;.00nan;0;0
24809;2598;50;0;0;0;0;.00nan;0;0
24809;2751;50;55;33;4;29;.879;3571000;0
24809;2846;41;75;32;2;30;.938;3600000;0
24809;4968;41;0;0;0;0;.00nan;0;0
24784;593;57;78;36;4;32;.889;3900000;0
24784;907;57;0;0;0;0;.00nan;0;0
24784;1279;49;0;0;0;0;.00nan;0;0
24784;2273;49;51;31;4;27;.871;3900000;0
24815;771;34;94;48;3;45;.938;3600000;0
24815;1002;34;0;0;0;0;.00nan;0;0
24815;2846;41;0;0;0;0;.00nan;0;0
24815;4968;41;36;34;6;28;.824;3600000;0
25205;856;48;0;0;0;0;.00nan;0;0
25205;1911;31;0;0;0;0;.00nan;0;0
25205;2641;48;80;29;2;27;.931;3543000;0
25205;2936;31;77;23;1;22;.957;3600000;0
24827;771;34;0;0;0;0;.00nan;0;0
24827;1002;34;43;26;4;22;.846;3600000;0
24827;1875;37;100;34;1;33;.971;3600000;0
24827;2591;37;0;0;0;0;.00nan;0;0
24841;430;56;0;0;0;0;.00nan;0;0
24841;1288;58;55;33;5;28;.848;3600000;0
24841;2081;56;24;23;6;17;.739;3549000;0
24841;2532;58;0;0;0;0;.00nan;0;0
24937;2033;51;61;49;5;44;.898;3600000;0
24937;2598;50;97;21;0;21;1.000;3600000;0
24937;2751;50;0;0;0;0;.00nan;0;0
24937;2940;51;0;0;0;0;.00nan;0;0
24965;923;32;100;36;1;35;.972;3600000;0
24965;992;32;0;0;0;0;.00nan;0;0
24965;1234;39;59;19;2;17;.895;3600000;0
24965;1901;39;0;0;0;0;.00nan;0;0
24787;706;42;0;0;0;0;.00nan;0;0
24787;778;54;75;39;4;35;.897;3600000;0
24787;2246;42;87;28;1;27;.964;3600000;0
24787;2848;54;0;0;0;0;.00nan;0;0
24866;401;47;0;0;0;0;.00nan;0;0
24866;593;57;0;0;0;0;.00nan;0;0
24866;907;57;100;33;0;33;1.000;3600000;0
24866;1060;47;43;29;4;25;.862;3600000;0
24863;485;36;65;27;2;25;.926;3900000;0
24863;534;38;94;40;2;38;.950;3900000;0
24863;599;36;0;0;0;0;.00nan;0;0
24863;1345;38;0;0;0;0;.00nan;0;0
25670;352;45;0;0;0;0;.00nan;0;0
25670;1458;61;0;0;0;0;.00nan;0;0
25670;1865;61;96;40;2;38;.950;3900000;0
25670;1934;45;81;34;2;32;.941;3900000;0
24913;335;60;67;24;2;22;.917;3844000;0
24913;673;35;0;0;0;0;.00nan;0;0
24913;692;35;63;22;3;19;.864;3844000;0
24913;2192;60;0;0;0;0;.00nan;0;0
24857;896;43;60;31;3;28;.903;3570000;0
24857;1259;53;70;22;1;21;.955;3600000;0
24857;1988;43;0;0;0;0;.00nan;0;0
24857;2538;53;0;0;0;0;.00nan;0;0
25079;401;47;45;50;7;43;.860;3391000;0
25079;856;48;63;22;2;20;.909;3600000;0
25079;1060;47;40;2;1;1;.500;209000;0
25079;2641;48;0;0;0;0;.00nan;0;0
24860;815;55;0;0;0;0;.00nan;0;0
24860;1311;55;98;38;1;37;.974;3582000;0
24860;2615;40;92;20;0;20;1.000;3600000;0
24860;2954;40;0;0;0;0;.00nan;0;0
24877;352;45;97;45;3;42;.933;3562000;0
24877;1279;49;87;35;2;33;.943;3600000;0
24877;1934;45;0;0;0;0;.00nan;0;0
24877;2273;49;0;0;0;0;.00nan;0;0
24796;1458;61;76;31;2;29;.935;3600000;0
24796;1865;61;0;0;0;0;.00nan;0;0
24796;1875;37;0;0;0;0;.00nan;0;0
24796;2591;37;59;26;3;23;.885;3600000;0
24914;430;56;81;25;1;24;.960;3600000;0
24914;673;35;71;40;4;36;.900;3600000;0
24914;692;35;0;0;0;0;.00nan;0;0
24914;2081;56;0;0;0;0;.00nan;0;0
25020;831;44;0;0;0;0;.00nan;0;0
25020;1259;53;0;0;0;0;.00nan;0;0
25020;2538;53;48;37;5;32;.865;3514000;0
25020;2916;44;79;35;3;32;.914;3600000;0
24798;1288;58;71;36;3;33;.917;3600000;0
24798;2532;58;0;0;0;0;.00nan;0;0
24798;2846;41;100;34;0;34;1.000;3600000;0
24798;4968;41;0;0;0;0;.00nan;0;0
24804;35;59;0;0;0;0;.00nan;0;0
24804;335;60;0;0;0;0;.00nan;0;0
24804;349;59;63;37;4;33;.892;3600000;0
24804;2192;60;86;17;0;17;1.000;3600000;0
24737;706;42;37;28;5;23;.821;3560000;0
24737;1016;33;0;0;0;0;.00nan;0;0
24737;2246;42;0;0;0;0;.00nan;0;0
24737;3987;33;45;23;4;19;.826;3600000;0
24988;2033;51;0;0;0;0;.00nan;0;0
24988;2598;50;65;30;3;27;.900;3900000;0
24988;2751;50;0;0;0;0;.00nan;0;0
24988;2940;51;68;31;3;28;.903;3900000;0
24901;485;36;0;0;0;0;.00nan;0;0
24901;599;36;59;21;2;19;.905;3600000;0
24901;2615;40;55;43;6;37;.860;3600000;0
24901;2954;40;0;0;0;0;.00nan;0;0
25124;831;44;36;21;4;17;.810;3563000;0
25124;923;32;65;27;2;25;.926;3600000;0
25124;992;32;0;0;0;0;.00nan;0;0
25124;2916;44;0;0;0;0;.00nan;0;0
25657;778;54;52;29;4;25;.862;3584000;0
25657;815;55;92;37;2;35;.946;3600000;0
25657;1311;55;0;0;0;0;.00nan;0;0
25657;2848;54;0;0;0;0;.00nan;0;0
25594;346;46;0;0;0;0;.00nan;0;0
25594;1911;31;39;28;5;23;.821;3541000;0
25594;2936;31;0;0;0;0;.00nan;0;0
25594;4916;46;56;28;4;24;.857;3600000;0
24759;281;57;56;26;3;23;.885;3545000;0
24759;427;54;0;0;0;0;.00nan;0;0
24759;706;42;0;0;0;0;.00nan;0;0
24759;2246;42;80;31;2;29;.935;3600000;0
24861;352;45;49;30;5;25;.833;3600000;0
24861;1875;37;100;39;1;38;.974;3600000;0
24861;1934;45;0;0;0;0;.00nan;0;0
24861;2591;37;0;0;0;0;.00nan;0;0
25664;485;36;14;22;6;16;.727;3413000;0
25664;599;36;55;4;0;4;1.000;187000;0
25664;771;34;98;35;2;33;.943;3600000;0
25664;1002;34;0;0;0;0;.00nan;0;0
25668;335;60;0;0;0;0;.00nan;0;0
25668;593;57;0;0;0;0;.00nan;0;0
25668;907;57;54;33;4;29;.879;3514000;0
25668;2192;60;90;41;2;39;.951;3600000;0
24942;673;35;0;0;0;0;.00nan;0;0
24942;692;35;71;39;4;35;.897;3551000;0
24942;1911;31;0;0;0;0;.00nan;0;0
24942;2936;31;71;33;3;30;.909;3600000;0
25253;346;46;75;23;1;22;.957;3600000;0
25253;815;55;67;38;4;34;.895;3600000;0
25253;1311;55;0;0;0;0;.00nan;0;0
25253;4916;46;0;0;0;0;.00nan;0;0
24821;281;57;75;33;2;31;.939;3900000;0
24821;427;54;0;0;0;0;.00nan;0;0
24821;1259;53;83;30;2;28;.933;3900000;0
24821;2538;53;0;0;0;0;.00nan;0;0
24817;778;54;78;48;4;44;.917;3600000;0
24817;2615;40;0;0;0;0;.00nan;0;0
24817;2848;54;0;0;0;0;.00nan;0;0
24817;2954;40;81;23;1;22;.957;3600000;0
24868;831;44;0;0;0;0;.00nan;0;0
24868;1085;44;74;25;2;23;.920;3591000;0
24868;2846;41;93;31;1;30;.968;3600000;0
24868;4968;41;0;0;0;0;.00nan;0;0
24805;1016;33;75;21;1;20;.952;3900000;0
24805;1458;61;0;0;0;0;.00nan;0;0
24805;1865;61;72;25;1;24;.960;3900000;0
24805;3987;33;0;0;0;0;.00nan;0;0
24919;534;38;52;27;3;24;.889;3565000;0
24919;1345;38;0;0;0;0;.00nan;0;0
24919;2033;51;0;0;0;0;.00nan;0;0
24919;2940;51;81;33;2;31;.939;3600000;0
24811;35;59;0;0;0;0;.00nan;0;0
24811;349;59;51;35;5;30;.857;3600000;0
24811;1234;39;100;26;0;26;1.000;3600000;0
24811;1901;39;0;0;0;0;.00nan;0;0
24847;1458;61;100;41;3;38;.927;3900000;0
24847;1865;61;0;0;0;0;.00nan;0;0
24847;1911;31;61;21;3;18;.857;3900000;0
24847;2936;31;0;0;0;0;.00nan;0;0
24813;335;60;51;29;4;25;.862;3515000;0
24813;771;34;76;33;2;31;.939;3600000;0
24813;1002;34;0;0;0;0;.00nan;0;0
24813;2192;60;0;0;0;0;.00nan;0;0
24862;831;44;47;27;4;23;.852;3564000;0
24862;1085;44;0;0;0;0;.00nan;0;0
24862;2846;41;0;0;0;0;.00nan;0;0
24862;4968;41;77;36;2;34;.944;3600000;0
24869;401;47;50;0;0;0;.00nan;31000;0
24869;896;43;0;0;0;0;.00nan;0;0
24869;1060;47;44;41;6;35;.854;3569000;0
24869;1988;43;67;22;2;20;.909;3600000;0
24887;352;45;0;0;0;0;.00nan;0;0
24887;706;42;84;29;2;27;.931;3600000;0
24887;1934;45;47;27;4;23;.852;3561000;0
24887;2246;42;0;0;0;0;.00nan;0;0
24854;778;54;0;0;0;0;.00nan;0;0
24854;1259;53;0;0;0;0;.00nan;0;0
24854;2538;53;76;22;2;20;.909;3600000;0
24854;2848;54;49;36;6;30;.833;3600000;0
24882;485;36;0;0;0;0;.00nan;0;0
24882;599;36;78;30;2;28;.933;3900000;0
24882;1875;37;85;29;2;27;.931;3900000;0
24882;2591;37;0;0;0;0;.00nan;0;0
24953;534;38;0;0;0;0;.00nan;0;0
24953;923;32;0;0;0;0;.00nan;0;0
24953;992;32;65;37;4;33;.892;3581000;0
24953;1345;38;61;20;2;18;.900;3600000;0
24849;1016;33;0;0;0;0;.00nan;0;0
24849;1288;58;75;27;2;25;.926;3600000;0
24849;2532;58;0;0;0;0;.00nan;0;0
24849;3987;33;50;44;6;38;.864;3600000;0
24918;856;48;0;0;0;0;.00nan;0;0
24918;2598;50;54;36;5;31;.861;3592000;0
24918;2641;48;63;32;4;28;.875;3600000;0
24918;2751;50;0;0;0;0;.00nan;0;0
24899;593;57;80;32;3;29;.906;3600000;0
24899;907;57;0;0;0;0;.00nan;0;0
24899;2033;51;72;37;4;33;.892;3522000;0
24899;2940;51;53;2;0;2;1.000;78000;0
24832;281;57;63;41;5;36;.878;3533000;0
24832;346;46;0;0;0;0;.00nan;0;0
24832;427;54;0;0;0;0;.00nan;0;0
24832;4916;46;67;25;3;22;.880;3600000;0
25645;815;55;86;45;4;41;.911;3555000;0
25645;1311;55;0;0;0;0;.00nan;0;0
25645;1875;37;0;0;0;0;.00nan;0;0
25645;2591;37;59;21;3;18;.857;3600000;0
24994;673;35;0;0;0;0;.00nan;0;0
24994;692;35;94;36;2;34;.944;3600000;0
24994;706;42;0;0;0;0;.00nan;0;0
24994;2246;42;54;38;5;33;.868;3600000;0
25567;815;55;0;0;0;0;.00nan;0;0
25567;1234;39;41;22;4;18;.818;3600000;0
25567;1311;55;100;46;1;45;.978;3600000;0
25567;1901;39;0;0;0;0;.00nan;0;0
25054;1911;31;0;0;0;0;.00nan;0;0
25054;2615;40;93;44;2;42;.955;3600000;0
25054;2936;31;67;26;3;23;.885;3554000;0
25054;2954;40;0;0;0;0;.00nan;0;0
24820;2598;50;0;0;0;0;.00nan;0;0
24820;2751;50;82;25;1;24;.960;3600000;0
24820;2846;41;81;33;2;31;.939;3600000;0
24820;4968;41;0;0;0;0;.00nan;0;0
24855;401;47;0;0;0;0;.00nan;0;0
24855;771;34;49;24;4;20;.833;3900000;0
24855;1002;34;0;0;0;0;.00nan;0;0
24855;1060;47;81;47;4;43;.915;3900000;0
24851;673;35;85;44;3;41;.932;3600000;0
24851;692;35;0;0;0;0;.00nan;0;0
24851;1288;58;0;0;0;0;.00nan;0;0
24851;2532;58;69;24;2;22;.917;3600000;0
24894;335;60;91;37;2;35;.946;3600000;0
24894;896;43;0;0;0;0;.00nan;0;0
24894;1988;43;71;34;4;30;.882;3570000;0
24894;2192;60;0;0;0;0;.00nan;0;0
24829;35;59;0;0;0;0;.00nan;0;0
24829;349;59;65;26;2;24;.923;3900000;0
24829;923;32;84;35;2;33;.943;3900000;0
24829;992;32;0;0;0;0;.00nan;0;0
24807;1016;33;84;18;0;18;1.000;3900000;0
24807;1458;61;0;0;0;0;.00nan;0;0
24807;1865;61;100;44;0;44;1.000;3900000;0
24807;3987;33;0;0;0;0;.00nan;0;0
24843;281;57;0;0;0;0;.00nan;0;0
24843;427;54;96;39;0;39;1.000;3900000;0
24843;1279;49;92;18;0;18;1.000;3900000;0
24843;2273;49;0;0;0;0;.00nan;0;0
24873;534;38;87;34;3;31;.912;3900000;0
24873;1259;53;84;40;3;37;.925;3900000;0
24873;1345;38;0;0;0;0;.00nan;0;0
24873;2538;53;0;0;0;0;.00nan;0;0
24889;706;42;84;37;3;34;.919;3900000;0
24889;923;32;0;0;0;0;.00nan;0;0
24889;992;32;72;29;3;26;.897;3900000;0
24889;2246;42;0;0;0;0;.00nan;0;0
24895;593;57;76;25;1;24;.960;3553000;0
24895;907;57;0;0;0;0;.00nan;0;0
24895;1875;37;100;35;0;35;1.000;3600000;0
24895;2591;37;0;0;0;0;.00nan;0;0
24904;896;43;57;27;3;24;.889;3600000;0
24904;1988;43;0;0;0;0;.00nan;0;0
24904;2033;51;65;45;5;40;.889;3572000;0
24904;2940;51;0;0;0;0;.00nan;0;0
24853;35;59;71;38;4;34;.895;3900000;0
24853;335;60;0;0;0;0;.00nan;0;0
24853;349;59;0;0;0;0;.00nan;0;0
24853;2192;60;51;30;4;26;.867;3900000;0
24922;352;45;83;34;3;31;.912;3600000;0
24922;401;47;100;40;2;38;.950;3600000;0
24922;1060;47;0;0;0;0;.00nan;0;0
24922;1934;45;0;0;0;0;.00nan;0;0
24859;485;36;85;15;0;15;1.000;3600000;0
24859;599;36;0;0;0;0;.00nan;0;0
24859;1288;58;64;34;4;30;.882;3600000;0
24859;2532;58;0;0;0;0;.00nan;0;0
25197;430;56;94;24;0;24;1.000;3600000;0
25197;1911;31;89;49;4;45;.918;3600000;0
25197;2081;56;0;0;0;0;.00nan;0;0
25197;2936;31;0;0;0;0;.00nan;0;0
25348;346;46;53;33;5;28;.848;2107000;0
25348;856;48;0;0;0;0;.00nan;0;0
25348;2641;48;46;36;5;31;.861;3600000;0
25348;4916;46;56;11;1;10;.909;1463000;0
25669;2033;51;0;0;0;0;.00nan;0;0
25669;2846;41;41;17;3;14;.824;3600000;0
25669;2940;51;87;28;2;26;.929;3600000;0
25669;4968;41;0;0;0;0;.00nan;0;0
25101;430;56;87;44;3;41;.932;3600000;0
25101;485;36;72;10;0;10;1.000;3600000;0
25101;599;36;0;0;0;0;.00nan;0;0
25101;2081;56;0;0;0;0;.00nan;0;0
25578;815;55;43;35;5;30;.857;3600000;0
25578;856;48;100;23;0;23;1.000;3600000;0
25578;1311;55;0;0;0;0;.00nan;0;0
25578;2641;48;0;0;0;0;.00nan;0;0
24928;352;45;0;0;0;0;.00nan;0;0
24928;1934;45;64;27;3;24;.889;3900000;0
24928;2615;40;74;32;3;29;.906;3900000;0
24928;2954;40;0;0;0;0;.00nan;0;0
24884;1279;49;60;33;4;29;.879;3600000;0
24884;1875;37;0;0;0;0;.00nan;0;0
24884;2273;49;0;0;0;0;.00nan;0;0
24884;2591;37;50;35;5;30;.857;3600000;0
24946;593;57;0;0;0;0;.00nan;0;0
24946;907;57;96;33;1;32;.970;3600000;0
24946;1234;39;56;37;5;32;.865;3600000;0
24946;1901;39;0;0;0;0;.00nan;0;0
25025;673;35;0;0;0;0;.00nan;0;0
25025;692;35;86;39;2;37;.949;3570000;0
25025;831;44;0;0;0;0;.00nan;0;0
25025;1085;44;68;18;1;17;.944;3600000;0
24848;771;34;0;0;0;0;.00nan;0;0
24848;778;54;0;0;0;0;.00nan;0;0
24848;1002;34;63;21;2;19;.905;3600000;0
24848;2848;54;59;27;3;24;.889;3554000;0
24912;1279;49;0;0;0;0;.00nan;0;0
24912;2273;49;62;30;3;27;.900;3600000;0
24912;2598;50;68;21;2;19;.905;3600000;0
24912;2751;50;0;0;0;0;.00nan;0;0
25006;352;45;80;38;3;35;.921;3600000;0
25006;401;47;0;0;0;0;.00nan;0;0
25006;1060;47;41;22;4;18;.818;3551000;0
25006;1934;45;0;0;0;0;.00nan;0;0
24930;856;48;74;27;3;24;.889;3600000;0
24930;1288;58;49;34;5;29;.853;3577000;0
24930;2532;58;0;0;0;0;.00nan;0;0
24930;2641;48;0;0;0;0;.00nan;0;0
24903;1259;53;60;27;3;24;.889;3600000;0
24903;2538;53;0;0;0;0;.00nan;0;0
24903;2615;40;88;54;4;50;.926;3579000;0
24903;2954;40;0;0;0;0;.00nan;0;0
25047;1234;39;96;33;1;32;.970;3600000;0
25047;1875;37;77;39;3;36;.923;3540000;0
25047;1901;39;0;0;0;0;.00nan;0;0
25047;2591;37;0;0;0;0;.00nan;0;0
24932;593;57;94;42;2;40;.952;3522000;0
24932;706;42;100;35;0;35;1.000;3600000;0
24932;907;57;0;0;0;0;.00nan;0;0
24932;2246;42;0;0;0;0;.00nan;0;0
24956;831;44;0;0;0;0;.00nan;0;0
24956;1016;33;43;20;4;16;.800;3542000;0
24956;1085;44;59;18;2;16;.889;3600000;0
24956;3987;33;0;0;0;0;.00nan;0;0
24858;673;35;0;0;0;0;.00nan;0;0
24858;692;35;75;29;3;26;.897;3900000;0
24858;778;54;57;22;3;19;.864;3900000;0
24858;2848;54;0;0;0;0;.00nan;0;0
24959;430;56;60;48;5;43;.896;3600000;0
24959;534;38;65;17;1;16;.941;3600000;0
24959;1345;38;0;0;0;0;.00nan;0;0
24959;2081;56;0;0;0;0;.00nan;0;0
24871;923;32;100;37;1;36;.973;3600000;0
24871;992;32;0;0;0;0;.00nan;0;0
24871;2846;41;58;23;2;21;.913;3544000;0
24871;4968;41;0;0;0;0;.00nan;0;0
24885;35;59;0;0;0;0;.00nan;0;0
24885;349;59;35;19;4;15;.789;3600000;0
24885;2615;40;0;0;0;0;.00nan;0;0
24885;2954;40;67;46;5;41;.891;3600000;0
24886;281;57;0;0;0;0;.00nan;0;0
24886;427;54;72;26;2;24;.923;3900000;0
24886;815;55;0;0;0;0;.00nan;0;0
24886;1311;55;87;35;2;33;.943;3900000;0
24879;771;34;57;24;3;21;.875;3774000;0
24879;1002;34;0;0;0;0;.00nan;0;0
24879;1911;31;0;0;0;0;.00nan;0;0
24879;2936;31;73;31;2;29;.935;3774000;0
24925;856;48;0;0;0;0;.00nan;0;0
24925;1875;37;0;0;0;0;.00nan;0;0
24925;2591;37;61;29;3;26;.897;3600000;0
24925;2641;48;87;36;2;34;.944;3600000;0
25156;831;44;60;20;2;18;.900;3600000;0
25156;1085;44;0;0;0;0;.00nan;0;0
25156;1279;49;21;22;6;16;.727;2410000;0
25156;2273;49;54;12;1;11;.917;1190000;0
25127;401;47;70;23;2;21;.913;3600000;0
25127;430;56;0;0;0;0;.00nan;0;0
25127;1060;47;0;0;0;0;.00nan;0;0
25127;2081;56;47;28;4;24;.857;3560000;0
24920;335;60;64;36;4;32;.889;3900000;0
24920;2192;60;0;0;0;0;.00nan;0;0
24920;2598;50;0;0;0;0;.00nan;0;0
24920;2751;50;57;33;4;29;.879;3900000;0
24906;706;42;34;29;5;24;.828;3554000;0
24906;1259;53;0;0;0;0;.00nan;0;0
24906;2246;42;0;0;0;0;.00nan;0;0
24906;2538;53;68;30;3;27;.900;3600000;0
24898;593;57;0;0;0;0;.00nan;0;0
24898;673;35;73;41;4;37;.902;3878000;0
24898;692;35;0;0;0;0;.00nan;0;0
24898;907;57;64;34;3;31;.912;3878000;0
24896;778;54;0;0;0;0;.00nan;0;0
24896;2033;51;0;0;0;0;.00nan;0;0
24896;2848;54;64;39;4;35;.897;3578000;0
24896;2940;51;79;27;2;25;.926;3600000;0
24931;346;46;58;36;4;32;.889;3546000;0
24931;1288;58;0;0;0;0;.00nan;0;0
24931;2532;58;78;33;2;31;.939;3600000;0
24931;4916;46;0;0;0;0;.00nan;0;0
24883;281;57;66;38;4;34;.895;3600000;0
24883;427;54;0;0;0;0;.00nan;0;0
24883;534;38;100;24;0;24;1.000;3600000;0
24883;1345;38;0;0;0;0;.00nan;0;0
24939;815;55;79;27;1;26;.963;3600000;0
24939;896;43;0;0;0;0;.00nan;0;0
24939;1311;55;0;0;0;0;.00nan;0;0
24939;1988;43;86;18;0;18;1.000;3600000;0
25027;352;45;55;30;4;26;.867;3600000;0
25027;831;44;0;0;0;0;.00nan;0;0
25027;1085;44;91;29;1;28;.966;3600000;0
25027;1934;45;0;0;0;0;.00nan;0;0
24892;771;34;61;31;3;28;.903;3541000;0
24892;1002;34;0;0;0;0;.00nan;0;0
24892;1875;37;71;29;2;27;.931;3600000;0
24892;2591;37;0;0;0;0;.00nan;0;0
24909;673;35;0;0;0;0;.00nan;0;0
24909;692;35;62;32;4;28;.875;3600000;0
24909;896;43;0;0;0;0;.00nan;0;0
24909;1988;43;50;35;5;30;.857;3600000;0
24984;534;38;74;20;1;19;.950;3600000;0
24984;1345;38;0;0;0;0;.00nan;0;0
24984;2615;40;49;23;3;20;.870;3514000;0
24984;2954;40;0;0;0;0;.00nan;0;0
24867;593;57;91;39;2;37;.949;3600000;0
24867;907;57;0;0;0;0;.00nan;0;0
24867;1458;61;0;0;0;0;.00nan;0;0
24867;1865;61;55;33;4;29;.879;3598000;0
25111;856;48;0;0;0;0;.00nan;0;0
25111;1234;39;89;33;1;32;.970;3600000;0
25111;1901;39;0;0;0;0;.00nan;0;0
25111;2641;48;74;45;4;41;.911;3600000;0
24876;923;32;0;0;0;0;.00nan;0;0
24876;992;32;56;39;5;34;.872;3600000;0
24876;2846;41;78;24;2;22;.917;3600000;0
24876;4968;41;0;0;0;0;.00nan;0;0
24916;35;59;0;0;0;0;.00nan;0;0
24916;349;59;100;45;1;44;.978;3613000;0
24916;1259;53;77;32;2;30;.938;3613000;0
24916;2538;53;0;0;0;0;.00nan;0;0
25000;430;56;58;35;5;30;.857;3600000;0
25000;2081;56;0;0;0;0;.00nan;0;0
25000;2598;50;66;31;4;27;.871;3600000;0
25000;2751;50;0;0;0;0;.00nan;0;0
24875;2033;51;70;30;3;27;.900;3723000;0
24875;2846;41;0;0;0;0;.00nan;0;0
24875;2940;51;0;0;0;0;.00nan;0;0
24875;4968;41;66;37;4;33;.892;3723000;0
24891;35;59;72;37;3;34;.919;3579000;0
24891;349;59;0;0;0;0;.00nan;0;0
24891;1016;33;0;0;0;0;.00nan;0;0
24891;3987;33;60;21;2;19;.905;3600000;0
25290;706;42;59;30;3;27;.900;3600000;0
25290;1875;37;0;0;0;0;.00nan;0;0
25290;2246;42;0;0;0;0;.00nan;0;0
25290;2591;37;74;23;1;22;.957;3600000;0
24960;485;36;30;18;4;14;.778;3613000;0
24960;599;36;0;0;0;0;.00nan;0;0
24960;923;32;75;53;5;48;.906;3604000;0
24960;992;32;0;0;0;0;.00nan;0;0
24934;346;46;44;26;4;22;.846;3600000;0
24934;1288;58;78;40;3;37;.925;3600000;0
24934;2532;58;0;0;0;0;.00nan;0;0
24934;4916;46;0;0;0;0;.00nan;0;0
24927;1279;49;82;30;2;28;.933;3900000;0
24927;1458;61;84;34;2;32;.941;3900000;0
24927;1865;61;0;0;0;0;.00nan;0;0
24927;2273;49;0;0;0;0;.00nan;0;0
24905;778;54;100;39;0;39;1.000;3600000;0
24905;1234;39;0;0;0;0;.00nan;0;0
24905;1901;39;66;30;3;27;.900;3600000;0
24905;2848;54;0;0;0;0;.00nan;0;0
24955;771;34;0;0;0;0;.00nan;0;0
24955;1002;34;76;29;2;27;.931;3554000;0
24955;1911;31;0;0;0;0;.00nan;0;0
24955;2936;31;100;29;0;29;1.000;3600000;0
24935;281;57;70;29;2;27;.931;3600000;0
24935;335;60;70;35;3;32;.914;3568000;0
24935;427;54;0;0;0;0;.00nan;0;0
24935;2192;60;0;0;0;0;.00nan;0;0
24947;896;43;0;0;0;0;.00nan;0;0
24947;1279;49;0;0;0;0;.00nan;0;0
24947;1988;43;58;26;3;23;.885;3600000;0
24947;2273;49;54;35;4;31;.886;3566000;0
25131;401;47;0;0;0;0;.00nan;0;0
25131;485;36;0;0;0;0;.00nan;0;0
25131;599;36;43;33;5;28;.848;3579000;0
25131;1060;47;68;27;3;24;.889;3600000;0
24948;1016;33;73;26;2;24;.923;3600000;0
24948;2033;51;0;0;0;0;.00nan;0;0
24948;2940;51;90;50;3;47;.940;3600000;0
24948;3987;33;0;0;0;0;.00nan;0;0
25009;815;55;0;0;0;0;.00nan;0;0
25009;1311;55;100;27;0;27;1.000;3600000;0
25009;2598;50;0;0;0;0;.00nan;0;0
25009;2751;50;39;33;6;27;.818;3600000;0
24989;335;60;68;22;2;20;.909;3600000;0
24989;346;46;0;0;0;0;.00nan;0;0
24989;2192;60;0;0;0;0;.00nan;0;0
24989;4916;46;58;41;5;36;.878;3600000;0
24936;706;42;45;19;3;16;.842;3574000;0
24936;1458;61;0;0;0;0;.00nan;0;0
24936;1865;61;96;36;1;35;.972;3600000;0
24936;2246;42;0;0;0;0;.00nan;0;0
24981;352;45;79;29;2;27;.931;3566000;0
24981;1911;31;0;0;0;0;.00nan;0;0
24981;1934;45;0;0;0;0;.00nan;0;0
24981;2936;31;90;29;1;28;.966;3600000;0
25129;401;47;0;0;0;0;.00nan;0;0
25129;896;43;62;9;0;9;1.000;1597000;0
25129;1060;47;92;29;1;28;.966;3600000;0
25129;1988;43;20;21;6;15;.714;2003000;0
25135;430;56;47;31;5;26;.839;3600000;0
25135;2081;56;0;0;0;0;.00nan;0;0
25135;2598;50;77;23;2;21;.913;3600000;0
25135;2751;50;0;0;0;0;.00nan;0;0
24957;593;57;47;23;4;19;.826;3600000;0
24957;907;57;0;0;0;0;.00nan;0;0
24957;923;32;0;0;0;0;.00nan;0;0
24957;992;32;99;41;1;40;.976;3600000;0
24954;1458;61;42;32;5;27;.844;3600000;0
24954;1865;61;0;0;0;0;.00nan;0;0
24954;2615;40;60;21;2;19;.905;3600000;0
24954;2954;40;0;0;0;0;.00nan;0;0
24993;1875;37;57;35;5;30;.857;3556000;0
24993;2591;37;0;0;0;0;.00nan;0;0
24993;2846;41;65;25;3;22;.880;3600000;0
24993;4968;41;0;0;0;0;.00nan;0;0
24952;335;60;0;0;0;0;.00nan;0;0
24952;778;54;92;29;1;28;.966;3600000;0
24952;2192;60;52;24;4;20;.833;3600000;0
24952;2848;54;0;0;0;0;.00nan;0;0
25031;485;36;82;31;2;29;.935;3600000;0
25031;599;36;0;0;0;0;.00nan;0;0
25031;1259;53;69;34;3;31;.912;3544000;0
25031;2538;53;0;0;0;0;.00nan;0;0
25017;534;38;89;34;1;33;.971;3600000;0
25017;673;35;0;0;0;0;.00nan;0;0
25017;692;35;87;32;2;30;.938;3549000;0
25017;1345;38;0;0;0;0;.00nan;0;0
24949;1279;49;93;39;2;37;.949;3600000;0
24949;1288;58;47;14;2;12;.857;2759000;0
24949;2273;49;0;0;0;0;.00nan;0;0
24949;2532;58;15;6;4;2;.333;841000;0
24969;35;59;0;0;0;0;.00nan;0;0
24969;349;59;79;40;3;37;.925;3592000;0
24969;593;57;100;28;0;28;1.000;3600000;0
24969;907;57;0;0;0;0;.00nan;0;0
24940;534;38;0;0;0;0;.00nan;0;0
24940;706;42;42;36;6;30;.833;3579000;0
24940;1345;38;47;28;4;24;.857;3600000;0
24940;2246;42;0;0;0;0;.00nan;0;0
24972;771;34;55;24;3;21;.875;3773000;0
24972;923;32;56;28;4;24;.857;3773000;0
24972;992;32;0;0;0;0;.00nan;0;0
24972;1002;34;0;0;0;0;.00nan;0;0
24900;673;35;82;39;3;36;.923;3529000;0
24900;692;35;0;0;0;0;.00nan;0;0
24900;2846;41;0;0;0;0;.00nan;0;0
24900;4968;41;71;24;1;23;.958;3600000;0
24943;1288;58;0;0;0;0;.00nan;0;0
24943;2033;51;40;35;5;30;.857;3900000;0
24943;2532;58;49;33;5;28;.848;3900000;0
24943;2940;51;0;0;0;0;.00nan;0;0
25374;815;55;0;0;0;0;.00nan;0;0
25374;831;44;67;18;1;17;.944;3600000;0
25374;1085;44;0;0;0;0;.00nan;0;0
25374;1311;55;65;31;3;28;.903;3581000;0
25038;346;46;60;23;2;21;.913;3600000;0
25038;352;45;81;48;4;44;.917;3573000;0
25038;1934;45;0;0;0;0;.00nan;0;0
25038;4916;46;0;0;0;0;.00nan;0;0
25016;1016;33;96;21;0;21;1.000;3600000;0
25016;1279;49;0;0;0;0;.00nan;0;0
25016;2273;49;82;31;1;30;.968;3565000;0
25016;3987;33;0;0;0;0;.00nan;0;0
24910;281;57;92;23;0;23;1.000;3600000;0
24910;427;54;0;0;0;0;.00nan;0;0
24910;2615;40;0;0;0;0;.00nan;0;0
24910;2954;40;54;21;3;18;.857;3600000;0
24924;35;59;28;33;7;26;.788;3210000;0
24924;281;57;41;21;4;17;.810;3600000;0
24924;349;59;48;8;1;7;.875;390000;0
24924;427;54;0;0;0;0;.00nan;0;0
24923;1259;53;0;0;0;0;.00nan;0;0
24923;1911;31;92;31;1;30;.968;3600000;0
24923;2538;53;44;21;4;17;.810;3600000;0
24923;6869;31;0;0;0;0;.00nan;0;0
25150;485;36;61;21;2;19;.905;3600000;0
25150;599;36;0;0;0;0;.00nan;0;0
25150;923;32;0;0;0;0;.00nan;0;0
25150;992;32;73;45;4;41;.911;3547000;0
25075;831;44;0;0;0;0;.00nan;0;0
25075;1016;33;49;20;3;17;.850;3600000;0
25075;1085;44;76;39;4;35;.897;3550000;0
25075;3987;33;0;0;0;0;.00nan;0;0
24958;771;34;100;35;0;35;1.000;3600000;0
24958;778;54;98;33;1;32;.970;3577000;0
24958;1002;34;0;0;0;0;.00nan;0;0
24958;2848;54;0;0;0;0;.00nan;0;0
25022;401;47;0;0;0;0;.00nan;0;0
25022;1060;47;41;32;5;27;.844;3560000;0
25022;1279;49;68;31;3;28;.903;3600000;0
25022;2273;49;0;0;0;0;.00nan;0;0
25004;1875;37;98;41;2;39;.951;3560000;0
25004;2591;37;0;0;0;0;.00nan;0;0
25004;2615;40;91;21;0;21;1.000;3600000;0
25004;2954;40;0;0;0;0;.00nan;0;0
25056;352;45;0;0;0;0;.00nan;0;0
25056;1934;45;78;26;1;25;.962;3600000;0
25056;2598;50;58;23;3;20;.870;3530000;0
25056;2751;50;0;0;0;0;.00nan;0;0
24964;346;46;0;0;0;0;.00nan;0;0
24964;2033;51;0;0;0;0;.00nan;0;0
24964;2940;51;100;46;2;44;.957;3900000;0
24964;4916;46;68;28;2;26;.929;3900000;0
24970;593;57;48;33;6;27;.818;2960000;0
24970;907;57;63;8;0;8;1.000;640000;0
24970;1234;39;80;22;1;21;.955;3600000;0
24970;1901;39;0;0;0;0;.00nan;0;0
24966;856;48;0;0;0;0;.00nan;0;0
24966;1458;61;0;0;0;0;.00nan;0;0
24966;1865;61;86;34;2;32;.941;3585000;0
24966;2641;48;100;42;1;41;.976;3600000;0
24986;673;35;0;0;0;0;.00nan;0;0
24986;692;35;95;48;4;44;.917;3900000;0
24986;896;43;0;0;0;0;.00nan;0;0
24986;1988;43;71;39;4;35;.897;3900000;0
24983;534;38;67;23;2;21;.913;3600000;0
24983;1345;38;0;0;0;0;.00nan;0;0
24983;1911;31;0;0;0;0;.00nan;0;0
24983;6869;31;59;38;4;34;.895;3523000;0
25505;346;46;100;30;0;30;1.000;3600000;0
25505;1875;37;0;0;0;0;.00nan;0;0
25505;2591;37;89;46;3;43;.935;3600000;0
25505;4916;46;0;0;0;0;.00nan;0;0
24974;35;59;0;0;0;0;.00nan;0;0
24974;349;59;62;25;2;23;.920;3600000;0
24974;706;42;63;41;5;36;.878;3600000;0
24974;2246;42;0;0;0;0;.00nan;0;0
25077;335;60;58;38;5;33;.868;3900000;0
25077;1259;53;84;54;5;49;.907;3900000;0
25077;2192;60;0;0;0;0;.00nan;0;0
25077;2538;53;0;0;0;0;.00nan;0;0
24938;430;56;67;25;2;23;.920;3600000;0
24938;778;54;0;0;0;0;.00nan;0;0
24938;2081;56;0;0;0;0;.00nan;0;0
24938;2848;54;75;42;4;38;.905;3600000;0
24961;1234;39;76;21;1;20;.952;3600000;0
24961;1901;39;0;0;0;0;.00nan;0;0
24961;2033;51;70;52;5;47;.904;3600000;0
24961;2940;51;0;0;0;0;.00nan;0;0
25011;485;36;0;0;0;0;.00nan;0;0
25011;599;36;66;30;3;27;.900;3629000;0
25011;771;34;69;24;2;22;.917;3645000;0
25011;1002;34;0;0;0;0;.00nan;0;0
24951;281;57;29;26;6;20;.769;2415000;0
24951;352;45;62;33;4;29;.879;3600000;0
24951;427;54;67;14;0;14;1.000;1166000;0
24951;1934;45;0;0;0;0;.00nan;0;0
24973;831;44;0;0;0;0;.00nan;0;0
24973;1085;44;47;15;2;13;.867;3600000;0
24973;1458;61;0;0;0;0;.00nan;0;0
24973;1865;61;47;31;5;26;.839;3600000;0
25026;401;47;0;0;0;0;.00nan;0;0
25026;1016;33;0;0;0;0;.00nan;0;0
25026;1060;47;80;36;3;33;.917;3900000;0
25026;3987;33;53;26;3;23;.885;3900000;0
24963;856;48;0;0;0;0;.00nan;0;0
24963;1288;58;81;30;2;28;.933;3600000;0
24963;2532;58;0;0;0;0;.00nan;0;0
24963;2641;48;72;41;4;37;.902;3583000;0
24996;706;42;0;0;0;0;.00nan;0;0
24996;2246;42;79;35;3;32;.914;3885000;0
24996;2846;41;81;32;2;30;.938;3885000;0
24996;4968;41;0;0;0;0;.00nan;0;0
24992;593;57;64;16;2;14;.875;3600000;0
24992;815;55;0;0;0;0;.00nan;0;0
24992;907;57;0;0;0;0;.00nan;0;0
24992;1311;55;73;41;5;36;.878;3600000;0
25067;430;56;58;34;4;30;.882;3529000;0
25067;673;35;0;0;0;0;.00nan;0;0
25067;692;35;83;32;2;30;.938;3600000;0
25067;2081;56;0;0;0;0;.00nan;0;0
25106;856;48;57;24;3;21;.875;3558000;0
25106;896;43;0;0;0;0;.00nan;0;0
25106;1988;43;99;58;1;57;.983;3600000;0
25106;2641;48;0;0;0;0;.00nan;0;0
25041;1911;31;94;40;3;37;.925;3900000;0
25041;2598;50;57;20;3;17;.850;3900000;0
25041;2751;50;0;0;0;0;.00nan;0;0
25041;6869;31;0;0;0;0;.00nan;0;0
25051;352;45;76;38;4;34;.895;3833000;0
25051;1234;39;67;24;3;21;.875;3833000;0
25051;1901;39;0;0;0;0;.00nan;0;0
25051;1934;45;0;0;0;0;.00nan;0;0
25138;346;46;44;29;5;24;.828;3600000;0
25138;778;54;37;33;6;27;.818;3154000;0
25138;2848;54;49;1;0;1;1.000;406000;0
25138;4916;46;0;0;0;0;.00nan;0;0
25033;534;38;57;29;4;25;.862;3900000;0
25033;1345;38;0;0;0;0;.00nan;0;0
25033;1875;37;77;28;4;24;.857;3900000;0
25033;2591;37;0;0;0;0;.00nan;0;0
24976;1234;39;0;0;0;0;.00nan;0;0
24976;1458;61;0;0;0;0;.00nan;0;0
24976;1865;61;56;31;4;27;.871;3543000;0
24976;1901;39;44;19;3;16;.842;3600000;0
24999;35;59;0;0;0;0;.00nan;0;0
24999;349;59;88;30;1;29;.967;3600000;0
24999;2615;40;61;27;3;24;.889;3550000;0
24999;2954;40;0;0;0;0;.00nan;0;0
25119;771;34;61;35;4;31;.886;3900000;0
25119;896;43;91;49;4;45;.918;3900000;0
25119;1002;34;0;0;0;0;.00nan;0;0
25119;1988;43;0;0;0;0;.00nan;0;0
25467;335;60;88;29;1;28;.966;3600000;0
25467;1016;33;68;21;2;19;.905;3562000;0
25467;2192;60;0;0;0;0;.00nan;0;0
25467;3987;33;0;0;0;0;.00nan;0;0
25401;352;45;0;0;0;0;.00nan;0;0
25401;485;36;74;7;0;7;1.000;3600000;0
25401;599;36;0;0;0;0;.00nan;0;0
25401;1934;45;61;40;4;36;.900;3600000;0
25012;706;42;96;24;0;24;1.000;3600000;0
25012;815;55;0;0;0;0;.00nan;0;0
25012;1311;55;70;31;3;28;.903;3600000;0
25012;2246;42;0;0;0;0;.00nan;0;0
24978;593;57;68;22;2;20;.909;3600000;0
24978;907;57;0;0;0;0;.00nan;0;0
24978;2846;41;55;32;4;28;.875;3600000;0
24978;4968;41;0;0;0;0;.00nan;0;0
25037;401;47;0;0;0;0;.00nan;0;0
25037;673;35;84;41;3;38;.927;3585000;0
25037;692;35;0;0;0;0;.00nan;0;0
25037;1060;47;80;25;1;24;.960;3600000;0
25249;831;44;47;34;5;29;.853;3563000;0
25249;1085;44;0;0;0;0;.00nan;0;0
25249;1279;49;53;25;3;22;.880;3600000;0
25249;2273;49;0;0;0;0;.00nan;0;0
25015;281;57;50;15;2;13;.867;3600000;0
25015;427;54;0;0;0;0;.00nan;0;0
25015;2033;51;73;34;3;31;.912;3600000;0
25015;2940;51;0;0;0;0;.00nan;0;0
25204;1288;58;50;22;4;18;.818;3513000;0
25204;1911;31;0;0;0;0;.00nan;0;0
25204;2532;58;0;0;0;0;.00nan;0;0
25204;6869;31;92;36;2;34;.944;3600000;0
25353;1259;53;0;0;0;0;.00nan;0;0
25353;2538;53;73;22;1;21;.955;3600000;0
25353;2598;50;0;0;0;0;.00nan;0;0
25353;2751;50;76;34;3;31;.912;3563000;0
25117;1458;61;47;21;3;18;.857;3575000;0
25117;1865;61;0;0;0;0;.00nan;0;0
25117;2846;41;87;27;1;26;.963;3600000;0
25117;4968;41;0;0;0;0;.00nan;0;0
25276;856;48;0;0;0;0;.00nan;0;0
25276;1911;31;67;33;3;30;.909;3872000;0
25276;2641;48;70;26;2;24;.923;3872000;0
25276;2936;31;0;0;0;0;.00nan;0;0
24985;281;57;41;30;5;25;.833;3600000;0
24985;427;54;0;0;0;0;.00nan;0;0
24985;1259;53;97;39;1;38;.974;3600000;0
24985;2538;53;0;0;0;0;.00nan;0;0
24967;1279;49;86;30;1;29;.967;3600000;0
24967;2273;49;0;0;0;0;.00nan;0;0
24967;2940;51;56;39;6;33;.846;3600000;0
24967;6851;51;0;0;0;0;.00nan;0;0
24962;346;46;0;0;0;0;.00nan;0;0
24962;771;34;94;45;1;44;.978;3734000;0
24962;1002;34;0;0;0;0;.00nan;0;0
24962;4916;46;100;32;0;32;1.000;3734000;0
25001;778;54;88;35;2;33;.943;3600000;0
25001;815;55;76;21;1;20;.952;3600000;0
25001;1311;55;0;0;0;0;.00nan;0;0
25001;2848;54;0;0;0;0;.00nan;0;0
24997;896;43;0;0;0;0;.00nan;0;0
24997;1234;39;93;33;1;32;.970;3600000;0
24997;1901;39;0;0;0;0;.00nan;0;0
24997;1988;43;49;26;4;22;.846;3600000;0
24982;1288;58;98;42;1;41;.976;3900000;0
24982;2532;58;0;0;0;0;.00nan;0;0
24982;2598;50;100;29;1;28;.966;3900000;0
24982;2751;50;0;0;0;0;.00nan;0;0
25072;831;44;0;0;0;0;.00nan;0;0
25072;1085;44;82;22;1;21;.955;3568000;0
25072;2615;40;100;35;0;35;1.000;3600000;0
25072;2954;40;0;0;0;0;.00nan;0;0
25021;534;38;100;48;1;47;.979;3600000;0
25021;1016;33;90;38;2;36;.947;3543000;0
25021;1345;38;0;0;0;0;.00nan;0;0
25021;3987;33;0;0;0;0;.00nan;0;0
24979;35;59;0;0;0;0;.00nan;0;0
24979;349;59;81;45;3;42;.933;3900000;0
24979;485;36;51;24;3;21;.875;3900000;0
24979;599;36;0;0;0;0;.00nan;0;0
25143;430;56;100;32;0;32;1.000;3600000;0
25143;923;32;77;31;2;29;.935;3566000;0
25143;992;32;0;0;0;0;.00nan;0;0
25143;2081;56;0;0;0;0;.00nan;0;0
24987;593;57;70;30;3;27;.900;3600000;0
24987;907;57;0;0;0;0;.00nan;0;0
24987;1259;53;0;0;0;0;.00nan;0;0
24987;2538;53;28;25;5;20;.800;3561000;0
25107;815;55;0;0;0;0;.00nan;0;0
25107;1311;55;63;21;2;19;.905;3600000;0
25107;2615;40;83;32;1;31;.969;3600000;0
25107;2954;40;0;0;0;0;.00nan;0;0
25044;335;60;67;18;1;17;.944;3600000;0
25044;771;34;83;48;5;43;.896;3600000;0
25044;1002;34;0;0;0;0;.00nan;0;0
25044;2192;60;0;0;0;0;.00nan;0;0
25232;401;47;0;0;0;0;.00nan;0;0
25232;1060;47;70;29;3;26;.897;3900000;0
25232;2598;50;0;0;0;0;.00nan;0;0
25232;2751;50;70;33;3;30;.909;3900000;0
25559;831;44;65;26;2;24;.923;3600000;0
25559;1085;44;0;0;0;0;.00nan;0;0
25559;1875;37;58;28;4;24;.857;3516000;0
25559;2591;37;0;0;0;0;.00nan;0;0
25091;673;35;0;0;0;0;.00nan;0;0
25091;692;35;39;20;4;16;.800;3873000;0
25091;923;32;0;0;0;0;.00nan;0;0
25091;992;32;74;47;5;42;.894;3873000;0
24968;281;57;0;0;0;0;.00nan;0;0
24968;427;54;81;26;1;25;.962;3600000;0
24968;1016;33;0;0;0;0;.00nan;0;0
24968;3987;33;52;31;4;27;.871;3600000;0
25023;706;42;54;29;4;25;.862;3547000;0
25023;778;54;0;0;0;0;.00nan;0;0
25023;2246;42;0;0;0;0;.00nan;0;0
25023;2848;54;59;27;3;24;.889;3600000;0
25222;430;56;66;48;6;42;.875;3452000;0
25222;1911;31;0;0;0;0;.00nan;0;0
25222;2081;56;52;2;0;2;1.000;148000;0
25222;2936;31;79;28;3;25;.893;3600000;0
25005;352;45;57;29;4;25;.862;3590000;0
25005;1934;45;0;0;0;0;.00nan;0;0
25005;2846;41;0;0;0;0;.00nan;0;0
25005;4968;41;82;32;2;30;.938;3600000;0
24977;35;59;0;0;0;0;.00nan;0;0
24977;349;59;59;21;2;19;.905;3600000;0
24977;673;35;49;42;6;36;.857;3600000;0
24977;692;35;0;0;0;0;.00nan;0;0
25007;1234;39;76;18;1;17;.944;3600000;0
25007;1458;61;0;0;0;0;.00nan;0;0
25007;1865;61;72;46;5;41;.891;3600000;0
25007;1901;39;0;0;0;0;.00nan;0;0
25002;706;42;0;0;0;0;.00nan;0;0
25002;1279;49;100;27;0;27;1.000;3600000;0
25002;2246;42;67;32;3;29;.906;3600000;0
25002;2273;49;0;0;0;0;.00nan;0;0
25128;346;46;0;0;0;0;.00nan;0;0
25128;401;47;88;28;1;27;.964;3600000;0
25128;1060;47;0;0;0;0;.00nan;0;0
25128;4916;46;78;35;2;33;.943;3564000;0
25089;352;45;0;0;0;0;.00nan;0;0
25089;896;43;60;29;4;25;.862;3600000;0
25089;1934;45;48;37;6;31;.838;3600000;0
25089;1988;43;0;0;0;0;.00nan;0;0
24980;856;48;0;0;0;0;.00nan;0;0
24980;2641;48;48;29;4;25;.862;3565000;0
24980;2940;51;81;37;3;34;.919;3600000;0
24980;6851;51;0;0;0;0;.00nan;0;0
25014;485;36;64;16;1;15;.938;3600000;0
25014;599;36;0;0;0;0;.00nan;0;0
25014;1288;58;72;54;6;48;.889;3600000;0
25014;2532;58;0;0;0;0;.00nan;0;0
25036;335;60;0;0;0;0;.00nan;0;0
25036;534;38;89;41;3;38;.927;3900000;0
25036;1345;38;0;0;0;0;.00nan;0;0
25036;2192;60;82;39;3;36;.923;3900000;0
25042;1259;53;78;23;1;22;.957;3600000;0
25042;1279;49;45;31;5;26;.839;3600000;0
25042;2273;49;0;0;0;0;.00nan;0;0
25042;2538;53;0;0;0;0;.00nan;0;0
25018;0;48;0;0;0;0;.00nan;0;0
25018;771;34;0;0;0;0;.00nan;0;0
25018;856;48;55;30;4;26;.867;3600000;0
25018;1002;34;100;30;0;30;1.000;3600000;0
25100;593;57;72;34;3;31;.912;3900000;0
25100;896;43;0;0;0;0;.00nan;0;0
25100;907;57;0;0;0;0;.00nan;0;0
25100;1988;43;92;40;3;37;.925;3900000;0
25078;281;57;83;15;0;15;1.000;3600000;0
25078;427;54;0;0;0;0;.00nan;0;0
25078;923;32;63;48;5;43;.896;3600000;0
25078;992;32;0;0;0;0;.00nan;0;0
25114;1016;33;73;21;1;20;.952;3600000;0
25114;2598;50;62;42;4;38;.905;3600000;0
25114;2751;50;0;0;0;0;.00nan;0;0
25114;3987;33;0;0;0;0;.00nan;0;0
25034;778;54;67;29;3;26;.897;3600000;0
25034;1288;58;0;0;0;0;.00nan;0;0
25034;2532;58;63;40;5;35;.875;3541000;0
25034;2848;54;0;0;0;0;.00nan;0;0
25172;815;55;98;41;1;40;.976;3600000;0
25172;831;44;0;0;0;0;.00nan;0;0
25172;1085;44;37;26;5;21;.808;3600000;0
25172;1311;55;0;0;0;0;.00nan;0;0
24998;430;56;49;17;3;14;.824;3600000;0
24998;2081;56;0;0;0;0;.00nan;0;0
24998;2846;41;37;19;4;15;.789;3573000;0
24998;4968;41;0;0;0;0;.00nan;0;0
25196;1016;33;0;0;0;0;.00nan;0;0
25196;1875;37;49;27;4;23;.852;3778000;0
25196;2591;37;0;0;0;0;.00nan;0;0
25196;3987;33;70;31;3;28;.903;3778000;0
24991;35;59;0;0;0;0;.00nan;0;0
24991;346;46;48;33;5;28;.848;3600000;0
24991;349;59;86;35;2;33;.943;3600000;0
24991;4916;46;0;0;0;0;.00nan;0;0
25030;401;47;0;0;0;0;.00nan;0;0
25030;706;42;50;28;4;24;.857;3570000;0
25030;1060;47;76;33;3;30;.909;3600000;0
25030;2246;42;0;0;0;0;.00nan;0;0
25057;352;45;84;30;2;28;.933;3900000;0
25057;1934;45;0;0;0;0;.00nan;0;0
25057;2615;40;51;18;2;16;.889;3900000;0
25057;2954;40;0;0;0;0;.00nan;0;0
25070;281;57;71;26;2;24;.923;3564000;0
25070;427;54;0;0;0;0;.00nan;0;0
25070;430;56;0;0;0;0;.00nan;0;0
25070;2081;56;83;28;1;27;.964;3600000;0
25039;534;38;51;30;5;25;.833;3600000;0
25039;1234;39;29;28;6;22;.786;2772000;0
25039;1345;38;0;0;0;0;.00nan;0;0
25039;1901;39;54;9;1;8;.889;798000;0
25587;335;60;65;15;1;14;.933;3600000;0
25587;1911;31;83;50;4;46;.920;3600000;0
25587;2192;60;0;0;0;0;.00nan;0;0
25587;2936;31;0;0;0;0;.00nan;0;0
25008;593;57;0;0;0;0;.00nan;0;0
25008;815;55;0;0;0;0;.00nan;0;0
25008;907;57;83;25;1;24;.960;3600000;0
25008;1311;55;73;39;4;35;.897;3600000;0
24975;673;35;0;0;0;0;.00nan;0;0
24975;692;35;81;24;1;23;.958;3600000;0
24975;2940;51;65;38;4;34;.895;3600000;0
24975;6851;51;0;0;0;0;.00nan;0;0
25043;534;38;0;0;0;0;.00nan;0;0
25043;923;32;66;40;4;36;.900;3600000;0
25043;992;32;0;0;0;0;.00nan;0;0
25043;1345;38;76;24;1;23;.958;3600000;0
25140;346;46;0;0;0;0;.00nan;0;0
25140;2846;41;53;36;4;32;.889;3539000;0
25140;4916;46;73;25;2;23;.920;3600000;0
25140;4968;41;0;0;0;0;.00nan;0;0
25085;1288;58;53;31;4;27;.871;3600000;0
25085;2532;58;0;0;0;0;.00nan;0;0
25085;2598;50;57;25;3;22;.880;3600000;0
25085;2751;50;0;0;0;0;.00nan;0;0
25149;771;34;50;1;0;1;1.000;203000;0
25149;831;44;0;0;0;0;.00nan;0;0
25149;1002;34;44;35;6;29;.829;3397000;0
25149;1085;44;90;32;1;31;.969;3600000;0
25069;281;57;49;35;4;31;.886;3548000;0
25069;335;60;56;20;3;17;.850;3600000;0
25069;427;54;0;0;0;0;.00nan;0;0
25069;2192;60;0;0;0;0;.00nan;0;0
25029;401;47;0;0;0;0;.00nan;0;0
25029;1060;47;72;40;4;36;.900;3600000;0
25029;1259;53;78;25;1;24;.960;3600000;0
25029;2538;53;0;0;0;0;.00nan;0;0
25032;673;35;0;0;0;0;.00nan;0;0
25032;692;35;53;33;5;28;.848;3544000;0
25032;778;54;53;30;4;26;.867;3600000;0
25032;2848;54;0;0;0;0;.00nan;0;0
25090;0;48;57;27;4;23;.852;3564000;0
25090;856;48;0;0;0;0;.00nan;0;0
25090;2615;40;64;27;2;25;.926;3600000;0
25090;2954;40;0;0;0;0;.00nan;0;0
25061;430;56;81;33;2;31;.939;3600000;0
25061;1279;49;71;28;3;25;.893;3561000;0
25061;2081;56;0;0;0;0;.00nan;0;0
25061;2273;49;0;0;0;0;.00nan;0;0
25063;923;32;34;14;3;11;.786;1308000;0
25063;992;32;37;24;4;20;.833;2292000;0
25063;1234;39;0;0;0;0;.00nan;0;0
25063;1901;39;100;27;0;27;1.000;3600000;0
25028;706;42;92;38;2;36;.947;3900000;0
25028;1458;61;0;0;0;0;.00nan;0;0
25028;1865;61;90;36;2;34;.944;3900000;0
25028;2246;42;0;0;0;0;.00nan;0;0
25049;485;36;71;23;2;21;.913;3600000;0
25049;599;36;0;0;0;0;.00nan;0;0
25049;2940;51;0;0;0;0;.00nan;0;0
25049;6851;51;65;33;3;30;.909;3600000;0
25003;35;59;0;0;0;0;.00nan;0;0
25003;349;59;59;36;5;31;.861;3900000;0
25003;896;43;0;0;0;0;.00nan;0;0
25003;1988;43;29;24;5;19;.792;3900000;0
25112;771;34;41;36;6;30;.833;3559000;0
25112;1002;34;0;0;0;0;.00nan;0;0
25112;1911;31;0;0;0;0;.00nan;0;0
25112;2936;31;55;35;4;31;.886;3600000;0
25040;706;42;0;0;0;0;.00nan;0;0
25040;2246;42;70;31;3;28;.903;3561000;0
25040;2846;41;98;35;1;34;.971;3600000;0
25040;4968;41;0;0;0;0;.00nan;0;0
25086;831;44;68;28;3;25;.893;3557000;0
25086;1085;44;0;0;0;0;.00nan;0;0
25086;1288;58;69;23;2;21;.913;3600000;0
25086;2532;58;0;0;0;0;.00nan;0;0
25059;593;57;88;30;2;28;.933;3558000;0
25059;907;57;0;0;0;0;.00nan;0;0
25059;1259;53;0;0;0;0;.00nan;0;0
25059;2538;53;100;33;0;33;1.000;3600000;0
25337;1016;33;0;0;0;0;.00nan;0;0
25337;1875;37;0;0;0;0;.00nan;0;0
25337;2591;37;100;26;0;26;1.000;3600000;0
25337;3987;33;98;41;3;38;.927;3600000;0
25068;0;48;0;0;0;0;.00nan;0;0
25068;856;48;64;32;3;29;.906;3600000;0
25068;1279;49;0;0;0;0;.00nan;0;0
25068;2273;49;91;22;0;22;1.000;3600000;0
25050;485;36;0;0;0;0;.00nan;0;0
25050;599;36;51;15;2;13;.867;3560000;0
25050;778;54;0;0;0;0;.00nan;0;0
25050;2848;54;77;26;1;25;.962;3600000;0
25189;335;60;0;0;0;0;.00nan;0;0
25189;2192;60;71;26;3;23;.885;3600000;0
25189;2598;50;0;0;0;0;.00nan;0;0
25189;2751;50;84;36;2;34;.944;3600000;0
25087;673;35;79;37;2;35;.946;3600000;0
25087;692;35;0;0;0;0;.00nan;0;0
25087;2615;40;0;0;0;0;.00nan;0;0
25087;2954;40;81;25;1;24;.960;3600000;0
25058;401;47;81;34;2;32;.941;3600000;0
25058;1060;47;0;0;0;0;.00nan;0;0
25058;1458;61;53;24;3;21;.875;3600000;0
25058;1865;61;0;0;0;0;.00nan;0;0
25502;35;59;0;0;0;0;.00nan;0;0
25502;349;59;57;21;3;18;.857;3600000;0
25502;815;55;0;0;0;0;.00nan;0;0
25502;1311;55;83;42;4;38;.905;3600000;0
25065;352;45;74;24;1;23;.958;3600000;0
25065;1934;45;0;0;0;0;.00nan;0;0
25065;2940;51;57;38;5;33;.868;3600000;0
25065;6851;51;0;0;0;0;.00nan;0;0
25099;1234;39;0;0;0;0;.00nan;0;0
25099;1901;39;38;16;3;13;.813;3600000;0
25099;1911;31;90;50;4;46;.920;3600000;0
25099;2936;31;0;0;0;0;.00nan;0;0
25109;352;45;0;0;0;0;.00nan;0;0
25109;485;36;63;26;3;23;.885;3543000;0
25109;599;36;0;0;0;0;.00nan;0;0
25109;1934;45;98;37;1;36;.973;3600000;0
25230;896;43;100;26;0;26;1.000;3600000;0
25230;1458;61;0;0;0;0;.00nan;0;0
25230;1865;61;74;30;2;28;.933;3594000;0
25230;1988;43;0;0;0;0;.00nan;0;0
25104;346;46;100;43;2;41;.953;3900000;0
25104;534;38;78;30;2;28;.933;3900000;0
25104;1345;38;0;0;0;0;.00nan;0;0
25104;4916;46;0;0;0;0;.00nan;0;0
25024;35;59;97;48;2;46;.958;3586000;0
25024;349;59;0;0;0;0;.00nan;0;0
25024;1875;37;0;0;0;0;.00nan;0;0
25024;2591;37;67;18;1;17;.944;3600000;0
25142;815;55;0;0;0;0;.00nan;0;0
25142;1311;55;66;44;5;39;.886;3566000;0
25142;2846;41;50;23;4;19;.826;3600000;0
25142;4968;41;0;0;0;0;.00nan;0;0
25046;430;56;57;23;3;20;.870;3600000;0
25046;668;56;0;0;0;0;.00nan;0;0
25046;706;42;48;30;5;25;.833;3520000;0
25046;2246;42;0;0;0;0;.00nan;0;0
25122;593;57;84;28;1;27;.964;3600000;0
25122;896;43;89;36;2;34;.944;3600000;0
25122;907;57;0;0;0;0;.00nan;0;0
25122;1988;43;0;0;0;0;.00nan;0;0
25071;778;54;69;30;3;27;.900;3717000;0
25071;923;32;0;0;0;0;.00nan;0;0
25071;992;32;76;28;2;26;.929;3717000;0
25071;2848;54;0;0;0;0;.00nan;0;0
25110;485;36;0;0;0;0;.00nan;0;0
25110;599;36;52;30;5;25;.833;3526000;0
25110;1016;33;0;0;0;0;.00nan;0;0
25110;3987;33;69;32;3;29;.906;3600000;0
25095;401;47;0;0;0;0;.00nan;0;0
25095;1060;47;63;21;2;19;.905;3600000;0
25095;2940;51;0;0;0;0;.00nan;0;0
25095;6851;51;58;42;5;37;.881;3600000;0
25093;281;57;92;40;2;38;.950;3560000;0
25093;427;54;0;0;0;0;.00nan;0;0
25093;1911;31;0;0;0;0;.00nan;0;0
25093;2936;31;85;29;1;28;.966;3600000;0
25105;1234;39;60;19;2;17;.895;3600000;0
25105;1901;39;0;0;0;0;.00nan;0;0
25105;2598;50;22;29;6;23;.793;2088000;0
25105;2751;50;65;23;2;21;.913;1512000;0
25275;335;60;100;25;0;25;1.000;3600000;0
25275;1458;61;38;30;5;25;.833;2254000;0
25275;1865;61;65;12;1;11;.917;1346000;0
25275;2192;60;0;0;0;0;.00nan;0;0
25407;1279;49;0;0;0;0;.00nan;0;0
25407;1875;37;68;30;3;27;.900;3543000;0
25407;2273;49;89;36;2;34;.944;3600000;0
25407;2591;37;0;0;0;0;.00nan;0;0
25080;771;34;68;28;3;25;.893;3600000;0
25080;1002;34;0;0;0;0;.00nan;0;0
25080;1259;53;0;0;0;0;.00nan;0;0
25080;2538;53;66;39;4;35;.897;3561000;0
25247;335;60;58;25;3;22;.880;3600000;0
25247;2192;60;0;0;0;0;.00nan;0;0
25247;2615;40;100;30;0;30;1.000;3600000;0
25247;2954;40;0;0;0;0;.00nan;0;0
25035;35;59;0;0;0;0;.00nan;0;0
25035;349;59;77;40;3;37;.925;3600000;0
25035;534;38;1;24;8;16;.667;3600000;0
25035;1345;38;0;0;0;0;.00nan;0;0
25066;346;46;0;0;0;0;.00nan;0;0
25066;778;54;0;0;0;0;.00nan;0;0
25066;2848;54;75;35;3;32;.914;3719000;0
25066;4916;46;70;27;2;25;.926;3719000;0
25088;673;35;0;0;0;0;.00nan;0;0
25088;692;35;100;23;0;23;1.000;3600000;0
25088;2598;50;0;0;0;0;.00nan;0;0
25088;5398;50;66;34;3;31;.912;3600000;0
25045;352;45;67;28;3;25;.893;3565000;0
25045;706;42;0;0;0;0;.00nan;0;0
25045;1934;45;0;0;0;0;.00nan;0;0
25045;2246;42;71;28;2;26;.929;3600000;0
25097;815;55;58;22;3;19;.864;3600000;0
25097;1288;58;58;36;4;32;.889;3591000;0
25097;1311;55;0;0;0;0;.00nan;0;0
25097;2532;58;0;0;0;0;.00nan;0;0
25137;0;48;43;28;5;23;.821;2199000;0
25137;856;48;69;15;0;15;1.000;1362000;0
25137;1016;33;60;31;3;28;.903;3600000;0
25137;3987;33;0;0;0;0;.00nan;0;0
25102;923;32;0;0;0;0;.00nan;0;0
25102;992;32;55;43;6;37;.860;3600000;0
25102;1279;49;65;22;2;20;.909;3600000;0
25102;2273;49;0;0;0;0;.00nan;0;0
25133;593;57;0;0;0;0;.00nan;0;0
25133;907;57;100;29;0;29;1.000;3600000;0
25133;2846;41;63;15;1;14;.933;1325000;0
25133;4968;41;40;27;5;22;.815;2275000;0
25083;281;57;45;49;7;42;.857;3413000;0
25083;427;54;48;0;0;0;.00nan;187000;0
25083;534;38;0;0;0;0;.00nan;0;0
25083;1345;38;74;22;1;21;.955;3600000;0
25060;401;47;0;0;0;0;.00nan;0;0
25060;1060;47;51;19;3;16;.842;3590000;0
25060;2033;51;0;0;0;0;.00nan;0;0
25060;2940;51;81;35;2;33;.943;3600000;0
25356;485;36;72;20;1;19;.950;3600000;0
25356;599;36;0;0;0;0;.00nan;0;0
25356;1911;31;40;26;4;22;.846;1976000;0
25356;2936;31;70;17;1;16;.941;1624000;0
25120;1259;53;58;13;1;12;.923;3600000;0
25120;2033;51;28;8;3;5;.625;591000;0
25120;2538;53;0;0;0;0;.00nan;0;0
25120;2940;51;88;44;3;41;.932;3009000;0
25216;346;46;0;0;0;0;.00nan;0;0
25216;1458;61;0;0;0;0;.00nan;0;0
25216;1865;61;93;37;2;35;.946;3582000;0
25216;4916;46;91;29;1;28;.966;3600000;0
25052;35;59;39;1;1;0;.000;198000;0
25052;349;59;41;33;6;27;.818;3402000;0
25052;771;34;99;45;2;43;.956;3600000;0
25052;1002;34;0;0;0;0;.00nan;0;0
25168;0;48;74;29;3;26;.897;3600000;0
25168;831;44;0;0;0;0;.00nan;0;0
25168;856;48;0;0;0;0;.00nan;0;0
25168;1085;44;46;24;4;20;.833;3548000;0
25094;430;56;69;27;3;24;.889;3600000;0
25094;668;56;0;0;0;0;.00nan;0;0
25094;1016;33;0;0;0;0;.00nan;0;0
25094;3987;33;96;21;0;21;1.000;3600000;0
25115;401;47;79;31;1;30;.968;3874000;0
25115;673;35;0;0;0;0;.00nan;0;0
25115;692;35;94;43;2;41;.953;3874000;0
25115;1060;47;0;0;0;0;.00nan;0;0
25121;778;54;50;31;6;25;.806;2700000;0
25121;2615;40;33;25;5;20;.800;2292000;0
25121;2848;54;51;8;1;7;.875;888000;0
25121;2954;40;70;9;0;9;1.000;1308000;0
25163;593;57;0;0;0;0;.00nan;0;0
25163;896;43;0;0;0;0;.00nan;0;0
25163;907;57;97;41;3;38;.927;3792000;0
25163;1988;43;43;24;4;20;.833;3792000;0
25151;352;45;100;50;3;47;.940;3600000;0
25151;1234;39;37;20;4;16;.800;3577000;0
25151;1901;39;0;0;0;0;.00nan;0;0
25151;1934;45;0;0;0;0;.00nan;0;0
25174;0;48;51;2;0;2;1.000;241000;0
25174;485;36;71;31;3;28;.903;3600000;0
25174;599;36;0;0;0;0;.00nan;0;0
25174;856;48;50;40;6;34;.850;3359000;0
25177;1259;53;0;0;0;0;.00nan;0;0
25177;1911;31;0;0;0;0;.00nan;0;0
25177;2538;53;72;22;1;21;.955;3600000;0
25177;2936;31;63;37;4;33;.892;3600000;0
25136;923;32;0;0;0;0;.00nan;0;0
25136;992;32;86;40;2;38;.950;3600000;0
25136;1234;39;0;0;0;0;.00nan;0;0
25136;1901;39;33;22;4;18;.818;3524000;0
25256;335;60;64;17;2;15;.882;3600000;0
25256;2192;60;0;0;0;0;.00nan;0;0
25256;2615;40;47;41;7;34;.829;3412000;0
25256;2954;40;44;4;1;3;.750;188000;0
25314;1458;61;60;28;4;24;.857;3578000;0
25314;1865;61;0;0;0;0;.00nan;0;0
25314;2598;50;0;0;0;0;.00nan;0;0
25314;5398;50;65;24;3;21;.875;3600000;0
25236;346;46;72;25;2;23;.920;3600000;0
25236;831;44;60;31;3;28;.903;3585000;0
25236;1085;44;0;0;0;0;.00nan;0;0
25236;4916;46;0;0;0;0;.00nan;0;0
25074;706;42;81;30;2;28;.933;3519000;0
25074;1288;58;100;32;0;32;1.000;3600000;0
25074;2246;42;0;0;0;0;.00nan;0;0
25074;2532;58;0;0;0;0;.00nan;0;0
25126;352;45;100;33;0;33;1.000;3600000;0
25126;430;56;90;40;2;38;.950;3517000;0
25126;1934;45;0;0;0;0;.00nan;0;0
25126;2081;56;0;0;0;0;.00nan;0;0
25108;673;35;0;0;0;0;.00nan;0;0
25108;692;35;40;27;5;22;.815;3564000;0
25108;815;55;0;0;0;0;.00nan;0;0
25108;1311;55;45;29;4;25;.862;3600000;0
25055;534;38;49;21;3;18;.857;3600000;0
25055;1345;38;0;0;0;0;.00nan;0;0
25055;2846;41;84;34;1;33;.971;3600000;0
25055;4968;41;0;0;0;0;.00nan;0;0
25053;35;59;0;0;0;0;.00nan;0;0
25053;349;59;66;35;4;31;.886;3587000;0
25053;1288;58;63;22;3;19;.864;3600000;0
25053;2532;58;0;0;0;0;.00nan;0;0
25440;485;36;0;0;0;0;.00nan;0;0
25440;599;36;56;20;2;18;.900;3564000;0
25440;1016;33;0;0;0;0;.00nan;0;0
25440;3987;33;72;20;1;19;.950;3600000;0
25103;281;57;72;33;3;30;.909;3579000;0
25103;427;54;0;0;0;0;.00nan;0;0
25103;771;34;83;31;2;29;.935;3600000;0
25103;1002;34;0;0;0;0;.00nan;0;0
25238;831;44;0;0;0;0;.00nan;0;0
25238;896;43;74;28;2;26;.929;3600000;0
25238;1085;44;73;42;3;39;.929;3569000;0
25238;1988;43;0;0;0;0;.00nan;0;0
25264;593;57;81;12;0;12;1.000;3600000;0
25264;907;57;0;0;0;0;.00nan;0;0
25264;2598;50;0;0;0;0;.00nan;0;0
25264;5398;50;78;33;1;32;.970;3600000;0
25164;1259;53;78;28;2;26;.929;3600000;0
25164;2538;53;0;0;0;0;.00nan;0;0
25164;2846;41;77;48;5;43;.896;3508000;0
25164;4968;41;42;3;1;2;.667;92000;0
25123;1288;58;60;34;5;29;.853;3600000;0
25123;2532;58;0;0;0;0;.00nan;0;0
25123;2615;40;87;23;1;22;.957;3600000;0
25123;2954;40;0;0;0;0;.00nan;0;0
25165;346;46;0;0;0;0;.00nan;0;0
25165;401;47;0;0;0;0;.00nan;0;0
25165;1060;47;67;30;3;27;.900;3600000;0
25165;4916;46;100;34;0;34;1.000;3600000;0
25188;815;55;0;0;0;0;.00nan;0;0
25188;923;32;0;0;0;0;.00nan;0;0
25188;992;32;61;34;3;31;.912;3600000;0
25188;1311;55;100;27;0;27;1.000;3600000;0
25175;1279;49;87;26;1;25;.962;3600000;0
25175;2033;51;57;27;3;24;.889;3560000;0
25175;2273;49;0;0;0;0;.00nan;0;0
25175;2940;51;0;0;0;0;.00nan;0;0
25132;706;42;78;31;3;28;.903;3600000;0
25132;1875;37;61;30;4;26;.867;3586000;0
25132;2246;42;0;0;0;0;.00nan;0;0
25132;2591;37;0;0;0;0;.00nan;0;0
25084;35;59;0;0;0;0;.00nan;0;0
25084;349;59;86;35;2;33;.943;3600000;0
25084;831;44;70;35;3;32;.914;3600000;0
25084;1085;44;0;0;0;0;.00nan;0;0
25096;534;38;100;31;0;31;1.000;3600000;0
25096;778;54;73;36;3;33;.917;3600000;0
25096;1345;38;0;0;0;0;.00nan;0;0
25096;2848;54;0;0;0;0;.00nan;0;0
25170;485;36;86;28;1;27;.964;3600000;0
25170;599;36;0;0;0;0;.00nan;0;0
25170;2846;41;62;20;2;18;.900;3589000;0
25170;4968;41;0;0;0;0;.00nan;0;0
25173;1016;33;0;0;0;0;.00nan;0;0
25173;1259;53;0;0;0;0;.00nan;0;0
25173;2538;53;59;40;5;35;.875;3600000;0
25173;3987;33;77;32;2;30;.938;3600000;0
25125;281;57;0;0;0;0;.00nan;0;0
25125;427;54;54;26;3;23;.885;3600000;0
25125;1288;58;0;0;0;0;.00nan;0;0
25125;2532;58;76;36;4;32;.889;3546000;0
25081;35;59;38;23;4;19;.826;3900000;0
25081;346;46;0;0;0;0;.00nan;0;0
25081;349;59;0;0;0;0;.00nan;0;0
25081;4916;46;62;34;4;30;.882;3881000;0
25181;1911;31;0;0;0;0;.00nan;0;0
25181;2033;51;0;0;0;0;.00nan;0;0
25181;2936;31;65;15;1;14;.933;3600000;0
25181;2940;51;38;31;5;26;.839;3600000;0
25269;896;43;53;25;4;21;.840;3626000;0
25269;923;32;0;0;0;0;.00nan;0;0
25269;992;32;64;32;3;29;.906;3626000;0
25269;1988;43;0;0;0;0;.00nan;0;0
25185;673;35;40;34;6;28;.824;2275000;0
25185;692;35;45;15;3;12;.800;1325000;0
25185;1234;39;41;15;3;12;.800;3600000;0
25185;1901;39;0;0;0;0;.00nan;0;0
25092;706;42;0;0;0;0;.00nan;0;0
25092;771;34;67;32;3;29;.906;3900000;0
25092;1002;34;0;0;0;0;.00nan;0;0
25092;2246;42;78;29;3;26;.897;3900000;0
25298;0;48;51;30;4;26;.867;3900000;0
25298;856;48;0;0;0;0;.00nan;0;0
25298;1875;37;0;0;0;0;.00nan;0;0
25298;2591;37;60;30;4;26;.867;3900000;0
25130;430;56;61;28;3;25;.893;3600000;0
25130;1458;61;0;0;0;0;.00nan;0;0
25130;1865;61;57;28;4;24;.857;3593000;0
25130;2081;56;0;0;0;0;.00nan;0;0
25139;352;45;80;27;2;25;.926;3600000;0
25139;430;56;0;0;0;0;.00nan;0;0
25139;1934;45;0;0;0;0;.00nan;0;0
25139;2081;56;61;35;4;31;.886;3551000;0
25186;0;48;55;29;4;25;.862;3600000;0
25186;856;48;0;0;0;0;.00nan;0;0
25186;1259;53;95;20;0;20;1.000;3600000;0
25186;2538;53;0;0;0;0;.00nan;0;0
25141;778;54;0;0;0;0;.00nan;0;0
25141;1288;58;58;38;5;33;.868;3600000;0
25141;2532;58;0;0;0;0;.00nan;0;0
25141;2848;54;81;23;1;22;.957;3600000;0
25273;923;32;0;0;0;0;.00nan;0;0
25273;992;32;36;32;6;26;.813;3600000;0
25273;2615;40;93;32;2;30;.938;3600000;0
25273;2954;40;0;0;0;0;.00nan;0;0
25191;1911;31;0;0;0;0;.00nan;0;0
25191;2033;51;0;0;0;0;.00nan;0;0
25191;2936;31;87;41;3;38;.927;3900000;0
25191;2940;51;72;33;3;30;.909;3900000;0
25134;771;34;68;34;4;30;.882;3600000;0
25134;1002;34;0;0;0;0;.00nan;0;0
25134;1234;39;87;24;1;23;.958;3600000;0
25134;1901;39;0;0;0;0;.00nan;0;0
25144;534;38;89;32;2;30;.938;3600000;0
25144;896;43;0;0;0;0;.00nan;0;0
25144;1345;38;0;0;0;0;.00nan;0;0
25144;1988;43;51;38;5;33;.868;3600000;0
25240;352;45;0;0;0;0;.00nan;0;0
25240;815;55;0;0;0;0;.00nan;0;0
25240;1311;55;82;20;1;19;.950;3600000;0
25240;1934;45;54;36;5;31;.861;3600000;0
25145;401;47;0;0;0;0;.00nan;0;0
25145;593;57;72;27;2;25;.926;3864000;0
25145;907;57;0;0;0;0;.00nan;0;0
25145;1060;47;79;36;3;33;.917;3864000;0
25157;335;60;62;24;2;22;.917;3900000;0
25157;706;42;99;43;2;41;.953;3900000;0
25157;2192;60;0;0;0;0;.00nan;0;0
25157;2246;42;0;0;0;0;.00nan;0;0
25296;485;36;99;33;1;32;.970;3600000;0
25296;599;36;0;0;0;0;.00nan;0;0
25296;2615;40;0;0;0;0;.00nan;0;0
25296;2954;40;60;41;5;36;.878;3600000;0
25155;771;34;0;0;0;0;.00nan;0;0
25155;831;44;0;0;0;0;.00nan;0;0
25155;1002;34;47;27;4;23;.852;3600000;0
25155;1085;44;72;22;1;21;.955;3600000;0
25158;281;57;100;27;0;27;1.000;3600000;0
25158;401;47;57;34;4;30;.882;3600000;0
25158;427;54;0;0;0;0;.00nan;0;0
25158;1060;47;0;0;0;0;.00nan;0;0
25260;896;43;45;26;4;22;.846;3567000;0
25260;1988;43;0;0;0;0;.00nan;0;0
25260;2846;41;84;44;3;41;.932;3600000;0
25260;4968;41;0;0;0;0;.00nan;0;0
25082;35;59;0;0;0;0;.00nan;0;0
25082;349;59;76;37;3;34;.919;3564000;0
25082;1279;49;98;40;2;38;.950;3600000;0
25082;2273;49;0;0;0;0;.00nan;0;0
25241;335;60;0;0;0;0;.00nan;0;0
25241;1016;33;0;0;0;0;.00nan;0;0
25241;2192;60;53;40;5;35;.875;3600000;0
25241;3987;33;67;36;4;32;.889;3600000;0
25224;815;55;78;29;2;27;.931;3900000;0
25224;1311;55;0;0;0;0;.00nan;0;0
25224;1458;61;0;0;0;0;.00nan;0;0
25224;1865;61;90;37;2;35;.946;3897000;0
25187;346;46;76;28;1;27;.964;3600000;0
25187;673;35;0;0;0;0;.00nan;0;0
25187;692;35;85;33;2;31;.939;3600000;0
25187;4916;46;0;0;0;0;.00nan;0;0
25171;593;57;54;17;3;14;.824;3600000;0
25171;831;44;34;46;8;38;.826;3049000;0
25171;907;57;0;0;0;0;.00nan;0;0
25171;1085;44;42;3;1;2;.667;551000;0
25454;1458;61;85;33;2;31;.939;3876000;0
25454;1865;61;0;0;0;0;.00nan;0;0
25454;2598;50;0;0;0;0;.00nan;0;0
25454;5398;50;83;26;1;25;.962;3876000;0
25154;1234;39;61;21;2;19;.905;3600000;0
25154;1279;49;0;0;0;0;.00nan;0;0
25154;1901;39;0;0;0;0;.00nan;0;0
25154;2273;49;65;44;5;39;.886;3600000;0
25148;0;48;72;50;5;45;.900;3600000;0
25148;534;38;56;21;2;19;.905;3600000;0
25148;856;48;0;0;0;0;.00nan;0;0
25148;1345;38;0;0;0;0;.00nan;0;0
25152;430;56;97;37;1;36;.973;3900000;0
25152;485;36;0;0;0;0;.00nan;0;0
25152;599;36;71;16;1;15;.938;3900000;0
25152;2081;56;0;0;0;0;.00nan;0;0
25229;352;45;76;32;3;29;.906;3600000;0
25229;1911;31;59;7;0;7;1.000;1517000;0
25229;1934;45;0;0;0;0;.00nan;0;0
25229;2936;31;26;19;5;14;.737;2083000;0
25198;673;35;0;0;0;0;.00nan;0;0
25198;692;35;60;40;4;36;.900;3900000;0
25198;1016;33;0;0;0;0;.00nan;0;0
25198;3987;33;55;27;4;23;.852;3900000;0
25512;335;60;78;30;1;29;.967;3600000;0
25512;1875;37;0;0;0;0;.00nan;0;0
25512;2192;60;0;0;0;0;.00nan;0;0
25512;2591;37;69;26;3;23;.885;3539000;0
25615;35;59;0;0;0;0;.00nan;0;0
25615;349;59;74;36;3;33;.917;3522000;0
25615;2615;40;83;30;1;29;.967;3600000;0
25615;2954;40;0;0;0;0;.00nan;0;0
25146;281;57;76;33;3;30;.909;3573000;0
25146;427;54;0;0;0;0;.00nan;0;0
25146;778;54;100;31;1;30;.968;3600000;0
25146;2848;54;0;0;0;0;.00nan;0;0
25176;335;60;0;0;0;0;.00nan;0;0
25176;430;56;100;25;0;25;1.000;3600000;0
25176;2081;56;0;0;0;0;.00nan;0;0
25176;2192;60;68;30;4;26;.867;3600000;0
25215;771;34;81;25;2;23;.920;3620000;0
25215;1002;34;0;0;0;0;.00nan;0;0
25215;1016;33;88;42;3;39;.929;3619000;0
25215;3987;33;0;0;0;0;.00nan;0;0
25358;485;36;62;27;3;24;.889;3573000;0
25358;599;36;0;0;0;0;.00nan;0;0
25358;1458;61;0;0;0;0;.00nan;0;0
25358;1865;61;93;35;2;33;.943;3600000;0
25199;815;55;0;0;0;0;.00nan;0;0
25199;1259;53;100;30;0;30;1.000;3600000;0
25199;1311;55;85;32;3;29;.906;3600000;0
25199;2538;53;0;0;0;0;.00nan;0;0
25113;35;59;51;17;2;15;.882;3532000;0
25113;349;59;0;0;0;0;.00nan;0;0
25113;923;32;0;0;0;0;.00nan;0;0
25113;992;32;98;23;0;23;1.000;3600000;0
25160;593;57;69;17;1;16;.941;3600000;0
25160;706;42;86;47;4;43;.915;3600000;0
25160;907;57;0;0;0;0;.00nan;0;0
25160;2246;42;0;0;0;0;.00nan;0;0
25202;0;48;83;49;5;44;.898;3584000;0
25202;534;38;0;0;0;0;.00nan;0;0
25202;856;48;0;0;0;0;.00nan;0;0
25202;1345;38;43;19;4;15;.789;3600000;0
25658;831;44;0;0;0;0;.00nan;0;0
25658;896;43;72;28;2;26;.929;3600000;0
25658;1085;44;69;37;3;34;.919;3543000;0
25658;1988;43;0;0;0;0;.00nan;0;0
25323;346;46;93;38;3;35;.921;3900000;0
25323;2598;50;0;0;0;0;.00nan;0;0
25323;4916;46;0;0;0;0;.00nan;0;0
25323;5398;50;62;31;3;28;.903;3900000;0
25225;923;32;0;0;0;0;.00nan;0;0
25225;992;32;91;41;2;39;.951;3548000;0
25225;1279;49;69;18;1;17;.944;3600000;0
25225;2273;49;0;0;0;0;.00nan;0;0
25161;534;38;47;28;5;23;.821;3522000;0
25161;771;34;0;0;0;0;.00nan;0;0
25161;1002;34;59;24;3;21;.875;3600000;0
25161;1345;38;0;0;0;0;.00nan;0;0
25159;706;42;0;0;0;0;.00nan;0;0
25159;2246;42;68;27;2;25;.926;3568000;0
25159;2615;40;91;38;1;37;.974;3600000;0
25159;2954;40;0;0;0;0;.00nan;0;0
25203;430;56;96;22;0;22;1.000;3600000;0
25203;1259;53;52;25;3;22;.880;3600000;0
25203;2081;56;0;0;0;0;.00nan;0;0
25203;2538;53;0;0;0;0;.00nan;0;0
25218;352;45;69;40;4;36;.900;3600000;0
25218;1234;39;0;0;0;0;.00nan;0;0
25218;1901;39;64;17;1;16;.941;3600000;0
25218;1934;45;0;0;0;0;.00nan;0;0
25166;281;57;50;32;5;27;.844;3618000;0
25166;427;54;0;0;0;0;.00nan;0;0
25166;2846;41;67;37;4;33;.892;3618000;0
25166;4968;41;0;0;0;0;.00nan;0;0
25345;593;57;0;0;0;0;.00nan;0;0
25345;907;57;71;26;2;24;.923;3600000;0
25345;1911;31;56;37;5;32;.865;3600000;0
25345;2936;31;0;0;0;0;.00nan;0;0
25169;831;44;69;32;4;28;.875;3600000;0
25169;1085;44;0;0;0;0;.00nan;0;0
25169;1288;58;54;39;6;33;.846;3558000;0
25169;2532;58;0;0;0;0;.00nan;0;0
25190;401;47;0;0;0;0;.00nan;0;0
25190;778;54;0;0;0;0;.00nan;0;0
25190;1060;47;84;26;1;25;.962;3600000;0
25190;2848;54;60;32;4;28;.875;3600000;0
25220;673;35;0;0;0;0;.00nan;0;0
25220;692;35;96;36;2;34;.944;3600000;0
25220;896;43;0;0;0;0;.00nan;0;0
25220;1988;43;55;35;5;30;.857;3578000;0
25592;485;36;0;0;0;0;.00nan;0;0
25592;599;36;71;25;3;22;.880;3600000;0
25592;2033;51;0;0;0;0;.00nan;0;0
25592;2940;51;67;42;5;37;.881;3592000;0
25362;335;60;78;33;2;31;.939;3600000;0
25362;346;46;48;0;0;0;.00nan;260000;0
25362;2192;60;0;0;0;0;.00nan;0;0
25362;4916;46;55;31;4;27;.871;3299000;0
25214;401;47;81;24;2;22;.917;3577000;0
25214;815;55;0;0;0;0;.00nan;0;0
25214;1060;47;0;0;0;0;.00nan;0;0
25214;1311;55;84;26;1;25;.962;3600000;0
25558;2033;51;65;42;4;38;.905;3530000;0
25558;2615;40;62;22;2;20;.909;3600000;0
25558;2940;51;0;0;0;0;.00nan;0;0
25558;2954;40;0;0;0;0;.00nan;0;0
25307;0;48;67;48;5;43;.896;3600000;0
25307;856;48;0;0;0;0;.00nan;0;0
25307;1259;53;46;26;4;22;.846;3600000;0
25307;2538;53;0;0;0;0;.00nan;0;0
25180;673;35;0;0;0;0;.00nan;0;0
25180;692;35;80;24;1;23;.958;3600000;0
25180;831;44;0;0;0;0;.00nan;0;0
25180;1085;44;92;43;2;41;.953;3580000;0
25182;1288;58;58;24;3;21;.875;3900000;0
25182;2532;58;0;0;0;0;.00nan;0;0
25182;2846;41;100;51;3;48;.941;3900000;0
25182;4968;41;0;0;0;0;.00nan;0;0
25235;896;43;84;39;3;36;.923;3551000;0
25235;1016;33;0;0;0;0;.00nan;0;0
25235;1988;43;0;0;0;0;.00nan;0;0
25235;3987;33;76;22;1;21;.955;3600000;0
25201;430;56;29;30;6;24;.800;2721000;0
25201;534;38;86;25;1;24;.960;3600000;0
25201;1345;38;0;0;0;0;.00nan;0;0
25201;2081;56;50;9;1;8;.889;879000;0
25285;1234;39;37;18;5;13;.722;3600000;0
25285;1901;39;0;0;0;0;.00nan;0;0
25285;1911;31;36;12;3;9;.750;917000;0
25285;2936;31;48;41;6;35;.854;2683000;0
25404;593;57;89;26;1;25;.962;3600000;0
25404;815;55;46;21;3;18;.857;3573000;0
25404;907;57;0;0;0;0;.00nan;0;0
25404;1311;55;0;0;0;0;.00nan;0;0
25118;35;59;0;0;0;0;.00nan;0;0
25118;349;59;100;47;3;44;.936;3900000;0
25118;1875;37;0;0;0;0;.00nan;0;0
25118;2591;37;58;22;3;19;.864;3900000;0
25162;352;45;90;31;1;30;.968;3600000;0
25162;706;42;73;30;3;27;.900;3518000;0
25162;1934;45;0;0;0;0;.00nan;0;0
25162;2246;42;0;0;0;0;.00nan;0;0
25328;346;46;0;0;0;0;.00nan;0;0
25328;1911;31;26;26;6;20;.769;2565000;0
25328;2936;31;33;14;3;11;.786;1035000;0
25328;4916;46;49;29;5;24;.828;3600000;0
25195;831;44;100;62;3;59;.952;3900000;0
25195;1085;44;0;0;0;0;.00nan;0;0
25195;1234;39;0;0;0;0;.00nan;0;0
25195;1901;39;43;19;3;16;.842;3900000;0
25252;352;45;44;3;1;2;.667;282000;0
25252;1934;45;41;37;6;31;.838;3318000;0
25252;2598;50;100;24;0;24;1.000;3600000;0
25252;5398;50;0;0;0;0;.00nan;0;0
25116;35;59;93;58;3;55;.948;3600000;0
25116;349;59;0;0;0;0;.00nan;0;0
25116;1875;37;27;20;5;15;.750;3536000;0
25116;2591;37;0;0;0;0;.00nan;0;0
25242;778;54;68;35;4;31;.886;3900000;0
25242;923;32;0;0;0;0;.00nan;0;0
25242;992;32;51;29;4;25;.862;3900000;0
25242;2848;54;0;0;0;0;.00nan;0;0
25178;281;57;61;28;3;25;.893;3900000;0
25178;427;54;0;0;0;0;.00nan;0;0
25178;1458;61;0;0;0;0;.00nan;0;0
25178;1865;61;74;43;3;40;.930;3900000;0
25302;1279;49;69;32;3;29;.906;3600000;0
25302;2273;49;0;0;0;0;.00nan;0;0
25302;2615;40;0;0;0;0;.00nan;0;0
25302;2954;40;24;24;6;18;.750;3600000;0
25319;0;48;69;49;6;43;.878;3579000;0
25319;856;48;50;0;0;0;.00nan;21000;0
25319;2598;50;63;23;2;21;.913;3600000;0
25319;5398;50;0;0;0;0;.00nan;0;0
25226;771;34;64;25;3;22;.880;3600000;0
25226;1002;34;0;0;0;0;.00nan;0;0
25226;2033;51;0;0;0;0;.00nan;0;0
25226;2940;51;50;35;5;30;.857;3524000;0
25209;673;35;0;0;0;0;.00nan;0;0
25209;692;35;99;36;1;35;.972;3600000;0
25209;1458;61;60;34;4;30;.882;3600000;0
25209;1865;61;0;0;0;0;.00nan;0;0
25192;281;57;0;0;0;0;.00nan;0;0
25192;427;54;84;17;0;17;1.000;3600000;0
25192;2846;41;91;52;5;47;.904;3600000;0
25192;4968;41;0;0;0;0;.00nan;0;0
25233;401;47;0;0;0;0;.00nan;0;0
25233;1060;47;79;29;2;27;.931;3600000;0
25233;1875;37;0;0;0;0;.00nan;0;0
25233;2591;37;77;37;3;34;.919;3568000;0
25287;778;54;70;36;3;33;.917;3588000;0
25287;896;43;94;37;2;35;.946;3600000;0
25287;1988;43;0;0;0;0;.00nan;0;0
25287;2848;54;0;0;0;0;.00nan;0;0
25313;335;60;57;22;3;19;.864;3900000;0
25313;1279;49;85;37;3;34;.919;3900000;0
25313;2192;60;0;0;0;0;.00nan;0;0
25313;2273;49;0;0;0;0;.00nan;0;0
25179;1016;33;0;0;0;0;.00nan;0;0
25179;1288;58;76;34;3;31;.912;3600000;0
25179;2532;58;0;0;0;0;.00nan;0;0
25179;3987;33;52;28;4;24;.857;3554000;0
25246;706;42;100;42;2;40;.952;3600000;0
25246;896;43;0;0;0;0;.00nan;0;0
25246;1988;43;83;38;3;35;.921;3576000;0
25246;2246;42;0;0;0;0;.00nan;0;0
25274;430;56;99;33;1;32;.970;3600000;0
25274;2081;56;0;0;0;0;.00nan;0;0
25274;2846;41;38;35;6;29;.829;3364000;0
25274;4968;41;50;1;0;1;1.000;236000;0
25210;534;38;59;24;3;21;.875;3900000;0
25210;1345;38;0;0;0;0;.00nan;0;0
25210;1458;61;0;0;0;0;.00nan;0;0
25210;1865;61;64;28;3;25;.893;3900000;0
25317;401;47;99;28;0;28;1.000;3600000;0
25317;485;36;59;31;4;27;.871;3600000;0
25317;599;36;0;0;0;0;.00nan;0;0
25317;1060;47;0;0;0;0;.00nan;0;0
25262;771;34;56;27;4;23;.852;3600000;0
25262;1002;34;0;0;0;0;.00nan;0;0
25262;2598;50;48;8;1;7;.875;842000;0
25262;5398;50;31;38;7;31;.816;2758000;0
25349;1234;39;94;20;0;20;1.000;3600000;0
25349;1901;39;0;0;0;0;.00nan;0;0
25349;2615;40;55;39;5;34;.872;3600000;0
25349;2954;40;0;0;0;0;.00nan;0;0
25237;1016;33;0;0;0;0;.00nan;0;0
25237;1911;31;0;0;0;0;.00nan;0;0
25237;2936;31;64;31;3;28;.903;3600000;0
25237;3987;33;21;13;4;9;.692;3564000;0
25354;335;60;54;23;3;20;.870;3600000;0
25354;923;32;0;0;0;0;.00nan;0;0
25354;992;32;63;31;4;27;.871;3600000;0
25354;2192;60;0;0;0;0;.00nan;0;0
25211;35;59;0;0;0;0;.00nan;0;0
25211;349;59;70;31;2;29;.935;3589000;0
25211;815;55;0;0;0;0;.00nan;0;0
25211;1311;55;100;26;0;26;1.000;3600000;0
25388;1234;39;81;37;2;35;.946;3596000;0
25388;1279;49;86;32;1;31;.969;3600000;0
25388;1901;39;0;0;0;0;.00nan;0;0
25388;2273;49;0;0;0;0;.00nan;0;0
25359;0;48;50;37;5;32;.865;3550000;0
25359;485;36;0;0;0;0;.00nan;0;0
25359;599;36;69;27;3;24;.889;3600000;0
25359;856;48;0;0;0;0;.00nan;0;0
25221;593;57;84;30;2;28;.933;3513000;0
25221;831;44;0;0;0;0;.00nan;0;0
25221;907;57;0;0;0;0;.00nan;0;0
25221;1085;44;100;33;0;33;1.000;3600000;0
25271;352;45;59;23;3;20;.870;3767000;0
25271;1934;45;0;0;0;0;.00nan;0;0
25271;4968;41;58;36;4;32;.889;3767000;0
25271;6353;41;0;0;0;0;.00nan;0;0
25245;346;46;0;0;0;0;.00nan;0;0
25245;1288;58;59;35;5;30;.857;3600000;0
25245;2532;58;0;0;0;0;.00nan;0;0
25245;4916;46;75;18;1;17;.944;3600000;0
25263;430;56;0;0;0;0;.00nan;0;0
25263;1259;53;10;17;6;11;.647;2893000;0
25263;2081;56;100;29;0;29;1.000;3600000;0
25263;2538;53;50;1;0;1;1.000;707000;0
25303;771;34;0;0;0;0;.00nan;0;0
25303;1002;34;59;26;3;23;.885;3600000;0
25303;2615;40;53;2;0;2;1.000;25000;0
25303;2954;40;43;39;6;33;.846;3575000;0
25184;534;38;0;0;0;0;.00nan;0;0
25184;778;54;47;39;6;33;.846;2928000;0
25184;1345;38;83;26;1;25;.962;3600000;0
25184;2848;54;32;3;2;1;.333;672000;0
25257;335;60;0;0;0;0;.00nan;0;0
25257;831;44;0;0;0;0;.00nan;0;0
25257;1085;44;57;32;5;27;.844;3576000;0
25257;2192;60;67;30;3;27;.900;3600000;0
25183;35;59;94;45;2;43;.956;3600000;0
25183;349;59;0;0;0;0;.00nan;0;0
25183;673;35;0;0;0;0;.00nan;0;0
25183;692;35;55;26;4;22;.846;3600000;0
25255;815;55;0;0;0;0;.00nan;0;0
25255;1311;55;70;25;2;23;.920;3600000;0
25255;1458;61;52;22;3;19;.864;3587000;0
25255;1890;61;0;0;0;0;.00nan;0;0
25207;281;57;0;0;0;0;.00nan;0;0
25207;427;54;74;27;2;25;.926;3600000;0
25207;2033;51;0;0;0;0;.00nan;0;0
25207;2940;51;75;50;5;45;.900;3600000;0
25250;1016;33;33;22;5;17;.773;3646000;0
25250;2598;50;59;15;2;13;.867;1563000;0
25250;3987;33;0;0;0;0;.00nan;0;0
25250;5398;50;53;28;4;24;.857;2083000;0
25259;352;45;91;32;1;31;.969;3600000;0
25259;1458;61;0;0;0;0;.00nan;0;0
25259;1890;61;74;26;3;23;.885;3572000;0
25259;1934;45;0;0;0;0;.00nan;0;0
25200;281;57;13;22;6;16;.727;3378000;0
25200;427;54;44;5;1;4;.800;448000;0
25200;673;35;61;44;6;38;.864;3826000;0
25200;692;35;0;0;0;0;.00nan;0;0
25355;1279;49;93;28;1;27;.964;3600000;0
25355;2273;49;0;0;0;0;.00nan;0;0
25355;2615;40;48;24;4;20;.833;3600000;0
25355;2954;40;0;0;0;0;.00nan;0;0
25283;593;57;48;20;4;16;.800;3600000;0
25283;907;57;0;0;0;0;.00nan;0;0
25283;923;32;43;5;1;4;.800;438000;0
25283;992;32;44;33;7;26;.788;3162000;0
25208;1288;58;47;14;2;12;.857;3600000;0
25208;2033;51;91;45;3;42;.933;3585000;0
25208;2532;58;0;0;0;0;.00nan;0;0
25208;2940;51;0;0;0;0;.00nan;0;0
25295;896;43;74;34;3;31;.912;3600000;0
25295;1875;37;0;0;0;0;.00nan;0;0
25295;1988;43;0;0;0;0;.00nan;0;0
25295;2591;37;99;37;2;35;.946;3600000;0
25206;534;38;73;31;3;28;.903;3555000;0
25206;1345;38;0;0;0;0;.00nan;0;0
25206;1911;31;0;0;0;0;.00nan;0;0
25206;2936;31;69;22;1;21;.955;3600000;0
25219;430;56;0;0;0;0;.00nan;0;0
25219;1234;39;0;0;0;0;.00nan;0;0
25219;1901;39;88;33;2;31;.939;3900000;0
25219;2081;56;96;44;2;42;.955;3900000;0
25439;346;46;36;29;5;24;.828;3566000;0
25439;485;36;75;33;3;30;.909;3600000;0
25439;599;36;0;0;0;0;.00nan;0;0
25439;4916;46;0;0;0;0;.00nan;0;0
25379;401;47;71;33;2;31;.939;3900000;0
25379;1060;47;0;0;0;0;.00nan;0;0
25379;1875;37;80;29;2;27;.931;3900000;0
25379;2591;37;0;0;0;0;.00nan;0;0
25193;335;60;63;41;5;36;.878;3600000;0
25193;1288;58;0;0;0;0;.00nan;0;0
25193;2192;60;0;0;0;0;.00nan;0;0
25193;2532;58;68;28;2;26;.929;3600000;0
25291;1911;31;68;32;3;29;.906;3600000;0
25291;2936;31;0;0;0;0;.00nan;0;0
25291;4968;41;0;0;0;0;.00nan;0;0
25291;6353;41;59;34;5;29;.853;3558000;0
25228;771;34;57;30;4;26;.867;3600000;0
25228;778;54;88;31;1;30;.968;3600000;0
25228;1002;34;0;0;0;0;.00nan;0;0
25228;2848;54;0;0;0;0;.00nan;0;0
25315;815;55;0;0;0;0;.00nan;0;0
25315;1259;53;75;35;3;32;.914;3600000;0
25315;1311;55;39;29;5;24;.828;3577000;0
25315;2538;53;0;0;0;0;.00nan;0;0
25234;593;57;92;20;0;20;1.000;3600000;0
25234;673;35;0;0;0;0;.00nan;0;0
25234;692;35;60;48;6;42;.875;3600000;0
25234;907;57;0;0;0;0;.00nan;0;0
25500;706;42;53;31;4;27;.871;3544000;0
25500;1279;49;81;37;3;34;.919;3600000;0
25500;2246;42;0;0;0;0;.00nan;0;0
25500;2273;49;0;0;0;0;.00nan;0;0
25248;778;54;0;0;0;0;.00nan;0;0
25248;2598;50;0;0;0;0;.00nan;0;0
25248;2751;50;73;23;1;22;.957;3600000;0
25248;2848;54;61;39;5;34;.872;3600000;0
25270;831;44;0;0;0;0;.00nan;0;0
25270;923;32;0;0;0;0;.00nan;0;0
25270;992;32;55;27;4;23;.852;3519000;0
25270;1085;44;77;32;2;30;.938;3600000;0
25450;0;48;100;35;1;34;.971;3600000;0
25450;346;46;0;0;0;0;.00nan;0;0
25450;856;48;0;0;0;0;.00nan;0;0
25450;4916;46;78;39;3;36;.923;3513000;0
25286;352;45;98;49;1;48;.980;3579000;0
25286;896;43;100;20;0;20;1.000;3600000;0
25286;1934;45;0;0;0;0;.00nan;0;0
25286;1988;43;0;0;0;0;.00nan;0;0
25217;35;59;0;0;0;0;.00nan;0;0
25217;349;59;78;35;3;32;.914;3600000;0
25217;2033;51;0;0;0;0;.00nan;0;0
25217;2940;51;48;28;5;23;.821;3528000;0
25266;401;47;0;0;0;0;.00nan;0;0
25266;1016;33;0;0;0;0;.00nan;0;0
25266;1060;47;36;23;5;18;.783;3533000;0
25266;3987;33;68;30;3;27;.900;3600000;0
25282;281;57;75;26;2;24;.923;3600000;0
25282;427;54;0;0;0;0;.00nan;0;0
25282;1259;53;33;29;6;23;.793;3334000;0
25282;2538;53;50;3;0;3;1.000;266000;0
25350;706;42;80;28;2;26;.929;3673000;0
25350;1259;53;0;0;0;0;.00nan;0;0
25350;2246;42;0;0;0;0;.00nan;0;0
25350;2538;53;95;33;1;32;.970;3673000;0
25311;896;43;78;39;4;35;.897;3894000;0
25311;1988;43;0;0;0;0;.00nan;0;0
25311;2598;50;56;27;3;24;.889;3894000;0
25311;2751;50;0;0;0;0;.00nan;0;0
25292;593;57;100;23;0;23;1.000;3600000;0
25292;907;57;0;0;0;0;.00nan;0;0
25292;2846;41;0;0;0;0;.00nan;0;0
25292;6353;41;76;41;3;38;.927;3600000;0
25268;35;59;65;17;1;16;.941;3600000;0
25268;349;59;0;0;0;0;.00nan;0;0
25268;778;54;84;47;3;44;.936;3522000;0
25268;2848;54;0;0;0;0;.00nan;0;0
25309;352;45;85;27;1;26;.963;3600000;0
25309;815;55;0;0;0;0;.00nan;0;0
25309;1311;55;66;22;2;20;.909;3600000;0
25309;1934;45;0;0;0;0;.00nan;0;0
25213;485;36;88;32;2;30;.938;3600000;0
25213;534;38;81;35;3;32;.914;3576000;0
25213;599;36;0;0;0;0;.00nan;0;0
25213;1345;38;0;0;0;0;.00nan;0;0
25369;401;47;79;31;1;30;.968;3900000;0
25369;1060;47;0;0;0;0;.00nan;0;0
25369;1911;31;0;0;0;0;.00nan;0;0
25369;2936;31;100;39;1;38;.974;3900000;0
25278;1288;58;74;43;5;38;.884;3557000;0
25278;1458;61;53;32;4;28;.875;3600000;0
25278;1890;61;0;0;0;0;.00nan;0;0
25278;2532;58;0;0;0;0;.00nan;0;0
25267;430;56;73;34;3;31;.912;3546000;0
25267;771;34;68;24;2;22;.917;3600000;0
25267;1002;34;0;0;0;0;.00nan;0;0
25267;2081;56;0;0;0;0;.00nan;0;0
25338;2598;50;0;0;0;0;.00nan;0;0
25338;2615;40;70;21;2;19;.905;3900000;0
25338;2751;50;94;42;2;40;.952;3900000;0
25338;2954;40;0;0;0;0;.00nan;0;0
25306;778;54;49;2;0;2;1.000;151000;0
25306;2033;51;0;0;0;0;.00nan;0;0
25306;2848;54;54;39;6;33;.846;3449000;0
25306;2940;51;74;32;3;29;.906;3600000;0
25305;352;45;70;39;4;35;.897;3600000;0
25305;1279;49;69;21;1;20;.952;3600000;0
25305;1934;45;0;0;0;0;.00nan;0;0
25305;2273;49;0;0;0;0;.00nan;0;0
25432;335;60;80;16;0;16;1.000;3600000;0
25432;485;36;0;0;0;0;.00nan;0;0
25432;599;36;59;33;4;29;.879;3600000;0
25432;2192;60;0;0;0;0;.00nan;0;0
25321;923;32;57;54;6;48;.889;3600000;0
25321;992;32;0;0;0;0;.00nan;0;0
25321;1016;33;0;0;0;0;.00nan;0;0
25321;3987;33;69;27;2;25;.926;3600000;0
25212;0;48;49;27;4;23;.852;3600000;0
25212;534;38;0;0;0;0;.00nan;0;0
25212;856;48;0;0;0;0;.00nan;0;0
25212;1345;38;74;27;2;25;.926;3600000;0
25227;706;42;0;0;0;0;.00nan;0;0
25227;1234;39;0;0;0;0;.00nan;0;0
25227;1901;39;62;21;2;19;.905;3600000;0
25227;2246;42;68;42;5;37;.881;3600000;0
25361;430;56;0;0;0;0;.00nan;0;0
25361;1875;37;0;0;0;0;.00nan;0;0
25361;2081;56;56;30;3;27;.900;3549000;0
25361;2591;37;76;15;1;14;.933;3600000;0
25310;771;34;0;0;0;0;.00nan;0;0
25310;815;55;41;35;6;29;.829;3600000;0
25310;1002;34;90;15;0;15;1.000;3600000;0
25310;1311;55;0;0;0;0;.00nan;0;0
25347;831;44;0;0;0;0;.00nan;0;0
25347;1085;44;86;17;0;17;1.000;3600000;0
25347;1458;61;0;0;0;0;.00nan;0;0
25347;1890;61;91;36;2;34;.944;3600000;0
25251;673;35;0;0;0;0;.00nan;0;0
25251;692;35;76;24;1;23;.958;3549000;0
25251;2846;41;100;27;0;27;1.000;3600000;0
25251;6353;41;0;0;0;0;.00nan;0;0
25244;281;57;58;21;2;19;.905;3600000;0
25244;427;54;0;0;0;0;.00nan;0;0
25244;1288;58;43;17;3;14;.824;1540000;0
25244;2532;58;51;26;4;22;.846;2060000;0
25580;346;46;0;0;0;0;.00nan;0;0
25580;1279;49;58;7;0;7;1.000;477000;0
25580;2273;49;16;22;6;16;.727;3123000;0
25580;4916;46;88;23;1;22;.957;3600000;0
25300;831;44;0;0;0;0;.00nan;0;0
25300;896;43;76;33;2;31;.939;3559000;0
25300;1085;44;93;36;1;35;.972;3600000;0
25300;1988;43;0;0;0;0;.00nan;0;0
25392;401;47;0;0;0;0;.00nan;0;0
25392;1060;47;74;34;3;31;.912;3627000;0
25392;2615;40;88;35;2;33;.943;3627000;0
25392;2954;40;0;0;0;0;.00nan;0;0
25312;778;54;60;44;6;38;.864;3572000;0
25312;1016;33;0;0;0;0;.00nan;0;0
25312;2848;54;50;0;0;0;.00nan;28000;0
25312;3987;33;84;40;3;37;.925;3600000;0
25327;706;42;66;34;5;29;.853;3600000;0
25327;815;55;0;0;0;0;.00nan;0;0
25327;1311;55;80;26;1;25;.962;3600000;0
25327;2246;42;0;0;0;0;.00nan;0;0
25509;485;36;69;33;3;30;.909;3600000;0
25509;599;36;0;0;0;0;.00nan;0;0
25509;1875;37;52;24;4;20;.833;2914000;0
25509;2591;37;52;2;0;2;1.000;631000;0
25279;673;35;0;0;0;0;.00nan;0;0
25279;692;35;63;36;3;33;.917;3553000;0
25279;771;34;0;0;0;0;.00nan;0;0
25279;1002;34;70;23;2;21;.913;3600000;0
25329;923;32;42;30;4;26;.867;3571000;0
25329;992;32;0;0;0;0;.00nan;0;0
25329;1911;31;77;33;2;31;.939;3600000;0
25329;2936;31;0;0;0;0;.00nan;0;0
25231;35;59;0;0;0;0;.00nan;0;0
25231;349;59;99;37;1;36;.973;3600000;0
25231;1234;39;53;21;3;18;.857;3518000;0
25231;1901;39;0;0;0;0;.00nan;0;0
25284;335;60;73;32;4;28;.875;3600000;0
25284;1288;58;42;33;5;28;.848;3562000;0
25284;2192;60;0;0;0;0;.00nan;0;0
25284;2532;58;0;0;0;0;.00nan;0;0
25381;346;46;72;33;3;30;.909;3600000;0
25381;1259;53;64;35;4;31;.886;3553000;0
25381;2538;53;0;0;0;0;.00nan;0;0
25381;4916;46;0;0;0;0;.00nan;0;0
25330;0;48;98;42;2;40;.952;3579000;0
25330;281;57;62;12;1;11;.917;3600000;0
25330;427;54;0;0;0;0;.00nan;0;0
25330;856;48;0;0;0;0;.00nan;0;0
25254;35;59;73;22;1;21;.955;3600000;0
25254;349;59;0;0;0;0;.00nan;0;0
25254;2846;41;60;26;3;23;.885;3582000;0
25254;6353;41;0;0;0;0;.00nan;0;0
25223;430;56;96;20;0;20;1.000;3600000;0
25223;2033;51;0;0;0;0;.00nan;0;0
25223;2081;56;0;0;0;0;.00nan;0;0
25223;2940;51;57;39;5;34;.872;3600000;0
25414;923;32;0;0;0;0;.00nan;0;0
25414;992;32;27;25;6;19;.760;3600000;0
25414;2598;50;0;0;0;0;.00nan;0;0
25414;2751;50;90;19;0;19;1.000;3600000;0
25277;673;35;49;43;6;37;.860;3600000;0
25277;692;35;0;0;0;0;.00nan;0;0
25277;1234;39;0;0;0;0;.00nan;0;0
25277;1901;39;62;19;2;17;.895;3600000;0
25281;352;45;91;27;1;26;.963;3600000;0
25281;1458;61;84;32;2;30;.938;3557000;0
25281;1890;61;0;0;0;0;.00nan;0;0
25281;1934;45;0;0;0;0;.00nan;0;0
25383;1259;53;0;0;0;0;.00nan;0;0
25383;1911;31;0;0;0;0;.00nan;0;0
25383;2538;53;85;24;1;23;.958;3600000;0
25383;2936;31;56;23;2;21;.913;3562000;0
25474;593;57;30;24;5;19;.792;3600000;0
25474;907;57;0;0;0;0;.00nan;0;0
25474;1279;49;97;33;1;32;.970;3600000;0
25474;2273;49;0;0;0;0;.00nan;0;0
25308;281;57;0;0;0;0;.00nan;0;0
25308;427;54;57;21;3;18;.857;3600000;0
25308;831;44;30;36;7;29;.806;3452000;0
25308;1085;44;48;0;0;0;.00nan;148000;0
25375;0;48;44;38;6;32;.842;3552000;0
25375;335;60;0;0;0;0;.00nan;0;0
25375;856;48;0;0;0;0;.00nan;0;0
25375;2192;60;61;28;4;24;.857;3600000;0
25625;346;46;0;0;0;0;.00nan;0;0
25625;593;57;0;0;0;0;.00nan;0;0
25625;907;57;65;24;2;22;.917;3600000;0
25625;4916;46;80;42;3;39;.929;3600000;0
25243;534;38;97;18;0;18;1.000;3600000;0
25243;896;43;0;0;0;0;.00nan;0;0
25243;1345;38;0;0;0;0;.00nan;0;0
25243;1988;43;77;33;2;31;.939;3600000;0
25366;1016;33;0;0;0;0;.00nan;0;0
25366;2033;51;0;0;0;0;.00nan;0;0
25366;2940;51;50;25;4;21;.840;3600000;0
25366;3987;33;67;18;1;17;.944;3600000;0
25289;401;47;0;0;0;0;.00nan;0;0
25289;430;56;87;32;1;31;.969;3600000;0
25289;1060;47;61;26;3;23;.885;3555000;0
25289;2081;56;0;0;0;0;.00nan;0;0
25326;281;57;61;17;3;14;.824;3600000;0
25326;427;54;0;0;0;0;.00nan;0;0
25326;1288;58;23;9;4;5;.556;362000;0
25326;2532;58;78;41;4;37;.902;3238000;0
25288;0;48;90;36;1;35;.972;3600000;0
25288;35;59;0;0;0;0;.00nan;0;0
25288;349;59;90;33;2;31;.939;3526000;0
25288;856;48;0;0;0;0;.00nan;0;0
25373;1016;33;66;32;3;29;.906;3572000;0
25373;1234;39;80;22;1;21;.955;3600000;0
25373;1901;39;0;0;0;0;.00nan;0;0
25373;3987;33;0;0;0;0;.00nan;0;0
25426;706;42;100;38;1;37;.974;3600000;0
25426;2246;42;0;0;0;0;.00nan;0;0
25426;2615;40;70;34;3;31;.912;3553000;0
25426;2954;40;0;0;0;0;.00nan;0;0
25352;896;43;79;25;1;24;.960;3600000;0
25352;1911;31;0;0;0;0;.00nan;0;0
25352;1988;43;0;0;0;0;.00nan;0;0
25352;2936;31;75;34;3;31;.912;3515000;0
25293;335;60;64;29;3;26;.897;3853000;0
25293;673;35;0;0;0;0;.00nan;0;0
25293;692;35;75;36;4;32;.889;3853000;0
25293;2192;60;0;0;0;0;.00nan;0;0
25258;430;56;0;0;0;0;.00nan;0;0
25258;534;38;47;25;4;21;.840;3600000;0
25258;1345;38;0;0;0;0;.00nan;0;0
25258;2081;56;89;39;3;36;.923;3600000;0
25334;352;45;77;38;4;34;.895;3576000;0
25334;1875;37;0;0;0;0;.00nan;0;0
25334;1934;45;0;0;0;0;.00nan;0;0
25334;2591;37;75;31;2;29;.935;3600000;0
25430;335;60;0;0;0;0;.00nan;0;0
25430;2033;51;0;0;0;0;.00nan;0;0
25430;2192;60;71;25;1;24;.960;3600000;0
25430;2940;51;82;42;4;38;.905;3600000;0
25431;485;36;71;27;2;25;.926;3567000;0
25431;599;36;0;0;0;0;.00nan;0;0
25431;1911;31;99;37;1;36;.973;3600000;0
25431;2936;31;0;0;0;0;.00nan;0;0
25280;35;59;100;33;0;33;1.000;3600000;0
25280;349;59;0;0;0;0;.00nan;0;0
25280;1458;61;0;0;0;0;.00nan;0;0
25280;1865;61;22;34;7;27;.794;3600000;0
25324;401;47;0;0;0;0;.00nan;0;0
25324;771;34;87;30;1;29;.967;3697000;0
25324;1002;34;0;0;0;0;.00nan;0;0
25324;1060;47;85;33;2;31;.939;3697000;0
25322;896;43;0;0;0;0;.00nan;0;0
25322;1988;43;82;36;2;34;.944;3600000;0
25322;2598;50;0;0;0;0;.00nan;0;0
25322;2751;50;72;31;4;27;.871;3544000;0
25294;923;32;64;38;4;34;.895;3600000;0
25294;992;32;0;0;0;0;.00nan;0;0
25294;2846;41;72;33;3;30;.909;3600000;0
25294;6353;41;0;0;0;0;.00nan;0;0
25325;346;46;0;0;0;0;.00nan;0;0
25325;778;54;0;0;0;0;.00nan;0;0
25325;2848;54;88;36;2;34;.944;3600000;0
25325;4916;46;39;31;5;26;.839;3600000;0
25351;673;35;59;44;6;38;.864;3600000;0
25351;692;35;0;0;0;0;.00nan;0;0
25351;1259;53;81;19;1;18;.947;3600000;0
25351;2538;53;0;0;0;0;.00nan;0;0
25364;815;55;0;0;0;0;.00nan;0;0
25364;1279;49;46;21;4;17;.810;3771000;0
25364;1311;55;60;35;5;30;.857;3771000;0
25364;2273;49;0;0;0;0;.00nan;0;0
25400;706;42;0;0;0;0;.00nan;0;0
25400;1234;39;0;0;0;0;.00nan;0;0
25400;1901;39;46;22;3;19;.864;3600000;0
25400;2246;42;38;30;5;25;.833;3542000;0
25395;401;47;63;20;2;18;.900;3679000;0
25395;427;54;69;21;1;20;.952;3679000;0
25395;1060;47;0;0;0;0;.00nan;0;0
25395;2625;52;0;0;0;0;.00nan;0;0
25397;1288;58;55;34;4;30;.882;3600000;0
25397;1875;37;0;0;0;0;.00nan;0;0
25397;2532;58;0;0;0;0;.00nan;0;0
25397;2591;37;64;30;3;27;.900;3600000;0
25261;534;38;43;24;4;20;.833;3533000;0
25261;1259;53;0;0;0;0;.00nan;0;0
25261;1345;38;0;0;0;0;.00nan;0;0
25261;2538;53;63;26;2;24;.923;3600000;0
25301;815;55;0;0;0;0;.00nan;0;0
25301;1311;55;100;21;0;21;1.000;3900000;0
25301;2846;41;97;26;0;26;1.000;3900000;0
25301;6353;41;0;0;0;0;.00nan;0;0
25372;923;32;100;31;0;31;1.000;3600000;0
25372;992;32;0;0;0;0;.00nan;0;0
25372;1458;61;0;0;0;0;.00nan;0;0
25372;1865;61;41;34;5;29;.853;3600000;0
25265;0;48;49;30;4;26;.867;3574000;0
25265;35;59;72;29;2;27;.931;3600000;0
25265;349;59;0;0;0;0;.00nan;0;0
25265;856;48;0;0;0;0;.00nan;0;0
25318;430;56;74;35;3;32;.914;3522000;0
25318;778;54;0;0;0;0;.00nan;0;0
25318;2081;56;0;0;0;0;.00nan;0;0
25318;2848;54;100;40;1;39;.975;3600000;0
25391;352;45;86;34;3;31;.912;3550000;0
25391;673;35;0;0;0;0;.00nan;0;0
25391;692;35;96;39;2;37;.949;3600000;0
25391;1934;45;0;0;0;0;.00nan;0;0
25402;1911;31;0;0;0;0;.00nan;0;0
25402;2598;50;0;0;0;0;.00nan;0;0
25402;2751;50;68;29;3;26;.897;3578000;0
25402;2936;31;100;39;2;37;.949;3600000;0
25272;534;38;57;22;3;19;.864;3577000;0
25272;1345;38;0;0;0;0;.00nan;0;0
25272;2033;51;94;38;1;37;.974;3600000;0
25272;2940;51;0;0;0;0;.00nan;0;0
25333;771;34;0;0;0;0;.00nan;0;0
25333;1002;34;67;26;2;24;.923;3600000;0
25333;1279;49;71;40;4;36;.900;3563000;0
25333;2273;49;0;0;0;0;.00nan;0;0
25499;593;57;77;40;3;37;.925;3600000;0
25499;706;42;95;40;2;38;.950;3600000;0
25499;907;57;0;0;0;0;.00nan;0;0
25499;2246;42;0;0;0;0;.00nan;0;0
25344;485;36;89;19;0;19;1.000;3600000;0
25344;599;36;0;0;0;0;.00nan;0;0
25344;2846;41;81;41;4;37;.902;3600000;0
25344;6353;41;0;0;0;0;.00nan;0;0
25420;401;47;0;0;0;0;.00nan;0;0
25420;1060;47;94;33;1;32;.970;3600000;0
25420;1259;53;75;35;3;32;.914;3590000;0
25420;2538;53;0;0;0;0;.00nan;0;0
25390;1458;61;20;32;8;24;.750;3156000;0
25390;1865;61;56;5;0;5;1.000;444000;0
25390;2615;40;61;20;2;18;.900;3600000;0
25390;2954;40;0;0;0;0;.00nan;0;0
25339;778;54;61;35;4;31;.886;3600000;0
25339;831;44;0;0;0;0;.00nan;0;0
25339;1085;44;100;34;0;34;1.000;3600000;0
25339;2848;54;0;0;0;0;.00nan;0;0
25320;0;48;0;0;0;0;.00nan;0;0
25320;771;34;66;33;3;30;.909;3557000;0
25320;856;48;100;44;2;42;.955;3600000;0
25320;1002;34;0;0;0;0;.00nan;0;0
25360;815;55;39;22;4;18;.818;3600000;0
25360;1279;49;100;35;0;35;1.000;3600000;0
25360;1311;55;0;0;0;0;.00nan;0;0
25360;2273;49;0;0;0;0;.00nan;0;0
25376;427;54;86;19;1;18;.947;3600000;0
25376;923;32;80;45;4;41;.911;3600000;0
25376;992;32;0;0;0;0;.00nan;0;0
25376;2625;52;0;0;0;0;.00nan;0;0
25332;430;56;0;0;0;0;.00nan;0;0
25332;1875;37;0;0;0;0;.00nan;0;0
25332;2081;56;89;34;2;32;.941;3600000;0
25332;2591;37;60;26;3;23;.885;3582000;0
25377;346;46;0;0;0;0;.00nan;0;0
25377;1016;33;0;0;0;0;.00nan;0;0
25377;3987;33;74;24;2;22;.917;3600000;0
25377;4916;46;59;21;3;18;.857;3600000;0
25602;335;60;80;34;2;32;.941;3600000;0
25602;593;57;57;25;3;22;.880;3574000;0
25602;907;57;0;0;0;0;.00nan;0;0
25602;2192;60;0;0;0;0;.00nan;0;0
25370;346;46;78;27;2;25;.926;3600000;0
25370;2033;51;0;0;0;0;.00nan;0;0
25370;2940;51;52;26;5;21;.808;3600000;0
25370;4916;46;0;0;0;0;.00nan;0;0
25406;1288;58;64;35;4;31;.886;3586000;0
25406;2532;58;0;0;0;0;.00nan;0;0
25406;2598;50;0;0;0;0;.00nan;0;0
25406;2751;50;61;20;2;18;.900;3600000;0
25357;896;43;37;28;5;23;.821;3600000;0
25357;1016;33;82;36;2;34;.944;3600000;0
25357;1988;43;0;0;0;0;.00nan;0;0
25357;3987;33;0;0;0;0;.00nan;0;0
25423;485;36;72;41;4;37;.902;3569000;0
25423;599;36;0;0;0;0;.00nan;0;0
25423;1234;39;0;0;0;0;.00nan;0;0
25423;1901;39;67;19;2;17;.895;3600000;0
25448;352;45;49;25;4;21;.840;3564000;0
25448;831;44;0;0;0;0;.00nan;0;0
25448;1085;44;61;23;3;20;.870;3600000;0
25448;1934;45;0;0;0;0;.00nan;0;0
25363;815;55;0;0;0;0;.00nan;0;0
25363;896;43;99;39;1;38;.974;3600000;0
25363;1311;55;54;23;3;20;.870;3584000;0
25363;1988;43;0;0;0;0;.00nan;0;0
25387;1016;33;0;0;0;0;.00nan;0;0
25387;2846;41;44;22;4;18;.818;3550000;0
25387;3987;33;92;34;2;32;.941;3600000;0
25387;6353;41;0;0;0;0;.00nan;0;0
25412;427;54;93;21;0;21;1.000;3900000;0
25412;831;44;0;0;0;0;.00nan;0;0
25412;1085;44;100;28;0;28;1.000;3900000;0
25412;2625;52;0;0;0;0;.00nan;0;0
25380;0;48;100;32;0;32;1.000;3600000;0
25380;401;47;0;0;0;0;.00nan;0;0
25380;856;48;0;0;0;0;.00nan;0;0
25380;1060;47;69;33;4;29;.879;3600000;0
25445;401;47;69;25;2;23;.920;3600000;0
25445;1060;47;0;0;0;0;.00nan;0;0
25445;1288;58;38;46;8;38;.826;3600000;0
25445;2532;58;0;0;0;0;.00nan;0;0
25371;673;35;0;0;0;0;.00nan;0;0
25371;692;35;89;32;1;31;.969;3600000;0
25371;1279;49;78;35;3;32;.914;3600000;0
25371;2273;49;0;0;0;0;.00nan;0;0
25368;1234;39;79;25;2;23;.920;3600000;0
25368;1901;39;0;0;0;0;.00nan;0;0
25368;2846;41;0;0;0;0;.00nan;0;0
25368;6353;41;85;56;5;51;.911;3600000;0
25304;35;59;57;27;3;24;.889;3600000;0
25304;349;59;0;0;0;0;.00nan;0;0
25304;430;56;20;25;6;19;.760;3600000;0
25304;2081;56;0;0;0;0;.00nan;0;0
25518;593;57;54;21;3;18;.857;3600000;0
25518;907;57;0;0;0;0;.00nan;0;0
25518;1458;61;0;0;0;0;.00nan;0;0
25518;1865;61;71;24;2;22;.917;3581000;0
25410;346;46;0;0;0;0;.00nan;0;0
25410;427;54;68;23;2;21;.913;3589000;0
25410;2625;52;0;0;0;0;.00nan;0;0
25410;4916;46;100;28;1;27;.964;3600000;0
25384;815;55;0;0;0;0;.00nan;0;0
25384;1311;55;64;20;2;18;.900;3600000;0
25384;2598;50;41;17;3;14;.824;3552000;0
25384;2751;50;0;0;0;0;.00nan;0;0
25539;923;32;81;28;1;27;.964;3600000;0
25539;992;32;0;0;0;0;.00nan;0;0
25539;2033;51;0;0;0;0;.00nan;0;0
25539;2940;51;71;36;3;33;.917;3517000;0
25639;335;60;74;28;2;26;.929;3559000;0
25639;352;45;74;22;1;21;.955;3600000;0
25639;1934;45;0;0;0;0;.00nan;0;0
25639;2192;60;0;0;0;0;.00nan;0;0
25425;1259;53;80;27;1;26;.963;3600000;0
25425;1875;37;0;0;0;0;.00nan;0;0
25425;2538;53;0;0;0;0;.00nan;0;0
25425;2591;37;69;34;3;31;.912;3579000;0
25342;778;54;0;0;0;0;.00nan;0;0
25342;896;43;0;0;0;0;.00nan;0;0
25342;1988;43;68;42;4;38;.905;3515000;0
25342;2848;54;73;26;2;24;.923;3600000;0
25449;0;48;100;41;1;40;.976;3600000;0
25449;856;48;0;0;0;0;.00nan;0;0
25449;2615;40;32;35;6;29;.829;3449000;0
25449;2954;40;48;0;0;0;.00nan;151000;0
25378;346;46;47;33;5;28;.848;3578000;0
25378;771;34;51;23;3;20;.870;3600000;0
25378;1002;34;0;0;0;0;.00nan;0;0
25378;4916;46;0;0;0;0;.00nan;0;0
25299;534;38;38;29;5;24;.828;3600000;0
25299;1234;39;0;0;0;0;.00nan;0;0
25299;1345;38;0;0;0;0;.00nan;0;0
25299;1901;39;91;37;2;35;.946;3600000;0
25335;430;56;0;0;0;0;.00nan;0;0
25335;1016;33;0;0;0;0;.00nan;0;0
25335;2081;56;49;43;5;38;.884;3600000;0
25335;3987;33;99;32;1;31;.969;3600000;0
25528;2033;51;100;30;0;30;1.000;3600000;0
25528;2615;40;0;0;0;0;.00nan;0;0
25528;2940;51;0;0;0;0;.00nan;0;0
25528;2954;40;68;22;1;21;.955;3600000;0
25413;401;47;0;0;0;0;.00nan;0;0
25413;1060;47;58;42;6;36;.857;3600000;0
25413;2598;50;0;0;0;0;.00nan;0;0
25413;2751;50;69;30;3;27;.900;3600000;0
25556;352;45;52;21;3;18;.857;3582000;0
25556;831;44;0;0;0;0;.00nan;0;0
25556;1085;44;87;35;2;33;.943;3600000;0
25556;1934;45;0;0;0;0;.00nan;0;0
25386;778;54;0;0;0;0;.00nan;0;0
25386;2846;41;99;40;1;39;.975;3762000;0
25386;2848;54;82;31;2;29;.935;3762000;0
25386;6353;41;0;0;0;0;.00nan;0;0
25385;771;34;0;0;0;0;.00nan;0;0
25385;815;55;0;0;0;0;.00nan;0;0
25385;1002;34;56;25;3;22;.880;3600000;0
25385;1311;55;58;42;5;37;.881;3567000;0
25443;593;57;85;35;2;33;.943;3900000;0
25443;907;57;0;0;0;0;.00nan;0;0
25443;1288;58;73;26;2;24;.923;3900000;0
25443;2532;58;0;0;0;0;.00nan;0;0
25399;706;42;67;29;3;26;.897;3580000;0
25399;923;32;71;23;1;22;.957;3600000;0
25399;992;32;0;0;0;0;.00nan;0;0
25399;2246;42;0;0;0;0;.00nan;0;0
25419;1875;37;0;0;0;0;.00nan;0;0
25419;1911;31;0;0;0;0;.00nan;0;0
25419;2591;37;91;25;1;24;.960;3600000;0
25419;2936;31;62;26;3;23;.885;3560000;0
25331;35;59;58;23;2;21;.913;3600000;0
25331;349;59;0;0;0;0;.00nan;0;0
25331;1458;61;0;0;0;0;.00nan;0;0
25331;1865;61;51;33;4;29;.879;3561000;0
25316;534;38;0;0;0;0;.00nan;0;0
25316;673;35;0;0;0;0;.00nan;0;0
25316;692;35;75;34;2;32;.941;3600000;0
25316;1345;38;56;28;4;24;.857;3565000;0
25461;335;60;90;43;2;41;.953;3900000;0
25461;401;47;91;39;2;37;.949;3895000;0
25461;1060;47;0;0;0;0;.00nan;0;0
25461;2192;60;0;0;0;0;.00nan;0;0
25514;352;45;0;0;0;0;.00nan;0;0
25514;593;57;0;0;0;0;.00nan;0;0
25514;907;57;63;28;4;24;.857;3600000;0
25514;1934;45;48;37;5;32;.865;3600000;0
25382;35;59;0;0;0;0;.00nan;0;0
25382;349;59;69;33;4;29;.879;3567000;0
25382;1259;53;89;36;3;33;.917;3600000;0
25382;2538;53;0;0;0;0;.00nan;0;0
25415;1234;39;61;16;1;15;.938;3600000;0
25415;1875;37;91;53;4;49;.925;3600000;0
25415;1901;39;0;0;0;0;.00nan;0;0
25415;2591;37;0;0;0;0;.00nan;0;0
25510;346;46;0;0;0;0;.00nan;0;0
25510;485;36;0;0;0;0;.00nan;0;0
25510;599;36;48;22;4;18;.818;3600000;0
25510;4916;46;49;35;5;30;.857;3558000;0
25551;706;42;0;0;0;0;.00nan;0;0
25551;831;44;45;39;6;33;.846;3900000;0
25551;1085;44;0;0;0;0;.00nan;0;0
25551;2246;42;53;35;6;29;.829;3866000;0
25533;1288;58;0;0;0;0;.00nan;0;0
25533;2532;58;67;27;2;25;.926;3546000;0
25533;2615;40;100;32;1;31;.969;3600000;0
25533;2954;40;0;0;0;0;.00nan;0;0
25398;673;35;73;23;2;21;.913;3600000;0
25398;692;35;0;0;0;0;.00nan;0;0
25398;1040;49;0;0;0;0;.00nan;0;0
25398;1279;49;70;33;3;30;.909;3558000;0
25486;923;32;0;0;0;0;.00nan;0;0
25486;992;32;75;36;3;33;.917;3900000;0
25486;2598;50;61;26;3;23;.885;3900000;0
25486;2751;50;0;0;0;0;.00nan;0;0
25508;335;60;0;0;0;0;.00nan;0;0
25508;485;36;73;36;3;33;.917;3600000;0
25508;599;36;0;0;0;0;.00nan;0;0
25508;2192;60;57;30;4;26;.867;3567000;0
25618;1458;61;0;0;0;0;.00nan;0;0
25618;1865;61;80;24;1;23;.958;3600000;0
25618;2033;51;66;41;5;36;.878;3600000;0
25618;2940;51;0;0;0;0;.00nan;0;0
25340;534;38;41;23;4;19;.826;3525000;0
25340;1259;53;0;0;0;0;.00nan;0;0
25340;1345;38;0;0;0;0;.00nan;0;0
25340;2538;53;74;28;2;26;.929;3600000;0
25429;0;48;60;27;3;24;.889;3568000;0
25429;778;54;0;0;0;0;.00nan;0;0
25429;856;48;0;0;0;0;.00nan;0;0
25429;2848;54;88;38;2;36;.947;3600000;0
25393;1016;33;0;0;0;0;.00nan;0;0
25393;1040;49;0;0;0;0;.00nan;0;0
25393;1279;49;62;40;5;35;.875;3581000;0
25393;3987;33;61;38;4;34;.895;3600000;0
25441;427;54;57;26;4;22;.846;3900000;0
25441;1911;31;0;0;0;0;.00nan;0;0
25441;2625;52;0;0;0;0;.00nan;0;0
25441;2936;31;74;45;4;41;.911;3900000;0
25341;430;56;81;27;1;26;.963;3600000;0
25341;1911;31;55;24;3;21;.875;3600000;0
25341;2081;56;0;0;0;0;.00nan;0;0
25341;2936;31;0;0;0;0;.00nan;0;0
25343;771;34;62;21;2;19;.905;3900000;0
25343;896;43;94;41;2;39;.951;3900000;0
25343;1002;34;0;0;0;0;.00nan;0;0
25343;1988;43;0;0;0;0;.00nan;0;0
25452;706;42;70;23;2;21;.913;3561000;0
25452;1288;58;93;34;1;33;.971;3600000;0
25452;2246;42;0;0;0;0;.00nan;0;0
25452;2532;58;0;0;0;0;.00nan;0;0
25542;1875;37;0;0;0;0;.00nan;0;0
25542;2591;37;86;33;3;30;.909;3600000;0
25542;2615;40;41;24;4;20;.833;3600000;0
25542;2954;40;0;0;0;0;.00nan;0;0
25365;430;56;0;0;0;0;.00nan;0;0
25365;2033;51;0;0;0;0;.00nan;0;0
25365;2081;56;81;46;4;42;.913;3600000;0
25365;2940;51;100;29;0;29;1.000;3600000;0
25437;771;34;0;0;0;0;.00nan;0;0
25437;1002;34;61;30;3;27;.900;3580000;0
25437;2846;41;83;35;2;33;.943;3600000;0
25437;6353;41;0;0;0;0;.00nan;0;0
25409;35;59;58;34;4;30;.882;3600000;0
25409;349;59;0;0;0;0;.00nan;0;0
25409;2598;50;0;0;0;0;.00nan;0;0
25409;2751;50;57;26;3;23;.885;3600000;0
25517;485;36;39;37;7;30;.811;3600000;0
25517;599;36;0;0;0;0;.00nan;0;0
25517;1234;39;0;0;0;0;.00nan;0;0
25517;1901;39;47;29;4;25;.862;3600000;0
25403;778;54;0;0;0;0;.00nan;0;0
25403;1040;49;0;0;0;0;.00nan;0;0
25403;1279;49;82;33;2;31;.939;3600000;0
25403;2848;54;82;25;1;24;.960;3600000;0
25394;896;43;76;25;2;23;.920;3600000;0
25394;1259;53;30;25;5;20;.800;3177000;0
25394;1988;43;0;0;0;0;.00nan;0;0
25394;2538;53;49;1;0;1;1.000;423000;0
25629;593;57;99;29;1;28;.966;3832000;0
25629;706;42;0;0;0;0;.00nan;0;0
25629;907;57;0;0;0;0;.00nan;0;0
25629;2246;42;88;37;2;35;.946;3832000;0
25590;335;60;63;18;2;16;.889;3600000;0
25590;401;47;51;1;0;1;1.000;52000;0
25590;1060;47;23;30;7;23;.767;3548000;0
25590;2192;60;0;0;0;0;.00nan;0;0
25492;35;59;0;0;0;0;.00nan;0;0
25492;349;59;82;26;1;25;.962;3600000;0
25492;2033;51;26;12;4;8;.667;620000;0
25492;2940;51;48;23;3;20;.870;2980000;0
25457;831;44;0;0;0;0;.00nan;0;0
25457;1085;44;58;21;3;18;.857;3600000;0
25457;1911;31;0;0;0;0;.00nan;0;0
25457;2936;31;60;35;4;31;.886;3569000;0
25422;835;40;0;0;0;0;.00nan;0;0
25422;1458;61;0;0;0;0;.00nan;0;0
25422;1865;61;69;22;1;21;.955;3600000;0
25422;2954;40;75;50;5;45;.900;3600000;0
25417;0;48;53;26;4;22;.846;3545000;0
25417;856;48;0;0;0;0;.00nan;0;0
25417;1016;33;0;0;0;0;.00nan;0;0
25417;3987;33;63;29;3;26;.897;3600000;0
25442;815;55;93;45;1;44;.978;3769000;0
25442;1046;52;0;0;0;0;.00nan;0;0
25442;1311;55;21;3;3;0;.000;131000;0
25442;2625;52;56;27;4;23;.852;3900000;0
25483;485;36;0;0;0;0;.00nan;0;0
25483;599;36;61;23;2;21;.913;3900000;0
25483;673;35;0;0;0;0;.00nan;0;0
25483;692;35;100;44;2;42;.955;3900000;0
25447;346;46;0;0;0;0;.00nan;0;0
25447;534;38;73;29;2;27;.931;3600000;0
25447;1345;38;0;0;0;0;.00nan;0;0
25447;4916;46;96;47;3;44;.936;3546000;0
25434;923;32;69;37;4;33;.892;3600000;0
25434;992;32;0;0;0;0;.00nan;0;0
25434;1875;37;27;21;5;16;.762;3563000;0
25434;2591;37;0;0;0;0;.00nan;0;0
25433;1234;39;79;24;2;22;.917;3600000;0
25433;1901;39;0;0;0;0;.00nan;0;0
25433;2598;50;56;47;6;41;.872;3600000;0
25433;2751;50;0;0;0;0;.00nan;0;0
25408;778;54;82;54;4;50;.926;3569000;0
25408;1016;33;59;18;2;16;.889;3600000;0
25408;2848;54;0;0;0;0;.00nan;0;0
25408;3987;33;0;0;0;0;.00nan;0;0
25424;0;48;0;0;0;0;.00nan;0;0
25424;430;56;64;35;4;31;.886;3600000;0
25424;856;48;69;17;1;16;.941;3600000;0
25424;2081;56;0;0;0;0;.00nan;0;0
25396;815;55;0;0;0;0;.00nan;0;0
25396;1288;58;45;29;4;25;.862;3600000;0
25396;1311;55;100;28;0;28;1.000;3600000;0
25396;2532;58;0;0;0;0;.00nan;0;0
25444;346;46;50;41;6;35;.854;3490000;0
25444;1259;53;0;0;0;0;.00nan;0;0
25444;2538;53;100;25;0;25;1.000;3600000;0
25444;4916;46;57;3;0;3;1.000;110000;0
25405;771;34;57;15;2;13;.867;3600000;0
25405;1002;34;0;0;0;0;.00nan;0;0
25405;1458;61;0;0;0;0;.00nan;0;0
25405;1865;61;80;42;3;39;.929;3560000;0
25475;673;35;0;0;0;0;.00nan;0;0
25475;692;35;96;35;1;34;.971;3600000;0
25475;1875;37;0;0;0;0;.00nan;0;0
25475;2591;37;79;35;3;32;.914;3600000;0
25469;1046;52;87;36;3;33;.917;3600000;0
25469;1911;31;43;22;4;18;.818;3600000;0
25469;2625;52;0;0;0;0;.00nan;0;0
25469;2936;31;0;0;0;0;.00nan;0;0
25456;35;59;0;0;0;0;.00nan;0;0
25456;349;59;69;19;1;18;.947;3600000;0
25456;923;32;33;37;7;30;.811;3600000;0
25456;992;32;0;0;0;0;.00nan;0;0
25427;593;57;67;42;4;38;.905;3543000;0
25427;907;57;0;0;0;0;.00nan;0;0
25427;1234;39;0;0;0;0;.00nan;0;0
25427;1901;39;50;23;3;20;.870;3600000;0
25438;1040;49;0;0;0;0;.00nan;0;0
25438;1279;49;100;37;2;35;.946;3900000;0
25438;2598;50;0;0;0;0;.00nan;0;0
25438;2751;50;81;38;2;36;.947;3900000;0
25346;430;56;0;0;0;0;.00nan;0;0
25346;534;38;73;32;2;30;.938;3542000;0
25346;1345;38;0;0;0;0;.00nan;0;0
25346;2081;56;79;28;1;27;.964;3600000;0
25411;593;57;0;0;0;0;.00nan;0;0
25411;778;54;0;0;0;0;.00nan;0;0
25411;907;57;70;27;2;25;.926;3600000;0
25411;2848;54;80;39;3;36;.923;3577000;0
25453;0;48;100;37;1;36;.973;3600000;0
25453;856;48;0;0;0;0;.00nan;0;0
25453;1259;53;0;0;0;0;.00nan;0;0
25453;2538;53;82;33;2;31;.939;3589000;0
25530;1288;58;37;30;6;24;.800;3600000;0
25530;1911;31;44;11;2;9;.818;1244000;0
25530;2532;58;0;0;0;0;.00nan;0;0
25530;2936;31;16;20;6;14;.700;2356000;0
25521;485;36;0;0;0;0;.00nan;0;0
25521;599;36;63;20;2;18;.900;3600000;0
25521;1458;61;74;46;4;42;.913;3576000;0
25521;1865;61;0;0;0;0;.00nan;0;0
25418;534;38;88;31;1;30;.968;3574000;0
25418;1016;33;0;0;0;0;.00nan;0;0
25418;1345;38;0;0;0;0;.00nan;0;0
25418;3987;33;100;25;0;25;1.000;3600000;0
25489;831;44;0;0;0;0;.00nan;0;0
25489;1085;44;88;36;3;33;.917;3600000;0
25489;2846;41;39;21;4;17;.810;3560000;0
25489;6353;41;0;0;0;0;.00nan;0;0
25455;346;46;0;0;0;0;.00nan;0;0
25455;896;43;45;27;4;23;.852;3565000;0
25455;1988;43;0;0;0;0;.00nan;0;0
25455;4916;46;86;38;2;36;.947;3600000;0
25511;401;47;72;23;2;21;.913;3701000;0
25511;831;44;69;32;3;29;.906;3701000;0
25511;1060;47;0;0;0;0;.00nan;0;0
25511;1085;44;0;0;0;0;.00nan;0;0
25485;352;45;53;37;5;32;.865;3600000;0
25485;673;35;0;0;0;0;.00nan;0;0
25485;692;35;88;28;1;27;.964;3600000;0
25485;1934;45;0;0;0;0;.00nan;0;0
25389;771;34;69;24;2;22;.917;3600000;0
25389;1002;34;0;0;0;0;.00nan;0;0
25389;2033;51;0;0;0;0;.00nan;0;0
25389;2940;51;43;24;4;20;.833;3527000;0
25484;1040;49;0;0;0;0;.00nan;0;0
25484;1279;49;57;11;1;10;.909;3600000;0
25484;2846;41;67;48;6;42;.875;3600000;0
25484;6353;41;0;0;0;0;.00nan;0;0
25491;352;45;0;0;0;0;.00nan;0;0
25491;1046;52;58;20;2;18;.900;3600000;0
25491;1934;45;64;34;4;30;.882;3515000;0
25491;2625;52;0;0;0;0;.00nan;0;0
25458;335;60;70;16;1;15;.938;3600000;0
25458;815;55;0;0;0;0;.00nan;0;0
25458;1311;55;75;46;5;41;.891;3600000;0
25458;2192;60;0;0;0;0;.00nan;0;0
25465;896;43;0;0;0;0;.00nan;0;0
25465;923;32;59;41;4;37;.902;3598000;0
25465;992;32;0;0;0;0;.00nan;0;0
25465;1988;43;41;19;3;16;.842;3600000;0
25471;534;38;70;39;5;34;.872;3600000;0
25471;1345;38;0;0;0;0;.00nan;0;0
25471;2598;50;66;8;0;8;1.000;536000;0
25471;2751;50;19;23;6;17;.739;3064000;0
25562;771;34;81;51;3;48;.941;3874000;0
25562;1002;34;0;0;0;0;.00nan;0;0
25562;1234;39;68;25;2;23;.920;3874000;0
25562;1901;39;0;0;0;0;.00nan;0;0
25515;485;36;55;32;4;28;.875;3600000;0
25515;599;36;0;0;0;0;.00nan;0;0
25515;1040;49;0;0;0;0;.00nan;0;0
25515;1279;49;92;28;1;27;.964;3600000;0
25494;35;59;82;31;2;29;.935;3600000;0
25494;349;59;0;0;0;0;.00nan;0;0
25494;706;42;59;24;3;21;.875;3569000;0
25494;2246;42;0;0;0;0;.00nan;0;0
25619;673;35;0;0;0;0;.00nan;0;0
25619;692;35;100;26;0;26;1.000;3600000;0
25619;1288;58;75;33;2;31;.939;3573000;0
25619;2532;58;0;0;0;0;.00nan;0;0
25519;427;54;86;28;1;27;.964;3900000;0
25519;778;54;0;0;0;0;.00nan;0;0
25519;2033;51;0;0;0;0;.00nan;0;0
25519;2940;51;83;29;1;28;.966;3900000;0
25466;346;46;0;0;0;0;.00nan;0;0
25466;815;55;71;45;4;41;.911;3524000;0
25466;1311;55;0;0;0;0;.00nan;0;0
25466;4916;46;82;31;2;29;.935;3600000;0
25451;430;56;97;35;1;34;.971;3551000;0
25451;835;40;0;0;0;0;.00nan;0;0
25451;2081;56;0;0;0;0;.00nan;0;0
25451;2954;40;100;33;0;33;1.000;3600000;0
25487;0;48;84;33;2;31;.939;3600000;0
25487;856;48;0;0;0;0;.00nan;0;0
25487;1046;52;0;0;0;0;.00nan;0;0
25487;2625;52;76;33;3;30;.909;3600000;0
25428;0;48;0;0;0;0;.00nan;0;0
25428;856;48;79;42;4;38;.905;3862000;0
25428;1016;33;0;0;0;0;.00nan;0;0
25428;3987;33;46;18;3;15;.833;3862000;0
25547;35;59;0;0;0;0;.00nan;0;0
25547;349;59;80;32;2;30;.938;3671000;0
25547;352;45;64;27;3;24;.889;3671000;0
25547;1934;45;0;0;0;0;.00nan;0;0
25446;346;46;97;38;1;37;.974;3600000;0
25446;430;56;0;0;0;0;.00nan;0;0
25446;2081;56;51;37;5;32;.865;3600000;0
25446;4916;46;0;0;0;0;.00nan;0;0
25421;427;54;0;0;0;0;.00nan;0;0
25421;534;38;0;0;0;0;.00nan;0;0
25421;778;54;82;40;3;37;.925;3600000;0
25421;1345;38;53;29;4;25;.862;3574000;0
25524;401;47;0;0;0;0;.00nan;0;0
25524;485;36;0;0;0;0;.00nan;0;0
25524;599;36;46;18;3;15;.833;3550000;0
25524;1060;47;100;36;1;35;.972;3600000;0
25504;896;43;77;25;2;23;.920;3600000;0
25504;1458;61;70;11;0;11;1.000;1087000;0
25504;1865;61;36;39;7;32;.821;2513000;0
25504;1988;43;0;0;0;0;.00nan;0;0
25525;835;40;0;0;0;0;.00nan;0;0
25525;2615;40;82;22;1;21;.955;3600000;0
25525;2846;41;77;25;2;23;.920;3547000;0
25525;6353;41;0;0;0;0;.00nan;0;0
25436;335;60;52;15;2;13;.867;3600000;0
25436;1259;53;75;33;3;30;.909;3543000;0
25436;2192;60;0;0;0;0;.00nan;0;0
25436;2538;53;0;0;0;0;.00nan;0;0
25488;593;57;49;28;4;24;.857;3550000;0
25488;907;57;0;0;0;0;.00nan;0;0
25488;923;32;78;28;2;26;.929;3600000;0
25488;992;32;0;0;0;0;.00nan;0;0
25513;1875;37;0;0;0;0;.00nan;0;0
25513;2033;51;91;40;2;38;.950;3600000;0
25513;2591;37;35;18;4;14;.778;3600000;0
25513;2940;51;0;0;0;0;.00nan;0;0
25473;673;35;0;0;0;0;.00nan;0;0
25473;692;35;92;50;4;46;.920;3600000;0
25473;2598;50;0;0;0;0;.00nan;0;0
25473;2751;50;69;19;1;18;.947;3600000;0
25463;831;44;0;0;0;0;.00nan;0;0
25463;1085;44;63;22;2;20;.909;3600000;0
25463;1259;53;0;0;0;0;.00nan;0;0
25463;2538;53;84;42;3;39;.929;3600000;0
25460;401;47;56;30;4;26;.867;3600000;0
25460;815;55;0;0;0;0;.00nan;0;0
25460;1060;47;0;0;0;0;.00nan;0;0
25460;1311;55;100;31;0;31;1.000;3600000;0
25468;35;59;0;0;0;0;.00nan;0;0
25468;349;59;59;23;3;20;.870;3581000;0
25468;430;56;91;42;1;41;.976;3600000;0
25468;2081;56;0;0;0;0;.00nan;0;0
25462;0;48;72;41;4;37;.902;3515000;0
25462;856;48;0;0;0;0;.00nan;0;0
25462;896;43;81;31;2;29;.935;3600000;0
25462;1988;43;0;0;0;0;.00nan;0;0
25529;346;46;0;0;0;0;.00nan;0;0
25529;706;42;92;38;2;36;.947;3600000;0
25529;2246;42;0;0;0;0;.00nan;0;0
25529;4916;46;71;27;3;24;.889;3565000;0
25464;335;60;53;34;4;30;.882;3600000;0
25464;1234;39;83;24;1;23;.958;3600000;0
25464;1901;39;0;0;0;0;.00nan;0;0
25464;2192;60;0;0;0;0;.00nan;0;0
25537;831;44;52;28;4;24;.857;3555000;0
25537;923;32;94;44;2;42;.955;3600000;0
25537;992;32;0;0;0;0;.00nan;0;0
25537;1085;44;0;0;0;0;.00nan;0;0
25540;427;54;46;35;6;29;.829;3184000;0
25540;485;36;59;32;4;28;.875;3600000;0
25540;599;36;0;0;0;0;.00nan;0;0
25540;778;54;45;6;1;5;.833;416000;0
25435;1016;33;0;0;0;0;.00nan;0;0
25435;1046;52;54;24;3;21;.875;2666000;0
25435;2625;52;24;13;4;9;.692;934000;0
25435;3987;33;64;19;2;17;.895;3600000;0
25538;593;57;32;25;5;20;.800;3600000;0
25538;907;57;0;0;0;0;.00nan;0;0
25538;2033;51;0;0;0;0;.00nan;0;0
25538;2940;51;87;37;2;35;.946;3600000;0
25544;673;35;44;32;5;27;.844;3600000;0
25544;692;35;0;0;0;0;.00nan;0;0
25544;1875;37;72;27;3;24;.889;3600000;0
25544;2591;37;0;0;0;0;.00nan;0;0
25481;1911;31;0;0;0;0;.00nan;0;0
25481;2598;50;31;14;4;10;.714;2162000;0
25481;2751;50;43;14;2;12;.857;1438000;0
25481;2936;31;100;32;0;32;1.000;3600000;0
25479;352;45;100;40;1;39;.975;3900000;0
25479;815;55;0;0;0;0;.00nan;0;0
25479;1311;55;96;34;1;33;.971;3900000;0
25479;1934;45;0;0;0;0;.00nan;0;0
25470;335;60;0;0;0;0;.00nan;0;0
25470;534;38;64;22;2;20;.909;3600000;0
25470;1345;38;0;0;0;0;.00nan;0;0
25470;2192;60;69;34;3;31;.912;3550000;0
25490;706;42;47;8;1;7;.875;1214000;0
25490;2246;42;37;34;6;28;.824;2386000;0
25490;2846;41;26;11;4;7;.636;1138000;0
25490;6353;41;75;17;0;17;1.000;2462000;0
25527;1234;39;0;0;0;0;.00nan;0;0
25527;1875;37;0;0;0;0;.00nan;0;0
25527;1901;39;59;17;2;15;.882;3600000;0
25527;2591;37;80;39;3;36;.923;3559000;0
25574;1040;49;0;0;0;0;.00nan;0;0
25574;1279;49;74;17;1;16;.941;3600000;0
25574;1911;31;0;0;0;0;.00nan;0;0
25574;2936;31;81;41;3;38;.927;3550000;0
25506;835;40;0;0;0;0;.00nan;0;0
25506;896;43;0;0;0;0;.00nan;0;0
25506;1988;43;54;27;4;23;.852;3610000;0
25506;2615;40;59;26;3;23;.885;3610000;0
25644;593;57;0;0;0;0;.00nan;0;0
25644;907;57;76;29;2;27;.931;3600000;0
25644;1458;61;58;34;4;30;.882;3539000;0
25644;1865;61;0;0;0;0;.00nan;0;0
25497;1016;33;64;28;3;25;.893;3816000;0
25497;1288;58;0;0;0;0;.00nan;0;0
25497;2532;58;88;36;2;34;.944;3816000;0
25497;3987;33;0;0;0;0;.00nan;0;0
25520;923;32;31;22;5;17;.773;3600000;0
25520;992;32;0;0;0;0;.00nan;0;0
25520;1288;58;88;41;2;39;.951;3600000;0
25520;2532;58;0;0;0;0;.00nan;0;0
25459;1046;52;69;28;3;25;.893;3551000;0
25459;1259;53;92;30;1;29;.967;3600000;0
25459;2538;53;0;0;0;0;.00nan;0;0
25459;2625;52;0;0;0;0;.00nan;0;0
25623;352;45;52;2;0;2;1.000;180000;0
25623;1934;45;33;49;9;40;.816;3420000;0
25623;2846;41;40;22;4;18;.818;3600000;0
25623;6353;41;0;0;0;0;.00nan;0;0
25531;401;47;79;37;3;34;.919;3600000;0
25531;771;34;0;0;0;0;.00nan;0;0
25531;1002;34;45;23;4;19;.826;3569000;0
25531;1060;47;0;0;0;0;.00nan;0;0
25554;831;44;0;0;0;0;.00nan;0;0
25554;1040;49;0;0;0;0;.00nan;0;0
25554;1085;44;93;31;1;30;.968;3900000;0
25554;1279;49;69;23;1;22;.957;3900000;0
25622;1458;61;0;0;0;0;.00nan;0;0
25622;1865;61;65;22;1;21;.955;3600000;0
25622;1911;31;28;30;6;24;.800;2828000;0
25622;2936;31;56;4;0;4;1.000;772000;0
25613;1234;39;76;35;4;31;.886;3554000;0
25613;1288;58;100;50;2;48;.960;3600000;0
25613;1901;39;0;0;0;0;.00nan;0;0
25613;2532;58;0;0;0;0;.00nan;0;0
25498;430;56;68;36;4;32;.889;3900000;0
25498;835;40;0;0;0;0;.00nan;0;0
25498;2081;56;0;0;0;0;.00nan;0;0
25498;2615;40;59;28;4;24;.857;3900000;0
25507;427;54;58;28;3;25;.893;3600000;0
25507;778;54;0;0;0;0;.00nan;0;0
25507;1259;53;99;24;0;24;1.000;3600000;0
25507;2538;53;0;0;0;0;.00nan;0;0
25482;815;55;0;0;0;0;.00nan;0;0
25482;1311;55;77;26;2;24;.923;3600000;0
25482;2033;51;0;0;0;0;.00nan;0;0
25482;2940;51;73;31;3;28;.903;3600000;0
25541;923;32;67;51;6;45;.882;3576000;0
25541;992;32;0;0;0;0;.00nan;0;0
25541;2846;41;0;0;0;0;.00nan;0;0
25541;6353;41;52;18;4;14;.778;3600000;0
25472;534;38;59;18;2;16;.889;3600000;0
25472;593;57;68;45;5;40;.889;3600000;0
25472;907;57;0;0;0;0;.00nan;0;0
25472;1345;38;0;0;0;0;.00nan;0;0
25576;346;46;0;0;0;0;.00nan;0;0
25576;771;34;83;48;4;44;.917;3569000;0
25576;1002;34;0;0;0;0;.00nan;0;0
25576;4916;46;66;26;3;23;.885;3600000;0
25571;352;45;60;4;0;4;1.000;420000;0
25571;1016;33;46;18;3;15;.833;3600000;0
25571;1934;45;32;34;6;28;.824;3180000;0
25571;3987;33;0;0;0;0;.00nan;0;0
25526;485;36;84;22;1;21;.955;3900000;0
25526;599;36;0;0;0;0;.00nan;0;0
25526;815;55;93;34;1;33;.971;3900000;0
25526;1311;55;0;0;0;0;.00nan;0;0
25503;923;32;0;0;0;0;.00nan;0;0
25503;992;32;74;18;1;17;.944;3600000;0
25503;1259;53;92;39;2;37;.949;3544000;0
25503;2538;53;0;0;0;0;.00nan;0;0
25577;346;46;82;40;3;37;.925;3850000;0
25577;2846;41;52;34;4;30;.882;3850000;0
25577;4916;46;0;0;0;0;.00nan;0;0
25577;6353;41;0;0;0;0;.00nan;0;0
25523;335;60;100;31;0;31;1.000;3600000;0
25523;831;44;0;0;0;0;.00nan;0;0
25523;1085;44;61;20;2;18;.900;3535000;0
25523;2192;60;0;0;0;0;.00nan;0;0
25501;534;38;55;29;4;25;.862;3600000;0
25501;771;34;0;0;0;0;.00nan;0;0
25501;1002;34;62;41;5;36;.878;3549000;0
25501;1345;38;0;0;0;0;.00nan;0;0
25568;427;54;0;0;0;0;.00nan;0;0
25568;778;54;75;39;3;36;.923;3600000;0
25568;1911;31;0;0;0;0;.00nan;0;0
25568;2936;31;99;39;1;38;.974;3600000;0
25548;35;59;0;0;0;0;.00nan;0;0
25548;349;59;67;22;2;20;.909;3600000;0
25548;1046;52;55;30;4;26;.867;3570000;0
25548;2625;52;0;0;0;0;.00nan;0;0
25516;0;48;28;31;6;25;.806;3490000;0
25516;401;47;50;27;4;23;.852;3600000;0
25516;856;48;49;1;0;1;1.000;79000;0
25516;1060;47;0;0;0;0;.00nan;0;0
25476;430;56;49;6;1;5;.833;574000;0
25476;1040;49;0;0;0;0;.00nan;0;0
25476;1279;49;34;16;4;12;.750;3600000;0
25476;2081;56;34;33;6;27;.818;3026000;0
25546;1288;58;0;0;0;0;.00nan;0;0
25546;1458;61;91;36;2;34;.944;3600000;0
25546;1865;61;0;0;0;0;.00nan;0;0
25546;2532;58;49;38;6;32;.842;3600000;0
25603;896;43;80;37;3;34;.919;3564000;0
25603;1875;37;0;0;0;0;.00nan;0;0
25603;1988;43;0;0;0;0;.00nan;0;0
25603;2591;37;75;24;1;23;.958;3600000;0
25601;831;44;69;19;2;17;.895;3578000;0
25601;1085;44;0;0;0;0;.00nan;0;0
25601;1911;31;77;23;1;22;.957;3600000;0
25601;2936;31;0;0;0;0;.00nan;0;0
25550;352;45;0;0;0;0;.00nan;0;0
25550;835;40;0;0;0;0;.00nan;0;0
25550;1934;45;81;38;3;35;.921;3600000;0
25550;2615;40;53;28;4;24;.857;3549000;0
25536;673;35;0;0;0;0;.00nan;0;0
25536;692;35;56;29;4;25;.862;3518000;0
25536;815;55;0;0;0;0;.00nan;0;0
25536;1311;55;68;25;2;23;.920;3600000;0
25543;706;42;32;36;7;29;.806;3600000;0
25543;1875;37;67;31;4;27;.871;3600000;0
25543;2246;42;0;0;0;0;.00nan;0;0
25543;2591;37;0;0;0;0;.00nan;0;0
25563;896;43;62;31;3;28;.903;3572000;0
25563;1040;49;0;0;0;0;.00nan;0;0
25563;1279;49;75;24;2;22;.917;3600000;0
25563;1988;43;0;0;0;0;.00nan;0;0
25553;485;36;100;27;0;27;1.000;3600000;0
25553;599;36;0;0;0;0;.00nan;0;0
25553;1046;52;0;0;0;0;.00nan;0;0
25553;2625;52;84;33;1;32;.970;3546000;0
25545;0;48;77;39;4;35;.897;3600000;0
25545;335;60;100;25;0;25;1.000;3600000;0
25545;856;48;0;0;0;0;.00nan;0;0
25545;2192;60;0;0;0;0;.00nan;0;0
25495;352;45;99;36;1;35;.972;3600000;0
25495;534;38;60;21;2;19;.905;3590000;0
25495;1345;38;0;0;0;0;.00nan;0;0
25495;1934;45;0;0;0;0;.00nan;0;0
25493;1259;53;0;0;0;0;.00nan;0;0
25493;1288;58;23;25;6;19;.760;2386000;0
25493;2532;58;41;10;2;8;.800;1214000;0
25493;2538;53;78;30;2;28;.933;3600000;0
25582;835;40;78;39;3;36;.923;3636000;0
25582;2598;50;0;0;0;0;.00nan;0;0
25582;2615;40;0;0;0;0;.00nan;0;0
25582;2751;50;70;22;2;20;.909;3636000;0
25583;771;34;85;14;0;14;1.000;3600000;0
25583;1002;34;0;0;0;0;.00nan;0;0
25583;2033;51;0;0;0;0;.00nan;0;0
25583;2940;51;84;43;3;40;.930;3600000;0
25477;401;47;73;16;1;15;.938;3600000;0
25477;430;56;0;0;0;0;.00nan;0;0
25477;1060;47;0;0;0;0;.00nan;0;0
25477;2081;56;75;31;2;29;.935;3556000;0
25608;1234;39;92;24;0;24;1.000;3600000;0
25608;1458;61;0;0;0;0;.00nan;0;0
25608;1865;61;98;43;1;42;.977;3600000;0
25608;1901;39;0;0;0;0;.00nan;0;0
25672;896;43;0;0;0;0;.00nan;0;0
25672;1988;43;38;19;4;15;.789;3561000;0
25672;2033;51;76;42;3;39;.929;3600000;0
25672;2940;51;0;0;0;0;.00nan;0;0
25496;335;60;79;33;2;31;.939;3600000;0
25496;427;54;96;37;1;36;.973;3600000;0
25496;778;54;0;0;0;0;.00nan;0;0
25496;2192;60;0;0;0;0;.00nan;0;0
25549;401;47;0;0;0;0;.00nan;0;0
25549;1060;47;73;23;1;22;.957;3600000;0
25549;2846;41;48;29;4;25;.862;3600000;0
25549;6353;41;0;0;0;0;.00nan;0;0
25532;673;35;100;40;2;38;.950;3900000;0
25532;692;35;0;0;0;0;.00nan;0;0
25532;706;42;0;0;0;0;.00nan;0;0
25532;2246;42;86;35;2;33;.943;3900000;0
25665;1016;33;0;0;0;0;.00nan;0;0
25665;1911;31;0;0;0;0;.00nan;0;0
25665;2936;31;99;47;1;46;.979;3600000;0
25665;3987;33;46;23;4;19;.826;3600000;0
25581;1046;52;62;30;3;27;.900;3600000;0
25581;1234;39;57;4;0;4;1.000;506000;0
25581;1901;39;13;18;6;12;.667;3094000;0
25581;2625;52;0;0;0;0;.00nan;0;0
25569;346;46;63;26;2;24;.923;3157000;0
25569;923;32;72;30;3;27;.900;3600000;0
25569;992;32;0;0;0;0;.00nan;0;0
25569;4916;46;39;13;3;10;.769;443000;0
25570;831;44;0;0;0;0;.00nan;0;0
25570;1085;44;67;25;2;23;.920;3600000;0
25570;1875;37;60;24;3;21;.875;3600000;0
25570;2591;37;0;0;0;0;.00nan;0;0
25565;485;36;86;37;2;35;.946;3807000;0
25565;599;36;0;0;0;0;.00nan;0;0
25565;2598;50;0;0;0;0;.00nan;0;0
25565;2751;50;95;31;1;30;.968;3796000;0
25555;35;59;77;25;2;23;.920;3600000;0
25555;349;59;0;0;0;0;.00nan;0;0
25555;673;35;0;0;0;0;.00nan;0;0
25555;692;35;70;33;3;30;.909;3589000;0
25564;706;42;0;0;0;0;.00nan;0;0
25564;1040;49;0;0;0;0;.00nan;0;0
25564;1279;49;100;24;0;24;1.000;3600000;0
25564;2246;42;78;28;2;26;.929;3557000;0
25557;401;47;83;26;2;24;.923;3600000;0
25557;427;54;69;44;4;40;.909;3600000;0
25557;778;54;0;0;0;0;.00nan;0;0
25557;1060;47;0;0;0;0;.00nan;0;0
25575;706;42;46;23;4;19;.826;3600000;0
25575;1911;31;0;0;0;0;.00nan;0;0
25575;2246;42;0;0;0;0;.00nan;0;0
25575;2936;31;78;19;1;18;.947;3600000;0
25584;430;56;100;35;0;35;1.000;3600000;0
25584;831;44;60;7;0;7;1.000;648000;0
25584;1085;44;84;31;1;30;.968;2935000;0
25584;2081;56;0;0;0;0;.00nan;0;0
25579;0;48;67;35;3;32;.914;3554000;0
25579;485;36;65;20;2;18;.900;3600000;0
25579;599;36;0;0;0;0;.00nan;0;0
25579;856;48;0;0;0;0;.00nan;0;0
25650;923;32;67;25;3;22;.880;3600000;0
25650;992;32;0;0;0;0;.00nan;0;0
25650;1458;61;13;13;5;8;.615;1541000;0
25650;1865;61;61;12;1;11;.917;2059000;0
25624;352;45;70;44;5;39;.886;3821000;0
25624;1016;33;49;30;4;26;.867;3821000;0
25624;1934;45;0;0;0;0;.00nan;0;0
25624;3987;33;0;0;0;0;.00nan;0;0
25647;835;40;0;0;0;0;.00nan;0;0
25647;2615;40;69;33;3;30;.909;3794000;0
25647;2846;41;57;34;4;30;.882;3794000;0
25647;6353;41;0;0;0;0;.00nan;0;0
25604;1875;37;0;0;0;0;.00nan;0;0
25604;2591;37;85;28;1;27;.964;3900000;0
25604;2598;50;0;0;0;0;.00nan;0;0
25604;2751;50;96;29;1;28;.966;3900000;0
25640;593;57;90;30;1;29;.967;3600000;0
25640;907;57;0;0;0;0;.00nan;0;0
25640;1288;58;33;27;5;22;.815;3600000;0
25640;2532;58;0;0;0;0;.00nan;0;0
25652;835;40;0;0;0;0;.00nan;0;0
25652;923;32;0;0;0;0;.00nan;0;0
25652;992;32;95;39;3;36;.923;3900000;0
25652;2615;40;55;22;3;19;.864;3900000;0
25586;485;36;0;0;0;0;.00nan;0;0
25586;599;36;62;18;1;17;.944;3600000;0
25586;1288;58;0;0;0;0;.00nan;0;0
25586;2532;58;66;41;4;37;.902;3600000;0
25589;401;47;0;0;0;0;.00nan;0;0
25589;1060;47;54;30;4;26;.867;3600000;0
25589;1458;61;0;0;0;0;.00nan;0;0
25589;1865;61;64;38;5;33;.868;3527000;0
25596;0;48;0;0;0;0;.00nan;0;0
25596;856;48;87;24;1;23;.958;3600000;0
25596;2846;41;0;0;0;0;.00nan;0;0
25596;6353;41;59;27;3;24;.889;3586000;0
25599;35;59;67;10;0;10;1.000;980000;0
25599;349;59;16;26;7;19;.731;2620000;0
25599;1040;49;17;15;5;10;.667;2983000;0
25599;1279;49;30;8;3;5;.625;562000;0
25573;1234;39;92;33;1;32;.970;3600000;0
25573;1259;53;0;0;0;0;.00nan;0;0
25573;1901;39;0;0;0;0;.00nan;0;0
25573;2538;53;52;25;4;21;.840;3600000;0
25621;815;55;0;0;0;0;.00nan;0;0
25621;1016;33;0;0;0;0;.00nan;0;0
25621;1311;55;96;44;1;43;.977;3600000;0
25621;3987;33;53;23;3;20;.870;3522000;0
25612;427;54;0;0;0;0;.00nan;0;0
25612;778;54;61;25;3;22;.880;3600000;0
25612;2598;50;55;30;4;26;.867;3581000;0
25612;2751;50;0;0;0;0;.00nan;0;0
25534;346;46;0;0;0;0;.00nan;0;0
25534;430;56;36;31;6;25;.806;2859000;0
25534;2081;56;53;3;0;3;1.000;741000;0
25534;4916;46;63;31;4;27;.871;3600000;0
25597;673;35;0;0;0;0;.00nan;0;0
25597;692;35;79;29;3;26;.897;3600000;0
25597;831;44;54;33;5;28;.848;3547000;0
25597;2916;44;0;0;0;0;.00nan;0;0
25572;534;38;65;34;3;31;.912;3515000;0
25572;1046;52;0;0;0;0;.00nan;0;0
25572;1345;38;0;0;0;0;.00nan;0;0
25572;2625;52;76;23;1;22;.957;3600000;0
25552;335;60;91;45;3;42;.933;3600000;0
25552;896;43;40;16;4;12;.750;3554000;0
25552;1988;43;0;0;0;0;.00nan;0;0
25552;2192;60;0;0;0;0;.00nan;0;0
25585;706;42;100;44;1;43;.977;3600000;0
25585;831;44;0;0;0;0;.00nan;0;0
25585;2246;42;0;0;0;0;.00nan;0;0
25585;2916;44;77;36;3;33;.917;3572000;0
25561;815;55;89;36;2;34;.944;3600000;0
25561;1040;49;0;0;0;0;.00nan;0;0
25561;1279;49;89;30;1;29;.967;3600000;0
25561;1311;55;0;0;0;0;.00nan;0;0
25631;427;54;0;0;0;0;.00nan;0;0
25631;778;54;54;33;5;28;.848;3600000;0
25631;1234;39;100;28;0;28;1.000;3600000;0
25631;1901;39;0;0;0;0;.00nan;0;0
25522;673;35;0;0;0;0;.00nan;0;0
25522;692;35;67;26;2;24;.923;3580000;0
25522;1259;53;0;0;0;0;.00nan;0;0
25522;2538;53;100;31;0;31;1.000;3600000;0
25628;401;47;84;26;1;25;.962;3600000;0
25628;923;32;27;7;3;4;.571;496000;0
25628;992;32;91;40;2;38;.950;3104000;0
25628;1060;47;0;0;0;0;.00nan;0;0
25605;35;59;45;23;4;19;.826;3600000;0
25605;349;59;0;0;0;0;.00nan;0;0
25605;1911;31;0;0;0;0;.00nan;0;0
25605;2936;31;57;58;8;50;.862;3600000;0
25609;771;34;97;52;1;51;.981;3900000;0
25609;1002;34;0;0;0;0;.00nan;0;0
25609;1046;52;73;13;1;12;.923;3900000;0
25609;2625;52;0;0;0;0;.00nan;0;0
25656;1458;61;15;23;6;17;.739;2613000;0
25656;1865;61;60;6;0;6;1.000;987000;0
25656;1875;37;0;0;0;0;.00nan;0;0
25656;2591;37;61;14;1;13;.929;3600000;0
25634;346;46;49;1;0;1;1.000;127000;0
25634;352;45;99;42;2;40;.952;3600000;0
25634;1934;45;0;0;0;0;.00nan;0;0
25634;4916;46;36;27;5;22;.815;3473000;0
25566;815;55;0;0;0;0;.00nan;0;0
25566;835;40;0;0;0;0;.00nan;0;0
25566;1311;55;87;41;2;39;.951;3544000;0
25566;2615;40;67;21;1;20;.952;3600000;0
25630;335;60;59;14;2;12;.857;3900000;0
25630;1911;31;81;42;2;40;.952;3900000;0
25630;2192;60;0;0;0;0;.00nan;0;0
25630;2936;31;0;0;0;0;.00nan;0;0
25637;771;34;0;0;0;0;.00nan;0;0
25637;1002;34;68;37;4;33;.892;3600000;0
25637;2598;50;0;0;0;0;.00nan;0;0
25637;2751;50;44;19;3;16;.842;3600000;0
25560;534;38;64;32;3;29;.906;3600000;0
25560;706;42;0;0;0;0;.00nan;0;0
25560;1345;38;0;0;0;0;.00nan;0;0
25560;2246;42;100;26;0;26;1.000;3600000;0
25627;346;46;23;4;3;1;.250;115000;0
25627;1875;37;72;30;2;28;.933;3600000;0
25627;2591;37;0;0;0;0;.00nan;0;0
25627;4916;46;93;32;1;31;.969;3484000;0
25588;0;48;52;32;5;27;.844;3527000;0
25588;430;56;51;20;3;17;.850;3600000;0
25588;856;48;0;0;0;0;.00nan;0;0
25588;2081;56;0;0;0;0;.00nan;0;0
25535;485;36;91;19;0;19;1.000;3600000;0
25535;599;36;0;0;0;0;.00nan;0;0
25535;1259;53;0;0;0;0;.00nan;0;0
25535;2538;53;76;33;3;30;.909;3600000;0
25606;534;38;46;29;4;25;.862;3600000;0
25606;1040;49;0;0;0;0;.00nan;0;0
25606;1279;49;83;29;1;28;.966;3600000;0
25606;1345;38;0;0;0;0;.00nan;0;0
25614;1234;39;47;33;5;28;.848;3600000;0
25614;1901;39;0;0;0;0;.00nan;0;0
25614;2846;41;89;36;2;34;.944;3600000;0
25614;6353;41;0;0;0;0;.00nan;0;0
25593;335;60;0;0;0;0;.00nan;0;0
25593;1046;52;78;26;2;24;.923;3600000;0
25593;2192;60;74;35;3;32;.914;3569000;0
25593;2625;52;0;0;0;0;.00nan;0;0
25677;1934;45;0;0;0;0;.00nan;0;0
25677;2834;29;96;32;1;31;.969;3600000;0
25677;2840;46;0;0;0;0;.00nan;0;0
25677;4916;46;69;43;4;39;.907;3600000;0
25679;1911;31;0;0;0;0;.00nan;0;0
25679;2079;44;0;0;0;0;.00nan;0;0
25679;2916;44;75;28;3;25;.893;3600000;0
25679;2936;31;53;39;5;34;.872;3567000;0
25681;1971;55;84;27;1;26;.963;3600000;0
25681;2033;51;77;48;4;44;.917;3600000;0
25681;2940;51;0;0;0;0;.00nan;0;0
25681;6540;55;0;0;0;0;.00nan;0;0
25683;692;35;89;30;1;29;.967;3600000;0
25683;2598;50;0;0;0;0;.00nan;0;0
25683;5398;50;73;44;4;40;.909;3600000;0
25683;5533;35;0;0;0;0;.00nan;0;0
25685;2358;38;0;0;0;0;.00nan;0;0
25685;3987;33;44;11;2;9;.818;1070000;0
25685;5880;38;79;21;2;19;.905;3600000;0
25685;5915;33;18;24;6;18;.750;2530000;0
25687;1042;36;86;23;2;21;.913;3600000;0
25687;1865;61;28;14;4;10;.714;1025000;0
25687;1890;61;69;23;2;21;.913;2575000;0
25687;2504;36;0;0;0;0;.00nan;0;0
25689;1820;58;0;0;0;0;.00nan;0;0
25689;2192;60;29;22;5;17;.773;3600000;0
25689;2532;58;100;55;1;54;.982;3600000;0
25689;2654;60;0;0;0;0;.00nan;0;0
25691;1002;34;72;24;2;22;.917;3600000;0
25691;2035;32;86;51;5;46;.902;3559000;0
25691;2458;32;0;0;0;0;.00nan;0;0
25691;6398;34;0;0;0;0;.00nan;0;0
25693;2273;49;0;0;0;0;.00nan;0;0
25693;4968;41;72;25;2;23;.920;3600000;0
25693;4972;49;43;27;4;23;.852;3575000;0
25693;6353;41;0;0;0;0;.00nan;0;0
25695;668;56;88;43;2;41;.953;3600000;0
25695;1234;39;0;0;0;0;.00nan;0;0
25695;1901;39;83;32;3;29;.906;3545000;0
25695;2081;56;0;0;0;0;.00nan;0;0
25697;1988;43;100;36;0;36;1.000;3600000;0
25697;2246;42;74;47;5;42;.894;3600000;0
25697;2878;42;0;0;0;0;.00nan;0;0
25697;6902;43;0;0;0;0;.00nan;0;0
25699;1694;57;50;32;5;27;.844;3564000;0
25699;2670;59;0;0;0;0;.00nan;0;0
25699;5791;59;72;40;3;37;.925;3600000;0
25699;6733;57;0;0;0;0;.00nan;0;0
25701;1875;37;75;28;3;25;.893;3600000;0
25701;2591;37;0;0;0;0;.00nan;0;0
25701;2615;40;72;42;4;38;.905;3562000;0
25701;2954;40;0;0;0;0;.00nan;0;0
25703;4839;54;0;0;0;0;.00nan;0;0
25703;4908;47;0;0;0;0;.00nan;0;0
25703;5881;47;62;16;2;14;.875;3600000;0
25703;7142;54;77;52;5;47;.904;3600000;0
25705;691;10;0;0;0;0;.00nan;0;0
25705;2538;53;47;38;6;32;.842;3600000;0
25705;2641;48;84;28;1;27;.964;3600000;0
25705;4977;48;0;0;0;0;.00nan;0;0
25707;668;56;71;45;4;41;.911;3583000;0
25707;1042;36;83;27;2;25;.926;3600000;0
25707;2081;56;0;0;0;0;.00nan;0;0
25707;5411;36;0;0;0;0;.00nan;0;0
25709;2079;44;27;21;5;16;.762;3600000;0
25709;2916;44;0;0;0;0;.00nan;0;0
25709;4839;54;90;40;2;38;.950;3600000;0
25709;7142;54;0;0;0;0;.00nan;0;0
25711;1988;43;90;23;1;22;.957;3900000;0
25711;2246;42;94;50;1;49;.980;3900000;0
25711;2878;42;0;0;0;0;.00nan;0;0
25711;6902;43;0;0;0;0;.00nan;0;0
25713;427;54;86;36;3;33;.917;3900000;0
25713;1875;37;0;0;0;0;.00nan;0;0
25713;2591;37;65;30;3;27;.900;3900000;0
25713;2625;52;0;0;0;0;.00nan;0;0
25715;1911;31;61;41;5;36;.878;3600000;0
25715;2615;40;0;0;0;0;.00nan;0;0
25715;2936;31;0;0;0;0;.00nan;0;0
25715;2954;40;22;35;7;28;.800;3540000;0
25717;1971;55;0;0;0;0;.00nan;0;0
25717;4968;41;0;0;0;0;.00nan;0;0
25717;6353;41;93;39;2;37;.949;3900000;0
25717;6540;55;62;26;2;24;.923;3900000;0
25719;1002;34;61;29;4;25;.862;3566000;0
25719;1694;57;0;0;0;0;.00nan;0;0
25719;6398;34;0;0;0;0;.00nan;0;0
25719;6733;57;67;23;2;21;.913;3600000;0
25721;692;35;51;38;5;33;.868;3600000;0
25721;2598;50;79;31;2;29;.935;3600000;0
25721;5398;50;0;0;0;0;.00nan;0;0
25721;5533;35;0;0;0;0;.00nan;0;0
25723;1934;45;0;0;0;0;.00nan;0;0
25723;2273;49;94;42;2;40;.952;3862000;0
25723;2834;29;67;22;1;21;.955;3862000;0
25723;4972;49;0;0;0;0;.00nan;0;0
25725;1820;58;0;0;0;0;.00nan;0;0
25725;2532;58;91;39;2;37;.949;3600000;0
25725;2840;46;68;13;0;13;1.000;2482000;0
25725;4916;46;28;13;4;9;.692;1085000;0
25727;2035;32;0;0;0;0;.00nan;0;0
25727;2358;38;49;10;2;8;.800;3600000;0
25727;2458;32;96;59;4;55;.932;3558000;0
25727;5880;38;0;0;0;0;.00nan;0;0
25729;691;10;0;0;0;0;.00nan;0;0
25729;2538;53;52;39;5;34;.872;3600000;0
25729;3987;33;78;34;2;32;.941;3600000;0
25729;5915;33;0;0;0;0;.00nan;0;0
25731;2033;51;32;28;6;22;.786;1948000;0
25731;2940;51;79;21;0;21;1.000;1652000;0
25731;4908;47;49;15;2;13;.867;3600000;0
25731;5881;47;0;0;0;0;.00nan;0;0
25733;1865;61;80;36;3;33;.917;3600000;0
25733;1890;61;0;0;0;0;.00nan;0;0
25733;2192;60;0;0;0;0;.00nan;0;0
25733;2654;60;49;27;4;23;.852;3600000;0
25735;1234;39;69;30;3;27;.900;3787000;0
25735;1901;39;0;0;0;0;.00nan;0;0
25735;2670;59;58;35;4;31;.886;3787000;0
25735;5791;59;0;0;0;0;.00nan;0;0
25737;1911;31;0;0;0;0;.00nan;0;0
25737;2079;44;0;0;0;0;.00nan;0;0
25737;2916;44;56;24;3;21;.875;3547000;0
25737;2936;31;75;21;1;20;.952;3600000;0
25739;1694;57;100;41;0;41;1.000;3600000;0
25739;2192;60;55;25;3;22;.880;3600000;0
25739;2654;60;0;0;0;0;.00nan;0;0
25739;6733;57;0;0;0;0;.00nan;0;0
25741;2246;42;0;0;0;0;.00nan;0;0
25741;2878;42;63;24;2;22;.917;3600000;0
25741;4839;54;0;0;0;0;.00nan;0;0
25741;7142;54;40;32;5;27;.844;3600000;0
25743;427;54;0;0;0;0;.00nan;0;0
25743;2625;52;98;22;0;22;1.000;3600000;0
25743;2840;46;0;0;0;0;.00nan;0;0
25743;4916;46;92;56;4;52;.929;3600000;0
25745;2358;38;0;0;0;0;.00nan;0;0
25745;4908;47;0;0;0;0;.00nan;0;0
25745;5880;38;48;19;3;16;.842;3600000;0
25745;5881;47;59;35;4;31;.886;3600000;0
25747;691;10;89;45;3;42;.933;3600000;0
25747;2538;53;0;0;0;0;.00nan;0;0
25747;2670;59;0;0;0;0;.00nan;0;0
25747;5791;59;100;29;0;29;1.000;3600000;0
25749;1042;36;0;0;0;0;.00nan;0;0
25749;1971;55;79;32;2;30;.938;3600000;0
25749;5411;36;38;20;4;16;.800;3600000;0
25749;6540;55;0;0;0;0;.00nan;0;0
25751;1934;45;69;17;1;16;.941;3600000;0
25751;2035;32;79;39;3;36;.923;3551000;0
25751;2458;32;0;0;0;0;.00nan;0;0
25751;2834;29;0;0;0;0;.00nan;0;0
25753;1820;58;61;31;4;27;.871;3543000;0
25753;1988;43;0;0;0;0;.00nan;0;0
25753;6902;43;63;28;3;25;.893;3600000;0
25753;7250;58;0;0;0;0;.00nan;0;0
25755;1865;61;0;0;0;0;.00nan;0;0
25755;1890;61;100;29;0;29;1.000;3600000;0
25755;2598;50;42;4;1;3;.750;135000;0
25755;5398;50;56;30;4;26;.867;3465000;0
25757;692;35;0;0;0;0;.00nan;0;0
25757;1234;39;50;1;0;1;1.000;405000;0
25757;1901;39;17;30;7;23;.767;3195000;0
25757;5533;35;74;38;4;34;.895;3600000;0
25759;2033;51;0;0;0;0;.00nan;0;0
25759;2273;49;51;10;1;9;.900;1487000;0
25759;2940;51;86;27;2;25;.926;3600000;0
25759;4972;49;17;23;6;17;.739;2113000;0
25761;1002;34;0;0;0;0;.00nan;0;0
25761;2615;40;84;28;2;26;.929;3600000;0
25761;2954;40;0;0;0;0;.00nan;0;0
25761;6398;34;54;45;6;39;.867;3600000;0
25763;668;56;0;0;0;0;.00nan;0;0
25763;2081;56;100;48;3;45;.938;3653000;0
25763;2641;48;75;38;4;34;.895;3653000;0
25763;4977;48;0;0;0;0;.00nan;0;0
25765;3987;33;0;0;0;0;.00nan;0;0
25765;4968;41;60;40;5;35;.875;3582000;0
25765;5915;33;57;33;4;29;.879;3600000;0
25765;6353;41;0;0;0;0;.00nan;0;0
25767;668;56;66;30;3;27;.900;3610000;0
25767;2081;56;0;0;0;0;.00nan;0;0
25767;4908;47;65;28;4;24;.857;3605000;0
25767;5881;47;0;0;0;0;.00nan;0;0
25769;1820;58;44;13;2;11;.846;986000;0
25769;2079;44;33;27;6;21;.778;3600000;0
25769;2916;44;0;0;0;0;.00nan;0;0
25769;7250;58;44;39;6;33;.846;2557000;0
25771;2192;60;0;0;0;0;.00nan;0;0
25771;2654;60;56;29;3;26;.897;3600000;0
25771;2670;59;58;5;0;5;1.000;360000;0
25771;5791;59;25;39;7;32;.821;3240000;0
25773;1934;45;0;0;0;0;.00nan;0;0
25773;1971;55;0;0;0;0;.00nan;0;0
25773;2834;29;85;38;2;36;.947;3900000;0
25773;6540;55;52;23;2;21;.913;3900000;0
25775;2273;49;83;36;2;34;.944;3600000;0
25775;2615;40;66;36;4;32;.889;3600000;0
25775;2954;40;0;0;0;0;.00nan;0;0
25775;4972;49;0;0;0;0;.00nan;0;0
25777;1002;34;0;0;0;0;.00nan;0;0
25777;4839;54;53;34;4;30;.882;3560000;0
25777;6398;34;55;27;3;24;.889;3600000;0
25777;7142;54;0;0;0;0;.00nan;0;0
25779;691;10;0;0;0;0;.00nan;0;0
25779;2538;53;84;33;2;31;.939;3600000;0
25779;2641;48;0;0;0;0;.00nan;0;0
25779;4977;48;42;34;5;29;.853;3600000;0
25781;1875;37;0;0;0;0;.00nan;0;0
25781;1911;31;0;0;0;0;.00nan;0;0
25781;2591;37;53;17;2;15;.882;3600000;0
25781;2936;31;41;35;6;29;.829;3600000;0
25783;1988;43;53;29;4;25;.862;3600000;0
25783;2598;50;0;0;0;0;.00nan;0;0
25783;5398;50;63;44;5;39;.886;3572000;0
25783;6902;43;0;0;0;0;.00nan;0;0
25785;1234;39;58;8;0;8;1.000;856000;0
25785;1694;57;93;18;0;18;1.000;3600000;0
25785;1901;39;30;30;6;24;.800;2744000;0
25785;6733;57;0;0;0;0;.00nan;0;0
25787;1042;36;40;28;5;23;.821;3600000;0
25787;2246;42;49;42;6;36;.857;3205000;0
25787;2878;42;26;11;4;7;.636;395000;0
25787;5411;36;0;0;0;0;.00nan;0;0
25789;1865;61;50;0;0;0;.00nan;30000;0
25789;1890;61;63;53;6;47;.887;3570000;0
25789;2358;38;69;27;2;25;.926;3600000;0
25789;5880;38;0;0;0;0;.00nan;0;0
25791;692;35;29;29;6;23;.793;2494000;0
25791;4968;41;0;0;0;0;.00nan;0;0
25791;5533;35;50;6;1;5;.833;1072000;0
25791;6353;41;49;35;5;30;.857;3600000;0
25793;2035;32;0;0;0;0;.00nan;0;0
25793;2458;32;92;30;2;28;.933;3900000;0
25793;3987;33;74;34;2;32;.941;3896000;0
25793;5915;33;0;0;0;0;.00nan;0;0
25795;2033;51;78;33;3;30;.909;3600000;0
25795;2840;46;46;40;6;34;.850;3393000;0
25795;2940;51;0;0;0;0;.00nan;0;0
25795;4916;46;50;1;0;1;1.000;207000;0
25797;2273;49;0;0;0;0;.00nan;0;0
25797;2641;48;94;33;1;32;.970;3600000;0
25797;4972;49;39;30;4;26;.867;3600000;0
25797;4977;48;0;0;0;0;.00nan;0;0
25799;668;56;0;0;0;0;.00nan;0;0
25799;1934;45;71;40;4;36;.900;3600000;0
25799;2081;56;40;32;5;27;.844;3553000;0
25799;2834;29;0;0;0;0;.00nan;0;0
25801;1875;37;76;24;1;23;.958;3600000;0
25801;1971;55;68;35;3;32;.914;3521000;0
25801;2591;37;0;0;0;0;.00nan;0;0
25801;6540;55;0;0;0;0;.00nan;0;0
25803;691;10;60;43;5;38;.884;3563000;0
25803;2538;53;0;0;0;0;.00nan;0;0
25803;4968;41;62;30;4;26;.867;3600000;0
25803;6353;41;0;0;0;0;.00nan;0;0
25805;1865;61;72;29;3;26;.897;3600000;0
25805;1890;61;0;0;0;0;.00nan;0;0
25805;4908;47;0;0;0;0;.00nan;0;0
25805;5881;47;70;47;5;42;.894;3579000;0
25807;2033;51;0;0;0;0;.00nan;0;0
25807;2358;38;0;0;0;0;.00nan;0;0
25807;2940;51;82;39;3;36;.923;3600000;0
25807;5880;38;54;15;2;13;.867;3600000;0
25809;1042;36;0;0;0;0;.00nan;0;0
25809;1694;57;60;39;4;35;.897;3600000;0
25809;5411;36;68;20;2;18;.900;3600000;0
25809;6733;57;0;0;0;0;.00nan;0;0
25811;2246;42;0;0;0;0;.00nan;0;0
25811;2598;50;54;20;3;17;.850;3900000;0
25811;2878;42;91;49;3;46;.939;3900000;0
25811;5398;50;0;0;0;0;.00nan;0;0
25813;1002;34;91;47;2;45;.957;3576000;0
25813;2079;44;0;0;0;0;.00nan;0;0
25813;2916;44;66;18;1;17;.944;3600000;0
25813;6398;34;0;0;0;0;.00nan;0;0
25815;1988;43;0;0;0;0;.00nan;0;0
25815;4839;54;0;0;0;0;.00nan;0;0
25815;6902;43;81;31;2;29;.935;3600000;0
25815;7142;54;93;46;3;43;.935;3546000;0
25817;2192;60;69;16;1;15;.938;3600000;0
25817;2654;60;0;0;0;0;.00nan;0;0
25817;2840;46;0;0;0;0;.00nan;0;0
25817;4916;46;57;45;5;40;.889;3600000;0
25819;692;35;0;0;0;0;.00nan;0;0
25819;2615;40;0;0;0;0;.00nan;0;0
25819;2954;40;83;39;3;36;.923;3600000;0
25819;5533;35;63;37;4;33;.892;3546000;0
25821;427;54;0;0;0;0;.00nan;0;0
25821;1911;31;70;44;4;40;.909;3572000;0
25821;2625;52;83;32;2;30;.938;3600000;0
25821;2936;31;0;0;0;0;.00nan;0;0
25823;2670;59;58;28;4;24;.857;3600000;0
25823;3987;33;0;0;0;0;.00nan;0;0
25823;5791;59;0;0;0;0;.00nan;0;0
25823;5915;33;81;40;2;38;.950;3600000;0
25825;1234;39;45;16;3;13;.813;3600000;0
25825;1901;39;0;0;0;0;.00nan;0;0
25825;2035;32;81;54;5;49;.907;3543000;0
25825;2458;32;0;0;0;0;.00nan;0;0
25827;1820;58;0;0;0;0;.00nan;0;0
25827;1971;55;60;19;2;17;.895;3600000;0
25827;6540;55;0;0;0;0;.00nan;0;0
25827;7250;58;80;40;4;36;.900;3595000;0
25829;1694;57;0;0;0;0;.00nan;0;0
25829;2033;51;33;21;4;17;.810;873000;0
25829;2940;51;90;33;1;32;.970;2681000;0
25829;6733;57;62;29;3;26;.897;3600000;0
25831;4839;54;86;46;4;42;.913;3900000;0
25831;4968;41;0;0;0;0;.00nan;0;0
25831;6353;41;29;23;4;19;.826;3900000;0
25831;7142;54;0;0;0;0;.00nan;0;0
25833;2035;32;99;41;1;40;.976;3600000;0
25833;2458;32;0;0;0;0;.00nan;0;0
25833;4908;47;48;21;3;18;.857;3525000;0
25833;5881;47;0;0;0;0;.00nan;0;0
25835;668;56;0;0;0;0;.00nan;0;0
25835;2081;56;93;34;1;33;.971;3600000;0
25835;2615;40;52;26;3;23;.885;3515000;0
25835;2954;40;0;0;0;0;.00nan;0;0
25837;2079;44;0;0;0;0;.00nan;0;0
25837;2641;48;0;0;0;0;.00nan;0;0
25837;2916;44;82;43;4;39;.907;3600000;0
25837;4977;48;96;39;1;38;.974;3600000;0
25839;1002;34;0;0;0;0;.00nan;0;0
25839;1911;31;61;14;1;13;.929;3600000;0
25839;2936;31;0;0;0;0;.00nan;0;0
25839;6398;34;58;20;2;18;.900;3600000;0
25841;1042;36;55;20;2;18;.900;3600000;0
25841;2598;50;78;54;5;49;.907;3600000;0
25841;5398;50;0;0;0;0;.00nan;0;0
25841;5411;36;0;0;0;0;.00nan;0;0
25843;1865;61;36;19;4;15;.789;3546000;0
25843;1890;61;0;0;0;0;.00nan;0;0
25843;2273;49;81;41;3;38;.927;3600000;0
25843;4972;49;0;0;0;0;.00nan;0;0
25845;2246;42;78;32;2;30;.938;3769000;0
25845;2670;59;0;0;0;0;.00nan;0;0
25845;2878;42;0;0;0;0;.00nan;0;0
25845;5791;59;72;35;3;32;.914;3769000;0
25847;427;54;57;21;3;18;.857;3537000;0
25847;2625;52;0;0;0;0;.00nan;0;0
25847;2840;46;94;38;1;37;.974;3600000;0
25847;4916;46;0;0;0;0;.00nan;0;0
25849;1875;37;0;0;0;0;.00nan;0;0
25849;1988;43;100;35;0;35;1.000;3600000;0
25849;2591;37;68;34;3;31;.912;3600000;0
25849;6902;43;0;0;0;0;.00nan;0;0
25851;1234;39;0;0;0;0;.00nan;0;0
25851;1901;39;83;31;2;29;.935;3600000;0
25851;1934;45;0;0;0;0;.00nan;0;0
25851;2834;29;59;27;3;24;.889;3594000;0
25853;691;10;100;39;0;39;1.000;3600000;0
25853;2192;60;98;38;1;37;.974;3572000;0
25853;2538;53;0;0;0;0;.00nan;0;0
25853;2654;60;0;0;0;0;.00nan;0;0
25855;692;35;84;28;1;27;.964;3600000;0
25855;3987;33;71;32;2;30;.938;3600000;0
25855;5533;35;0;0;0;0;.00nan;0;0
25855;5915;33;0;0;0;0;.00nan;0;0
25857;1875;37;100;21;0;21;1.000;3600000;0
25857;2246;42;54;4;0;4;1.000;473000;0
25857;2591;37;0;0;0;0;.00nan;0;0
25857;2878;42;46;40;6;34;.850;3127000;0
25859;2615;40;0;0;0;0;.00nan;0;0
25859;2641;48;84;47;4;43;.915;3551000;0
25859;2954;40;66;25;2;23;.920;3600000;0
25859;4977;48;0;0;0;0;.00nan;0;0
25861;1002;34;25;5;3;2;.400;278000;0
25861;1694;57;57;31;4;27;.871;3600000;0
25861;6398;34;49;36;5;31;.861;3322000;0
25861;6733;57;0;0;0;0;.00nan;0;0
25863;2273;49;0;0;0;0;.00nan;0;0
25863;4839;54;0;0;0;0;.00nan;0;0
25863;4972;49;56;24;3;21;.875;3600000;0
25863;7142;54;65;51;5;46;.902;3581000;0
25865;1042;36;46;4;1;3;.750;450000;0
25865;4968;41;52;34;5;29;.853;3600000;0
25865;5411;36;17;23;6;17;.739;3064000;0
25865;6353;41;0;0;0;0;.00nan;0;0
25867;692;35;0;0;0;0;.00nan;0;0
25867;2033;51;92;47;2;45;.957;3900000;0
25867;2940;51;0;0;0;0;.00nan;0;0
25867;5533;35;84;35;2;33;.943;3900000;0
25869;1934;45;74;34;2;32;.941;3565000;0
25869;2834;29;0;0;0;0;.00nan;0;0
25869;4908;47;0;0;0;0;.00nan;0;0
25869;5881;47;79;27;1;26;.963;3600000;0
25871;1234;39;65;37;4;33;.892;3897000;0
25871;1901;39;0;0;0;0;.00nan;0;0
25871;2192;60;0;0;0;0;.00nan;0;0
25871;2654;60;86;41;3;38;.927;3897000;0
25873;668;56;88;29;1;28;.966;3900000;0
25873;1988;43;83;23;1;22;.957;3900000;0
25873;2081;56;0;0;0;0;.00nan;0;0
25873;6902;43;0;0;0;0;.00nan;0;0
25875;691;10;78;19;1;18;.947;3600000;0
25875;2035;32;50;0;0;0;.00nan;8000;0
25875;2458;32;70;59;7;52;.881;3592000;0
25875;2538;53;0;0;0;0;.00nan;0;0
25877;1911;31;0;0;0;0;.00nan;0;0
25877;2670;59;52;30;4;26;.867;3600000;0
25877;2936;31;100;26;0;26;1.000;3600000;0
25877;5791;59;0;0;0;0;.00nan;0;0
25879;1971;55;0;0;0;0;.00nan;0;0
25879;3987;33;0;0;0;0;.00nan;0;0
25879;5915;33;63;38;4;34;.895;3600000;0
25879;6540;55;100;24;0;24;1.000;3600000;0
25881;427;54;0;0;0;0;.00nan;0;0
25881;2598;50;52;3;0;3;1.000;174000;0
25881;2625;52;93;21;0;21;1.000;3600000;0
25881;5398;50;59;49;6;43;.878;3426000;0
25883;1865;61;0;0;0;0;.00nan;0;0
25883;1890;61;56;20;2;18;.900;3600000;0
25883;2840;46;46;28;4;24;.857;3117000;0
25883;4916;46;32;12;3;9;.750;483000;0
25885;1820;58;78;35;4;31;.886;3600000;0
25885;2079;44;47;37;6;31;.838;2828000;0
25885;2916;44;57;3;0;3;1.000;762000;0
25885;7250;58;0;0;0;0;.00nan;0;0
28346;831;44;0;0;0;0;.00nan;0;0
28346;1085;44;75;40;4;36;.900;4175000;0
28346;1234;39;72;43;3;40;.930;4175000;0
28346;1901;39;0;0;0;0;.00nan;0;0
28347;35;59;94;38;2;36;.947;3600000;0
28347;349;59;0;0;0;0;.00nan;0;0
28347;1016;33;0;0;0;0;.00nan;0;0
28347;3987;33;42;26;4;22;.846;3522000;0
28348;534;38;43;29;4;25;.862;3515000;0
28348;835;40;0;0;0;0;.00nan;0;0
28348;1345;38;0;0;0;0;.00nan;0;0
28348;2615;40;77;29;2;27;.931;3600000;0
28349;1040;49;0;0;0;0;.00nan;0;0
28349;1279;49;95;33;1;32;.970;3662000;0
28349;2846;41;83;28;2;26;.929;3662000;0
28349;6353;41;0;0;0;0;.00nan;0;0
28350;335;60;65;22;2;20;.909;3556000;0
28350;346;46;0;0;0;0;.00nan;0;0
28350;2192;60;0;0;0;0;.00nan;0;0
28350;4916;46;100;45;1;44;.978;3600000;0
28351;485;36;31;27;6;21;.778;2868000;0
28351;599;36;54;4;0;4;1.000;732000;0
28351;2598;50;0;0;0;0;.00nan;0;0
28351;2751;50;65;32;3;29;.906;3600000;0
28352;771;34;90;38;3;35;.921;3549000;0
28352;1002;34;0;0;0;0;.00nan;0;0
28352;1046;52;74;21;1;20;.952;3600000;0
28352;2625;52;0;0;0;0;.00nan;0;0
28353;593;57;28;24;6;18;.750;3278000;0
28353;907;57;57;3;0;3;1.000;322000;0
28353;1259;53;46;6;1;5;.833;974000;0
28353;2538;53;16;20;6;14;.700;2626000;0
28354;831;44;0;0;0;0;.00nan;0;0
28354;1085;44;46;32;5;27;.844;3600000;0
28354;1234;39;100;26;0;26;1.000;3600000;0
28354;1901;39;0;0;0;0;.00nan;0;0
28355;35;59;100;48;2;46;.958;4405000;0
28355;349;59;0;0;0;0;.00nan;0;0
28355;1016;33;0;0;0;0;.00nan;0;0
28355;3987;33;64;28;3;25;.893;4405000;0
28356;534;38;67;32;3;29;.906;3551000;0
28356;835;40;0;0;0;0;.00nan;0;0
28356;1345;38;0;0;0;0;.00nan;0;0
28356;2615;40;80;29;2;27;.931;3600000;0
28357;1040;49;0;0;0;0;.00nan;0;0
28357;1279;49;81;28;2;26;.929;3600000;0
28357;2846;41;78;39;4;35;.897;3578000;0
28357;6353;41;0;0;0;0;.00nan;0;0
28358;335;60;79;33;2;31;.939;4010000;0
28358;346;46;0;0;0;0;.00nan;0;0
28358;2192;60;0;0;0;0;.00nan;0;0
28358;4916;46;82;26;1;25;.962;4010000;0
28359;485;36;99;24;0;24;1.000;3600000;0
28359;599;36;0;0;0;0;.00nan;0;0
28359;2598;50;51;2;0;2;1.000;446000;0
28359;2751;50;31;27;6;21;.778;3154000;0
28360;771;34;59;34;4;30;.882;3556000;0
28360;1002;34;0;0;0;0;.00nan;0;0
28360;1046;52;83;42;3;39;.929;3600000;0
28360;2625;52;0;0;0;0;.00nan;0;0
28361;593;57;82;37;4;33;.892;3587000;0
28361;907;57;0;0;0;0;.00nan;0;0
28361;1259;53;76;28;2;26;.929;3600000;0
28361;2538;53;0;0;0;0;.00nan;0;0
28362;831;44;0;0;0;0;.00nan;0;0
28362;1085;44;91;30;1;29;.967;3600000;0
28362;1234;39;71;41;4;37;.902;3600000;0
28362;1901;39;0;0;0;0;.00nan;0;0
28363;35;59;72;29;2;27;.931;3600000;0
28363;349;59;0;0;0;0;.00nan;0;0
28363;1016;33;0;0;0;0;.00nan;0;0
28363;3987;33;70;29;3;26;.897;3575000;0
28364;534;38;83;31;2;29;.935;3600000;0
28364;835;40;0;0;0;0;.00nan;0;0
28364;1345;38;0;0;0;0;.00nan;0;0
28364;2615;40;66;31;3;28;.903;3578000;0
28365;1040;49;48;0;0;0;.00nan;62000;0
28365;1279;49;45;37;6;31;.838;3482000;0
28365;2846;41;62;32;5;27;.844;3600000;0
28365;6353;41;0;0;0;0;.00nan;0;0
28366;335;60;100;27;0;27;1.000;3600000;0
28366;346;46;0;0;0;0;.00nan;0;0
28366;2192;60;0;0;0;0;.00nan;0;0
28366;4916;46;37;27;5;22;.815;3600000;0
28367;485;36;100;33;0;33;1.000;3600000;0
28367;599;36;0;0;0;0;.00nan;0;0
28367;2598;50;67;22;2;20;.909;3520000;0
28367;2751;50;0;0;0;0;.00nan;0;0
28368;771;34;67;24;2;22;.917;3600000;0
28368;1002;34;0;0;0;0;.00nan;0;0
28368;1046;52;29;23;5;18;.783;3600000;0
28368;2625;52;0;0;0;0;.00nan;0;0
28369;593;57;76;27;2;25;.926;3600000;0
28369;907;57;0;0;0;0;.00nan;0;0
28369;1259;53;30;10;3;7;.700;600000;0
28369;2538;53;54;33;3;30;.909;3000000;0
28370;831;44;0;0;0;0;.00nan;0;0
28370;1085;44;58;25;2;23;.920;3564000;0
28370;1234;39;92;27;1;26;.963;3600000;0
28370;1901;39;0;0;0;0;.00nan;0;0
28371;35;59;20;20;6;14;.700;2800000;0
28371;349;59;41;11;2;9;.818;800000;0
28371;1016;33;0;0;0;0;.00nan;0;0
28371;3987;33;86;33;2;31;.939;3600000;0
28372;534;38;54;32;5;27;.844;3600000;0
28372;835;40;0;0;0;0;.00nan;0;0
28372;1345;38;0;0;0;0;.00nan;0;0
28372;2615;40;64;36;3;33;.917;3600000;0
28373;1040;49;0;0;0;0;.00nan;0;0
28373;1279;49;92;39;3;36;.923;4256000;0
28373;2846;41;73;26;2;24;.923;4256000;0
28373;6353;41;0;0;0;0;.00nan;0;0
28374;335;60;58;21;2;19;.905;3600000;0
28374;346;46;0;0;0;0;.00nan;0;0
28374;2192;60;0;0;0;0;.00nan;0;0
28374;4916;46;81;34;3;31;.912;3600000;0
28375;485;36;45;36;5;31;.861;3898000;0
28375;599;36;0;0;0;0;.00nan;0;0
28375;2598;50;67;39;4;35;.897;3898000;0
28375;2751;50;0;0;0;0;.00nan;0;0
28376;771;34;100;29;0;29;1.000;3600000;0
28376;1002;34;0;0;0;0;.00nan;0;0
28376;1046;52;93;31;1;30;.968;3600000;0
28376;2625;52;0;0;0;0;.00nan;0;0
28377;593;57;78;26;2;24;.923;3600000;0
28377;907;57;0;0;0;0;.00nan;0;0
28377;1259;53;0;0;0;0;.00nan;0;0
28377;2538;53;21;21;5;16;.762;3600000;0
28504;831;44;0;0;0;0;.00nan;0;0
28504;1085;44;74;40;3;37;.925;3600000;0
28504;1234;39;48;32;5;27;.844;3512000;0
28504;1901;39;0;0;0;0;.00nan;0;0
28505;35;59;0;0;0;0;.00nan;0;0
28505;349;59;89;38;2;36;.947;3600000;0
28505;1016;33;0;0;0;0;.00nan;0;0
28505;3987;33;60;35;5;30;.857;3600000;0
28506;534;38;76;24;1;23;.958;3600000;0
28506;835;40;0;0;0;0;.00nan;0;0
28506;1345;38;0;0;0;0;.00nan;0;0
28506;2615;40;58;22;3;19;.864;3576000;0
28507;1040;49;50;0;0;0;.00nan;16000;0
28507;1279;49;44;45;7;38;.844;3584000;0
28507;2846;41;85;27;1;26;.963;3600000;0
28507;6353;41;0;0;0;0;.00nan;0;0
28508;335;60;100;26;0;26;1.000;3600000;0
28508;346;46;0;0;0;0;.00nan;0;0
28508;2192;60;0;0;0;0;.00nan;0;0
28508;4916;46;78;27;1;26;.963;3584000;0
28509;485;36;92;42;3;39;.929;4457000;0
28509;599;36;0;0;0;0;.00nan;0;0
28509;2598;50;66;29;2;27;.931;4457000;0
28509;2751;50;0;0;0;0;.00nan;0;0
28510;771;34;88;40;2;38;.950;3551000;0
28510;1002;34;0;0;0;0;.00nan;0;0
28510;1046;52;100;32;0;32;1.000;3600000;0
28510;2625;52;0;0;0;0;.00nan;0;0
28511;593;57;32;37;6;31;.838;3600000;0
28511;907;57;0;0;0;0;.00nan;0;0
28511;1259;53;0;0;0;0;.00nan;0;0
28511;2538;53;55;32;3;29;.906;3600000;0
28515;831;44;0;0;0;0;.00nan;0;0
28515;1085;44;45;32;6;26;.813;3531000;0
28515;1234;39;41;26;4;22;.846;3600000;0
28515;1901;39;0;0;0;0;.00nan;0;0
28516;534;38;99;24;0;24;1.000;3600000;0
28516;835;40;0;0;0;0;.00nan;0;0
28516;1345;38;0;0;0;0;.00nan;0;0
28516;2615;40;87;43;3;40;.930;3600000;0
28517;1040;49;0;0;0;0;.00nan;0;0
28517;1279;49;73;19;1;18;.947;3600000;0
28517;2846;41;78;30;2;28;.933;3598000;0
28517;6353;41;0;0;0;0;.00nan;0;0
28518;335;60;72;21;2;19;.905;3600000;0
28518;346;46;0;0;0;0;.00nan;0;0
28518;2192;60;0;0;0;0;.00nan;0;0
28518;4916;46;83;41;3;38;.927;3552000;0
28519;485;36;56;29;3;26;.897;3600000;0
28519;599;36;0;0;0;0;.00nan;0;0
28519;2598;50;78;32;2;30;.938;3600000;0
28519;2751;50;0;0;0;0;.00nan;0;0
28520;771;34;80;27;1;26;.963;3600000;0
28520;1002;34;0;0;0;0;.00nan;0;0
28520;1046;52;33;29;6;23;.793;3401000;0
28520;2625;52;50;1;0;1;1.000;199000;0
28521;593;57;55;30;4;26;.867;3600000;0
28521;907;57;0;0;0;0;.00nan;0;0
28521;1259;53;0;0;0;0;.00nan;0;0
28521;2538;53;65;19;1;18;.947;3600000;0
28570;534;38;46;19;3;16;.842;3545000;0
28570;835;40;0;0;0;0;.00nan;0;0
28570;1345;38;0;0;0;0;.00nan;0;0
28570;2615;40;97;40;2;38;.950;3600000;0
28571;1040;49;0;0;0;0;.00nan;0;0
28571;1279;49;94;32;1;31;.969;3600000;0
28571;2846;41;72;27;2;25;.926;3548000;0
28571;6353;41;0;0;0;0;.00nan;0;0
28572;771;34;50;21;3;18;.857;3600000;0
28572;1002;34;0;0;0;0;.00nan;0;0
28572;1046;52;57;32;4;28;.875;3571000;0
28572;2625;52;0;0;0;0;.00nan;0;0
28573;593;57;42;23;4;19;.826;3600000;0
28573;907;57;0;0;0;0;.00nan;0;0
28573;1259;53;0;0;0;0;.00nan;0;0
28573;2538;53;83;24;1;23;.958;3600000;0
28574;35;59;0;0;0;0;.00nan;0;0
28574;349;59;77;41;3;38;.927;4351000;0
28574;1234;39;62;26;4;22;.846;4368000;0
28574;1901;39;0;0;0;0;.00nan;0;0
28575;335;60;67;23;2;21;.913;3600000;0
28575;2192;60;0;0;0;0;.00nan;0;0
28575;2598;50;66;32;3;29;.906;3587000;0
28575;2751;50;0;0;0;0;.00nan;0;0
28576;771;34;71;22;1;21;.955;3600000;0
28576;1002;34;0;0;0;0;.00nan;0;0
28576;1259;53;0;0;0;0;.00nan;0;0
28576;2538;53;91;21;0;21;1.000;3600000;0
28577;835;40;0;0;0;0;.00nan;0;0
28577;1040;49;0;0;0;0;.00nan;0;0
28577;1279;49;66;23;2;21;.913;3600000;0
28577;2615;40;75;40;4;36;.900;3530000;0
28578;35;59;86;27;0;27;1.000;2123000;0
28578;349;59;23;27;6;21;.778;1477000;0
28578;1234;39;100;21;0;21;1.000;3600000;0
28578;1901;39;0;0;0;0;.00nan;0;0
28579;335;60;99;37;2;35;.946;3600000;0
28579;2192;60;0;0;0;0;.00nan;0;0
28579;2598;50;62;32;3;29;.906;3600000;0
28579;2751;50;0;0;0;0;.00nan;0;0
28580;771;34;64;28;3;25;.893;5552000;0
28580;1002;34;0;0;0;0;.00nan;0;0
28580;1259;53;0;0;0;0;.00nan;0;0
28580;2538;53;94;53;2;51;.962;5552000;0
28581;835;40;0;0;0;0;.00nan;0;0
28581;1040;49;0;0;0;0;.00nan;0;0
28581;1279;49;69;32;4;28;.875;3600000;0
28581;2615;40;75;42;3;39;.929;3600000;0
28582;35;59;75;43;5;38;.884;3865000;0
28582;349;59;0;0;0;0;.00nan;0;0
28582;1234;39;64;33;4;29;.879;3865000;0
28582;1901;39;0;0;0;0;.00nan;0;0
28583;335;60;49;19;3;16;.842;3558000;0
28583;2192;60;0;0;0;0;.00nan;0;0
28583;2598;50;69;25;2;23;.920;3600000;0
28583;2751;50;0;0;0;0;.00nan;0;0
28584;771;34;57;27;3;24;.889;3600000;0
28584;1002;34;0;0;0;0;.00nan;0;0
28584;1259;53;0;0;0;0;.00nan;0;0
28584;2538;53;98;42;2;40;.952;3600000;0
28585;835;40;0;0;0;0;.00nan;0;0
28585;1040;49;0;0;0;0;.00nan;0;0
28585;1279;49;97;44;1;43;.977;3558000;0
28585;2615;40;74;12;0;12;1.000;3600000;0
28586;35;59;82;40;2;38;.950;3811000;0
28586;349;59;0;0;0;0;.00nan;0;0
28586;1234;39;83;23;1;22;.957;3811000;0
28586;1901;39;0;0;0;0;.00nan;0;0
28587;335;60;60;28;3;25;.893;3686000;0
28587;2192;60;0;0;0;0;.00nan;0;0
28587;2598;50;66;24;2;22;.917;3686000;0
28587;2751;50;0;0;0;0;.00nan;0;0
28588;771;34;67;22;2;20;.909;3600000;0
28588;1002;34;0;0;0;0;.00nan;0;0
28588;1259;53;0;0;0;0;.00nan;0;0
28588;2538;53;85;39;3;36;.923;3572000;0
28589;835;40;0;0;0;0;.00nan;0;0
28589;1040;49;0;0;0;0;.00nan;0;0
28589;1279;49;94;28;2;26;.929;3600000;0
28589;2615;40;50;28;4;24;.857;3518000;0
28666;35;59;69;41;4;37;.902;3600000;0
28666;349;59;0;0;0;0;.00nan;0;0
28666;1234;39;26;18;5;13;.722;3586000;0
28666;1901;39;0;0;0;0;.00nan;0;0
28667;335;60;60;24;2;22;.917;3600000;0
28667;2192;60;0;0;0;0;.00nan;0;0
28667;2598;50;65;43;6;37;.860;3600000;0
28667;2751;50;0;0;0;0;.00nan;0;0
28668;771;34;65;26;2;24;.923;3600000;0
28668;1002;34;0;0;0;0;.00nan;0;0
28668;1259;53;0;0;0;0;.00nan;0;0
28668;2538;53;92;46;3;43;.935;3600000;0
28669;835;40;0;0;0;0;.00nan;0;0
28669;1040;49;0;0;0;0;.00nan;0;0
28669;1279;49;59;30;3;27;.900;3600000;0
28669;2615;40;45;29;4;25;.862;3600000;0
28675;35;59;31;32;7;25;.781;2134000;0
28675;349;59;64;21;2;19;.905;1466000;0
28675;1234;39;81;21;1;20;.952;3600000;0
28675;1901;39;0;0;0;0;.00nan;0;0
28676;335;60;47;16;2;14;.875;3543000;0
28676;2192;60;0;0;0;0;.00nan;0;0
28676;2598;50;94;37;1;36;.973;3600000;0
28676;2751;50;0;0;0;0;.00nan;0;0
28677;771;34;90;22;0;22;1.000;3600000;0
28677;1002;34;0;0;0;0;.00nan;0;0
28677;1259;53;0;0;0;0;.00nan;0;0
28677;2538;53;56;34;4;30;.882;3600000;0
28678;835;40;0;0;0;0;.00nan;0;0
28678;1040;49;0;0;0;0;.00nan;0;0
28678;1279;49;62;32;3;29;.906;3600000;0
28678;2615;40;45;27;5;22;.815;3570000;0
28681;335;60;78;23;1;22;.957;3600000;0
28681;2192;60;0;0;0;0;.00nan;0;0
28681;2598;50;77;34;3;31;.912;3600000;0
28681;2751;50;0;0;0;0;.00nan;0;0
28682;771;34;36;25;5;20;.800;3600000;0
28682;1002;34;0;0;0;0;.00nan;0;0
28682;1259;53;0;0;0;0;.00nan;0;0
28682;2538;53;82;24;1;23;.958;3600000;0
28685;1234;39;34;23;5;18;.783;3546000;0
28685;1259;53;0;0;0;0;.00nan;0;0
28685;1901;39;0;0;0;0;.00nan;0;0
28685;2538;53;80;48;4;44;.917;3600000;0
28686;335;60;39;32;6;26;.813;3600000;0
28686;1040;49;0;0;0;0;.00nan;0;0
28686;1279;49;88;31;1;30;.968;3600000;0
28686;2192;60;0;0;0;0;.00nan;0;0
28687;1234;39;59;13;1;12;.923;3600000;0
28687;1259;53;72;16;0;16;1.000;925000;0
28687;1901;39;0;0;0;0;.00nan;0;0
28687;2538;53;45;35;6;29;.829;2675000;0
28688;335;60;87;31;1;30;.968;3600000;0
28688;1040;49;0;0;0;0;.00nan;0;0
28688;1279;49;42;22;4;18;.818;3600000;0
28688;2192;60;0;0;0;0;.00nan;0;0
28689;1234;39;48;25;4;21;.840;3548000;0
28689;1259;53;0;0;0;0;.00nan;0;0
28689;1901;39;0;0;0;0;.00nan;0;0
28689;2538;53;95;37;2;35;.946;3600000;0
28690;335;60;77;12;0;12;1.000;3600000;0
28690;1040;49;0;0;0;0;.00nan;0;0
28690;1279;49;61;27;4;23;.852;3600000;0
28690;2192;60;0;0;0;0;.00nan;0;0
28691;1234;39;59;26;3;23;.885;3524000;0
28691;1259;53;0;0;0;0;.00nan;0;0
28691;1901;39;0;0;0;0;.00nan;0;0
28691;2538;53;90;29;1;28;.966;3600000;0
28692;335;60;100;40;1;39;.975;4924000;0
28692;1040;49;0;0;0;0;.00nan;0;0
28692;1279;49;91;43;2;41;.953;4924000;0
28692;2192;60;0;0;0;0;.00nan;0;0
28729;1234;39;70;26;2;24;.923;3600000;0
28729;1259;53;0;0;0;0;.00nan;0;0
28729;1901;39;0;0;0;0;.00nan;0;0
28729;2538;53;44;21;4;17;.810;3586000;0
28730;335;60;60;23;3;20;.870;3600000;0
28730;1040;49;0;0;0;0;.00nan;0;0
28730;1279;49;100;33;0;33;1.000;3600000;0
28730;2192;60;0;0;0;0;.00nan;0;0
28736;1234;39;0;0;0;0;.00nan;0;0
28736;1259;53;52;4;0;4;1.000;417000;0
28736;1901;39;98;20;0;20;1.000;3600000;0
28736;2538;53;41;45;7;38;.844;3183000;0
28737;335;60;0;0;0;0;.00nan;0;0
28737;1040;49;0;0;0;0;.00nan;0;0
28737;1279;49;84;34;2;32;.941;3516000;0
28737;2192;60;95;22;0;22;1.000;3600000;0
28742;1234;39;0;0;0;0;.00nan;0;0
28742;1259;53;90;39;2;37;.949;3600000;0
28742;1901;39;78;25;1;24;.960;3600000;0
28742;2538;53;0;0;0;0;.00nan;0;0
28746;335;60;0;0;0;0;.00nan;0;0
28746;1234;39;0;0;0;0;.00nan;0;0
28746;1901;39;46;26;4;22;.846;4129000;0
28746;2192;60;38;28;5;23;.821;4129000;0
28747;335;60;0;0;0;0;.00nan;0;0
28747;1234;39;0;0;0;0;.00nan;0;0
28747;1901;39;40;22;4;18;.818;3600000;0
28747;2192;60;36;23;5;18;.783;3600000;0
28748;335;60;0;0;0;0;.00nan;0;0
28748;1234;39;0;0;0;0;.00nan;0;0
28748;1901;39;54;32;4;28;.875;3921000;0
28748;2192;60;53;35;5;30;.857;3921000;0
28749;335;60;0;0;0;0;.00nan;0;0
28749;1234;39;0;0;0;0;.00nan;0;0
28749;1901;39;61;36;4;32;.889;3600000;0
28749;2192;60;72;39;3;36;.923;3600000;0
28766;335;60;0;0;0;0;.00nan;0;0
28766;1234;39;0;0;0;0;.00nan;0;0
28766;1901;39;60;31;3;28;.903;3600000;0
28766;2192;60;38;21;4;17;.810;3545000;0
25886;4872;89;0;0;0;0;.00nan;0;0
25886;5966;89;70;33;3;30;.909;3600000;0
25886;6418;92;79;33;2;31;.939;3600000;0
25886;9400;92;0;0;0;0;.00nan;0;0
25887;4629;100;23;26;6;20;.769;3600000;0
25887;4872;89;76;36;3;33;.917;3600000;0
25887;5966;89;0;0;0;0;.00nan;0;0
25887;7787;97;0;0;0;0;.00nan;0;0
25888;4754;96;72;39;3;36;.923;3600000;0
25888;4771;86;35;35;6;29;.829;3600000;0
25888;9240;-1;0;0;0;0;.00nan;0;0
25888;9413;96;0;0;0;0;.00nan;0;0
25889;4697;84;83;26;2;24;.923;3600000;0
25889;7329;87;100;40;1;39;.975;3600000;0
25889;7801;84;0;0;0;0;.00nan;0;0
25889;8790;87;0;0;0;0;.00nan;0;0
25890;3867;95;29;29;7;22;.759;3558000;0
25890;4838;102;0;0;0;0;.00nan;0;0
25890;6448;95;0;0;0;0;.00nan;0;0
25890;9426;102;55;49;6;43;.878;3600000;0
25891;5976;94;70;43;4;39;.907;3600000;0
25891;6593;103;0;0;0;0;.00nan;0;0
25891;7876;100;0;0;0;0;.00nan;0;0
25891;9454;88;61;31;3;28;.903;3600000;0
25892;4523;90;36;19;4;15;.789;722000;0
25892;6367;90;88;38;2;36;.947;2878000;0
25892;6418;92;0;0;0;0;.00nan;0;0
25892;9400;92;67;20;1;19;.950;3600000;0
25893;4666;93;14;21;6;15;.714;2274000;0
25893;4705;91;100;26;0;26;1.000;3600000;0
25893;8043;91;0;0;0;0;.00nan;0;0
25893;9273;93;54;10;1;9;.900;1326000;0
25894;4643;99;0;0;0;0;.00nan;0;0
25894;6581;99;80;36;3;33;.917;3600000;0
25894;7333;85;22;25;6;19;.760;3600000;0
25894;9378;85;0;0;0;0;.00nan;0;0
25895;4480;100;54;41;5;36;.878;3600000;0
25895;6503;100;0;0;0;0;.00nan;0;0
25895;7790;101;100;30;0;30;1.000;3600000;0
25895;9386;101;0;0;0;0;.00nan;0;0
25896;4666;93;0;0;0;0;.00nan;0;0
25896;5976;94;50;0;0;0;.00nan;29000;0
25896;7876;100;62;48;6;42;.875;3571000;0
25896;9273;93;38;15;3;12;.800;3600000;0
25897;4629;100;53;9;1;8;.889;994000;0
25897;7333;85;0;0;0;0;.00nan;0;0
25897;7787;97;19;22;6;16;.727;2606000;0
25897;9378;85;100;27;0;27;1.000;3600000;0
25898;4771;86;36;26;5;21;.808;3581000;0
25898;6631;98;0;0;0;0;.00nan;0;0
25898;7426;98;56;26;4;22;.846;3600000;0
25898;9240;-1;0;0;0;0;.00nan;0;0
25899;4838;102;58;17;2;15;.882;3600000;0
25899;7790;101;97;48;3;45;.938;3576000;0
25899;9386;101;0;0;0;0;.00nan;0;0
25899;9426;102;0;0;0;0;.00nan;0;0
25900;4480;100;60;12;1;11;.917;971000;0
25900;4705;91;0;0;0;0;.00nan;0;0
25900;6503;100;1;24;8;16;.667;2629000;0
25900;8043;91;75;25;2;23;.920;3600000;0
25901;6593;103;97;23;0;23;1.000;3600000;0
25901;7323;103;0;0;0;0;.00nan;0;0
25901;8857;103;70;41;3;38;.927;3600000;0
25901;9454;88;0;0;0;0;.00nan;0;0
25902;4523;90;60;32;4;28;.875;3571000;0
25902;4872;89;0;0;0;0;.00nan;0;0
25902;5966;89;91;41;2;39;.951;3600000;0
25902;6367;90;0;0;0;0;.00nan;0;0
25903;4666;93;0;0;0;0;.00nan;0;0
25903;6631;98;0;0;0;0;.00nan;0;0
25903;7426;98;89;45;3;42;.933;3587000;0
25903;9273;93;50;15;2;13;.867;3600000;0
25904;6418;92;25;12;4;8;.667;1085000;0
25904;7329;87;70;43;4;39;.907;3332000;0
25904;8790;87;23;4;3;1;.250;217000;0
25904;9400;92;60;19;1;18;.947;2515000;0
25905;3867;95;53;33;4;29;.879;3518000;0
25905;4705;91;93;39;2;37;.949;3600000;0
25905;6448;95;0;0;0;0;.00nan;0;0
25905;8043;91;0;0;0;0;.00nan;0;0
25906;4629;100;41;23;4;19;.826;3600000;0
25906;7323;103;29;50;8;42;.840;3600000;0
25906;7787;97;0;0;0;0;.00nan;0;0
25906;8857;103;0;0;0;0;.00nan;0;0
25907;4754;96;0;0;0;0;.00nan;0;0
25907;6631;98;77;27;2;25;.926;3600000;0
25907;7426;98;0;0;0;0;.00nan;0;0
25907;9413;96;68;38;4;34;.895;3523000;0
25908;7323;103;0;0;0;0;.00nan;0;0
25908;7333;85;0;0;0;0;.00nan;0;0
25908;8857;103;32;35;7;28;.800;3600000;0
25908;9378;85;59;15;1;14;.933;3600000;0
25909;4697;84;64;28;3;25;.893;3600000;0
25909;4771;86;33;24;5;19;.792;3585000;0
25909;7801;84;0;0;0;0;.00nan;0;0
25909;9240;-1;0;0;0;0;.00nan;0;0
25910;4629;100;0;0;0;0;.00nan;0;0
25910;5976;94;69;35;3;32;.914;3600000;0
25910;7787;97;62;37;4;33;.892;3600000;0
25910;7876;100;0;0;0;0;.00nan;0;0
25911;4523;90;0;0;0;0;.00nan;0;0
25911;6367;90;64;37;4;33;.892;3586000;0
25911;7329;87;49;21;3;18;.857;3600000;0
25911;8790;87;0;0;0;0;.00nan;0;0
25912;4643;99;0;0;0;0;.00nan;0;0
25912;4838;102;0;0;0;0;.00nan;0;0
25912;6581;99;54;36;5;31;.861;3599000;0
25912;9426;102;79;38;3;35;.921;3600000;0
25913;3867;95;0;0;0;0;.00nan;0;0
25913;4480;100;0;0;0;0;.00nan;0;0
25913;6448;95;90;35;2;33;.943;3600000;0
25913;6503;100;87;56;5;51;.911;3600000;0
25914;4705;91;0;0;0;0;.00nan;0;0
25914;4872;89;0;0;0;0;.00nan;0;0
25914;5966;89;35;26;5;21;.808;3541000;0
25914;8043;91;71;30;3;27;.900;3600000;0
25915;4523;90;52;40;6;34;.850;3600000;0
25915;4666;93;53;16;2;14;.875;3600000;0
25915;6367;90;0;0;0;0;.00nan;0;0
25915;9273;93;0;0;0;0;.00nan;0;0
25916;4629;100;71;24;2;22;.917;3600000;0
25916;7323;103;60;37;4;33;.892;3575000;0
25916;7787;97;0;0;0;0;.00nan;0;0
25916;8857;103;0;0;0;0;.00nan;0;0
25917;6418;92;49;16;3;13;.813;3600000;0
25917;7790;101;83;42;4;38;.905;3545000;0
25917;9386;101;0;0;0;0;.00nan;0;0
25917;9400;92;0;0;0;0;.00nan;0;0
25918;5976;94;0;0;0;0;.00nan;0;0
25918;7333;85;55;30;4;26;.867;3588000;0
25918;7876;100;54;20;3;17;.850;3600000;0
25918;9378;85;0;0;0;0;.00nan;0;0
25919;4754;96;74;35;3;32;.914;3600000;0
25919;6631;98;0;0;0;0;.00nan;0;0
25919;7426;98;88;33;2;31;.939;3600000;0
25919;9413;96;0;0;0;0;.00nan;0;0
25920;4480;100;68;27;2;25;.926;3600000;0
25920;4838;102;59;42;5;37;.881;3600000;0
25920;6503;100;0;0;0;0;.00nan;0;0
25920;9426;102;0;0;0;0;.00nan;0;0
25921;4643;99;31;24;5;19;.792;3568000;0
25921;6581;99;0;0;0;0;.00nan;0;0
25921;7790;101;0;0;0;0;.00nan;0;0
25921;9386;101;42;22;4;18;.818;3600000;0
25922;4697;84;0;0;0;0;.00nan;0;0
25922;7329;87;0;0;0;0;.00nan;0;0
25922;7801;84;79;32;2;30;.938;3900000;0
25922;8790;87;77;27;2;25;.926;3900000;0
25923;4771;86;24;30;6;24;.800;2213000;0
25923;6593;103;51;27;4;23;.852;3600000;0
25923;9240;-1;52;19;3;16;.842;1387000;0
25923;9454;88;0;0;0;0;.00nan;0;0
25924;4838;102;0;0;0;0;.00nan;0;0
25924;6418;92;0;0;0;0;.00nan;0;0
25924;9400;92;34;22;5;17;.773;3900000;0
25924;9426;102;48;36;5;31;.861;3900000;0
25925;3867;95;75;23;2;21;.913;3600000;0
25925;4872;89;0;0;0;0;.00nan;0;0
25925;5966;89;94;45;3;42;.933;3549000;0
25925;6448;95;0;0;0;0;.00nan;0;0
25926;4838;102;69;33;3;30;.909;3900000;0
25926;6418;92;39;19;3;16;.842;3900000;0
25926;9400;92;0;0;0;0;.00nan;0;0
25926;9426;102;0;0;0;0;.00nan;0;0
25927;4705;91;61;28;3;25;.893;3600000;0
25927;6593;103;0;0;0;0;.00nan;0;0
25927;8043;91;0;0;0;0;.00nan;0;0
25927;9454;88;56;32;4;28;.875;3544000;0
25928;4603;86;27;14;4;10;.714;1839000;0
25928;4771;86;43;10;2;8;.800;1761000;0
25928;5987;103;18;24;6;18;.750;1806000;0
25928;8857;103;48;23;3;20;.870;1794000;0
25929;4629;100;0;0;0;0;.00nan;0;0
25929;4838;102;0;0;0;0;.00nan;0;0
25929;7787;97;68;18;1;17;.944;3600000;0
25929;9426;102;83;38;2;36;.947;3600000;0
25930;4754;96;0;0;0;0;.00nan;0;0
25930;7790;101;66;40;5;35;.875;3900000;0
25930;9386;101;0;0;0;0;.00nan;0;0
25930;9413;96;28;20;5;15;.750;3900000;0
25931;3867;95;71;23;2;21;.913;3900000;0
25931;6448;95;0;0;0;0;.00nan;0;0
25931;6631;98;0;0;0;0;.00nan;0;0
25931;7426;98;82;37;2;35;.946;3900000;0
25932;4603;86;78;32;3;29;.906;3600000;0
25932;4771;86;0;0;0;0;.00nan;0;0
25932;5976;94;0;0;0;0;.00nan;0;0
25932;7876;100;64;40;4;36;.900;3581000;0
25933;4523;90;0;0;0;0;.00nan;0;0
25933;6367;90;55;28;4;24;.857;3635000;0
25933;7333;85;0;0;0;0;.00nan;0;0
25933;9378;85;44;29;5;24;.828;3635000;0
25934;4697;84;29;22;5;17;.773;3600000;0
25934;6418;92;53;3;0;3;1.000;173000;0
25934;7801;84;0;0;0;0;.00nan;0;0
25934;9400;92;24;28;6;22;.786;3424000;0
25935;4705;91;50;0;0;0;.00nan;12000;0
25935;6579;87;61;25;3;22;.880;3600000;0
25935;7329;87;0;0;0;0;.00nan;0;0
25935;8043;91;37;34;6;28;.824;3582000;0
25936;4643;99;61;36;4;32;.889;3543000;0
25936;4666;93;0;0;0;0;.00nan;0;0
25936;6581;99;0;0;0;0;.00nan;0;0
25936;9273;93;63;28;3;25;.893;3600000;0
25937;4872;89;72;39;3;36;.923;3600000;0
25937;5966;89;0;0;0;0;.00nan;0;0
25937;6593;103;46;31;5;26;.839;3514000;0
25937;9454;88;0;0;0;0;.00nan;0;0
25938;4629;100;67;25;3;22;.880;3900000;0
25938;4697;84;0;0;0;0;.00nan;0;0
25938;7787;97;0;0;0;0;.00nan;0;0
25938;7801;84;80;44;3;41;.932;3900000;0
25939;6579;87;0;0;0;0;.00nan;0;0
25939;7329;87;43;21;4;17;.810;3600000;0
25939;7333;85;13;13;5;8;.615;1117000;0
25939;9378;85;52;23;4;19;.826;2483000;0
25940;6631;98;98;47;2;45;.957;3600000;0
25940;7426;98;0;0;0;0;.00nan;0;0
25940;7790;101;0;0;0;0;.00nan;0;0
25940;9386;101;76;26;1;25;.962;3600000;0
25941;4480;100;0;0;0;0;.00nan;0;0
25941;4872;89;0;0;0;0;.00nan;0;0
25941;5966;89;60;30;4;26;.867;3900000;0
25941;6503;100;72;41;4;37;.902;3873000;0
25942;4666;93;81;29;1;28;.966;3600000;0
25942;5987;103;51;3;0;3;1.000;498000;0
25942;8857;103;37;33;6;27;.818;3102000;0
25942;9273;93;0;0;0;0;.00nan;0;0
25943;4697;84;55;26;3;23;.885;3600000;0
25943;7333;85;69;44;5;39;.886;3547000;0
25943;7801;84;0;0;0;0;.00nan;0;0
25943;9378;85;0;0;0;0;.00nan;0;0
25944;3867;95;0;0;0;0;.00nan;0;0
25944;4603;86;0;0;0;0;.00nan;0;0
25944;4771;86;71;39;4;35;.897;3820000;0
25944;6448;95;51;35;5;30;.857;3820000;0
25945;4523;90;57;23;3;20;.870;3877000;0
25945;5987;103;93;51;4;47;.922;3877000;0
25945;6367;90;0;0;0;0;.00nan;0;0
25945;8857;103;0;0;0;0;.00nan;0;0
25946;4838;102;59;15;1;14;.933;1013000;0
25946;6579;87;59;11;1;10;.909;3600000;0
25946;7329;87;0;0;0;0;.00nan;0;0
25946;9426;102;32;37;6;31;.838;2587000;0
25947;4643;99;0;0;0;0;.00nan;0;0
25947;4754;96;0;0;0;0;.00nan;0;0
25947;6581;99;53;30;4;26;.867;3600000;0
25947;9413;96;77;31;1;30;.968;3600000;0
25948;4480;100;64;33;3;30;.909;3600000;0
25948;6503;100;0;0;0;0;.00nan;0;0
25948;6593;103;0;0;0;0;.00nan;0;0
25948;9454;88;66;35;4;31;.886;3600000;0
25949;3867;95;18;37;8;29;.784;3600000;0
25949;6448;95;0;0;0;0;.00nan;0;0
25949;6631;98;0;0;0;0;.00nan;0;0
25949;7426;98;67;20;2;18;.900;3600000;0
25950;4838;102;63;17;1;16;.941;1746000;0
25950;6593;103;0;0;0;0;.00nan;0;0
25950;9426;102;25;20;5;15;.750;1854000;0
25950;9454;88;69;34;4;30;.882;3600000;0
25951;4705;91;71;28;2;26;.929;3600000;0
25951;6579;87;63;35;4;31;.886;3553000;0
25951;7329;87;0;0;0;0;.00nan;0;0
25951;8043;91;0;0;0;0;.00nan;0;0
25952;7333;85;40;10;2;8;.800;765000;0
25952;7787;97;18;15;5;10;.667;3600000;0
25952;7870;97;0;0;0;0;.00nan;0;0
25952;9378;85;61;49;6;43;.878;2835000;0
25953;4480;100;0;0;0;0;.00nan;0;0
25953;4754;96;0;0;0;0;.00nan;0;0
25953;6503;100;59;31;4;27;.871;3689000;0
25953;9413;96;63;31;3;28;.903;3689000;0
25954;4697;84;42;34;6;28;.824;3600000;0
25954;6418;92;69;25;2;23;.920;3600000;0
25954;7801;84;0;0;0;0;.00nan;0;0
25954;9400;92;0;0;0;0;.00nan;0;0
25955;3867;95;62;21;2;19;.905;3600000;0
25955;5987;103;0;0;0;0;.00nan;0;0
25955;6448;95;0;0;0;0;.00nan;0;0
25955;7323;103;56;39;5;34;.872;3600000;0
25956;5976;94;60;37;4;33;.892;3592000;0
25956;6631;98;55;26;3;23;.885;3600000;0
25956;7426;98;0;0;0;0;.00nan;0;0
25956;7876;100;0;0;0;0;.00nan;0;0
25957;4523;90;88;41;3;38;.927;3600000;0
25957;4603;86;57;31;4;27;.871;3586000;0
25957;4771;86;0;0;0;0;.00nan;0;0
25957;6367;90;0;0;0;0;.00nan;0;0
25958;4643;99;0;0;0;0;.00nan;0;0
25958;6401;88;38;29;5;24;.828;3556000;0
25958;6581;99;56;34;4;30;.882;3600000;0
25958;6593;103;0;0;0;0;.00nan;0;0
25959;4872;89;0;0;0;0;.00nan;0;0
25959;5966;89;39;28;5;23;.821;3600000;0
25959;6579;87;50;2;0;2;1.000;151000;0
25959;7329;87;35;29;6;23;.793;3401000;0
25960;4666;93;54;38;5;33;.868;3789000;0
25960;4697;84;0;0;0;0;.00nan;0;0
25960;7801;84;38;22;4;18;.818;3789000;0
25960;9273;93;0;0;0;0;.00nan;0;0
25961;4754;96;72;33;3;30;.909;3554000;0
25961;7787;97;0;0;0;0;.00nan;0;0
25961;7870;97;59;21;2;19;.905;3600000;0
25961;9413;96;0;0;0;0;.00nan;0;0
25962;6401;88;0;0;0;0;.00nan;0;0
25962;6593;103;84;45;4;41;.911;3600000;0
25962;7790;101;31;32;6;26;.813;3354000;0
25962;9386;101;49;1;0;1;1.000;243000;0
25963;4705;91;0;0;0;0;.00nan;0;0
25963;6418;92;0;0;0;0;.00nan;0;0
25963;8043;91;41;23;4;19;.826;3900000;0
25963;9400;92;83;49;4;45;.918;3900000;0
25964;4480;100;19;8;4;4;.500;870000;0
25964;6503;100;44;32;5;27;.844;2730000;0
25964;6631;98;0;0;0;0;.00nan;0;0
25964;7426;98;53;33;4;29;.879;3600000;0
25965;4838;102;0;0;0;0;.00nan;0;0
25965;5976;94;0;0;0;0;.00nan;0;0
25965;7876;100;48;28;4;24;.857;3600000;0
25965;9426;102;84;28;1;27;.964;3600000;0
25966;4643;99;73;42;4;38;.905;3513000;0
25966;5987;103;73;26;2;24;.923;3600000;0
25966;6581;99;0;0;0;0;.00nan;0;0
25966;7323;103;0;0;0;0;.00nan;0;0
25967;4523;90;0;0;0;0;.00nan;0;0
25967;4872;89;0;0;0;0;.00nan;0;0
25967;5966;89;42;32;5;27;.844;3600000;0
25967;6367;90;81;28;1;27;.964;3600000;0
25968;4666;93;0;0;0;0;.00nan;0;0
25968;7333;85;53;4;0;4;1.000;184000;0
25968;9273;93;51;7;1;6;.857;3600000;0
25968;9378;85;50;41;6;35;.854;3416000;0
25969;3867;95;0;0;0;0;.00nan;0;0
25969;4872;89;40;26;5;21;.808;3900000;0
25969;5966;89;0;0;0;0;.00nan;0;0
25969;6448;95;50;41;5;36;.878;3900000;0
25970;4480;100;61;37;5;32;.865;3600000;0
25970;4705;91;63;25;3;22;.880;3600000;0
25970;6503;100;0;0;0;0;.00nan;0;0
25970;8043;91;0;0;0;0;.00nan;0;0
25971;4603;86;0;0;0;0;.00nan;0;0
25971;4697;84;52;31;5;26;.839;3600000;0
25971;4771;86;96;42;2;40;.952;3600000;0
25971;7801;84;0;0;0;0;.00nan;0;0
25972;4480;100;0;0;0;0;.00nan;0;0
25972;4838;102;66;21;1;20;.952;2436000;0
25972;6503;100;77;30;2;28;.933;3600000;0
25972;9426;102;44;28;4;24;.857;1164000;0
25973;4643;99;55;4;0;4;1.000;1381000;0
25973;4666;93;60;28;3;25;.893;3600000;0
25973;6581;99;19;22;6;16;.727;2219000;0
25973;9273;93;0;0;0;0;.00nan;0;0
25974;4629;100;41;36;6;30;.833;3539000;0
25974;6418;92;85;32;2;30;.938;3600000;0
25974;7787;97;48;0;0;0;.00nan;61000;0
25974;9400;92;0;0;0;0;.00nan;0;0
25975;6401;88;32;19;4;15;.789;3600000;0
25975;6593;103;0;0;0;0;.00nan;0;0
25975;7333;85;72;15;0;15;1.000;1367000;0
25975;9378;85;28;24;5;19;.792;2233000;0
25976;5987;103;0;0;0;0;.00nan;0;0
25976;7323;103;57;44;5;39;.886;3595000;0
25976;7790;101;66;35;3;32;.914;3600000;0
25976;9386;101;0;0;0;0;.00nan;0;0
25977;4629;100;0;0;0;0;.00nan;0;0
25977;4754;96;0;0;0;0;.00nan;0;0
25977;7787;97;44;16;3;13;.813;3607000;0
25977;9413;96;61;33;4;29;.879;3607000;0
25978;4697;84;63;23;2;21;.913;2610000;0
25978;7333;85;57;9;0;9;1.000;793000;0
25978;7801;84;16;5;4;1;.200;990000;0
25978;9378;85;26;32;7;25;.781;2771000;0
25979;3867;95;55;36;6;30;.833;3537000;0
25979;6448;95;0;0;0;0;.00nan;0;0
25979;7790;101;0;0;0;0;.00nan;0;0
25979;9386;101;64;40;5;35;.875;3600000;0
25980;5976;94;54;27;3;24;.889;3600000;0
25980;5987;103;42;27;4;23;.852;3576000;0
25980;7323;103;0;0;0;0;.00nan;0;0
25980;7876;100;0;0;0;0;.00nan;0;0
25981;4523;90;82;28;1;27;.964;3600000;0
25981;6367;90;0;0;0;0;.00nan;0;0
25981;6418;92;0;0;0;0;.00nan;0;0
25981;9400;92;42;30;5;25;.833;3600000;0
25982;4643;99;13;23;7;16;.696;1472000;0
25982;6579;87;52;14;2;12;.857;3600000;0
25982;6581;99;17;35;8;27;.771;2128000;0
25982;7329;87;0;0;0;0;.00nan;0;0
25983;4603;86;76;28;2;26;.929;3600000;0
25983;4771;86;0;0;0;0;.00nan;0;0
25983;6401;88;52;2;0;2;1.000;319000;0
25983;6593;103;34;32;7;25;.781;3281000;0
25984;4705;91;45;28;4;24;.857;3600000;0
25984;4838;102;25;28;6;22;.786;2285000;0
25984;8043;91;0;0;0;0;.00nan;0;0
25984;9426;102;51;18;2;16;.889;1315000;0
25985;4666;93;0;0;0;0;.00nan;0;0
25985;4872;89;0;0;0;0;.00nan;0;0
25985;5966;89;77;25;1;24;.960;3600000;0
25985;9273;93;93;56;4;52;.929;3600000;0
25986;4523;90;0;0;0;0;.00nan;0;0
25986;4629;100;79;42;3;39;.929;3900000;0
25986;6367;90;75;42;3;39;.929;3900000;0
25986;7787;97;0;0;0;0;.00nan;0;0
25987;4705;91;0;0;0;0;.00nan;0;0
25987;7790;101;50;43;6;37;.860;2960000;0
25987;8043;91;63;15;1;14;.933;3600000;0
25987;9386;101;59;14;1;13;.929;640000;0
25988;4697;84;78;27;1;26;.963;3600000;0
25988;5976;94;0;0;0;0;.00nan;0;0
25988;7801;84;0;0;0;0;.00nan;0;0
25988;7876;100;72;33;2;31;.939;3545000;0
25989;4754;96;71;38;4;34;.895;3600000;0
25989;6418;92;62;27;3;24;.889;3600000;0
25989;9400;92;0;0;0;0;.00nan;0;0
25989;9413;96;0;0;0;0;.00nan;0;0
25990;4872;89;45;40;5;35;.875;3900000;0
25990;5966;89;0;0;0;0;.00nan;0;0
25990;6631;98;51;32;5;27;.844;3900000;0
25990;7426;98;0;0;0;0;.00nan;0;0
25991;3867;95;46;6;1;5;.833;1290000;0
25991;4838;102;55;36;5;31;.861;3600000;0
25991;6448;95;15;19;6;13;.684;2230000;0
25991;9426;102;0;0;0;0;.00nan;0;0
25992;4480;100;74;22;1;21;.955;3600000;0
25992;4666;93;67;37;3;34;.919;3600000;0
25992;6503;100;0;0;0;0;.00nan;0;0
25992;9273;93;0;0;0;0;.00nan;0;0
25993;4754;96;0;0;0;0;.00nan;0;0
25993;4872;89;0;0;0;0;.00nan;0;0
25993;5966;89;74;48;5;43;.896;3527000;0
25993;9413;96;63;27;3;24;.889;3600000;0
25994;6401;88;6;14;6;8;.571;1432000;0
25994;6579;87;65;22;2;20;.909;3600000;0
25994;6593;103;77;29;2;27;.931;2168000;0
25994;7329;87;0;0;0;0;.00nan;0;0
25995;4603;86;0;0;0;0;.00nan;0;0
25995;4771;86;53;19;2;17;.895;3600000;0
25995;7333;85;0;0;0;0;.00nan;0;0
25995;9378;85;70;34;4;30;.882;3533000;0
25996;4643;99;44;36;5;31;.861;3548000;0
25996;4697;84;0;0;0;0;.00nan;0;0
25996;6581;99;0;0;0;0;.00nan;0;0
25996;7801;84;35;18;4;14;.778;3600000;0
25997;4480;100;0;0;0;0;.00nan;0;0
25997;4705;91;30;26;6;20;.769;3533000;0
25997;6503;100;58;30;4;26;.867;3600000;0
25997;8043;91;50;0;0;0;.00nan;4000;0
25998;4629;100;51;18;2;16;.889;3600000;0
25998;4754;96;0;0;0;0;.00nan;0;0
25998;7787;97;0;0;0;0;.00nan;0;0
25998;9413;96;82;49;4;45;.918;3530000;0
25999;4666;93;55;26;3;23;.885;3900000;0
25999;6631;98;0;0;0;0;.00nan;0;0
25999;7426;98;87;41;3;38;.927;3900000;0
25999;9273;93;0;0;0;0;.00nan;0;0
26000;4643;99;0;0;0;0;.00nan;0;0
26000;6401;88;0;0;0;0;.00nan;0;0
26000;6581;99;77;30;3;27;.900;3548000;0
26000;6593;103;68;25;2;23;.920;3600000;0
26001;4480;100;37;28;5;23;.821;3600000;0
26001;5987;103;0;0;0;0;.00nan;0;0
26001;6503;100;0;0;0;0;.00nan;0;0
26001;7323;103;87;30;1;29;.967;3600000;0
26002;4872;89;50;0;0;0;.00nan;11000;0
26002;5966;89;36;41;7;34;.829;3589000;0
26002;7790;101;54;19;3;16;.842;3600000;0
26002;9386;101;0;0;0;0;.00nan;0;0
26003;4705;91;0;0;0;0;.00nan;0;0
26003;4754;96;80;48;5;43;.896;3900000;0
26003;8043;91;24;21;5;16;.762;3900000;0
26003;9413;96;0;0;0;0;.00nan;0;0
26004;4643;99;60;47;7;40;.851;3578000;0
26004;4697;84;25;23;6;17;.739;3600000;0
26004;6581;99;0;0;0;0;.00nan;0;0
26004;7801;84;0;0;0;0;.00nan;0;0
26005;4838;102;81;37;3;34;.919;3612000;0
26005;5976;94;0;0;0;0;.00nan;0;0
26005;7876;100;51;26;4;22;.846;3612000;0
26005;9426;102;0;0;0;0;.00nan;0;0
26006;4523;90;75;40;3;37;.925;3036000;0
26006;6367;90;27;7;3;4;.571;564000;0
26006;6579;87;89;34;1;33;.971;3600000;0
26006;7329;87;0;0;0;0;.00nan;0;0
26007;6418;92;49;36;5;31;.861;3600000;0
26007;7333;85;58;9;0;9;1.000;1203000;0
26007;9378;85;20;24;6;18;.750;2352000;0
26007;9400;92;0;0;0;0;.00nan;0;0
26008;3867;95;77;33;2;31;.939;3600000;0
26008;4603;86;51;25;4;21;.840;3568000;0
26008;4771;86;0;0;0;0;.00nan;0;0
26008;6448;95;0;0;0;0;.00nan;0;0
26009;4666;93;0;0;0;0;.00nan;0;0
26009;6418;92;0;0;0;0;.00nan;0;0
26009;9273;93;69;37;3;34;.919;3600000;0
26009;9400;92;70;40;4;36;.900;3574000;0
26010;4629;100;52;11;1;10;.909;1820000;0
26010;5976;94;77;41;4;37;.902;3600000;0
26010;7787;97;26;16;4;12;.750;1777000;0
26010;7876;100;0;0;0;0;.00nan;0;0
26011;4480;100;78;28;2;26;.929;3600000;0
26011;6503;100;0;0;0;0;.00nan;0;0
26011;7790;101;0;0;0;0;.00nan;0;0
26011;9386;101;68;37;4;33;.892;3556000;0
26012;6579;87;0;0;0;0;.00nan;0;0
26012;7329;87;88;27;1;26;.963;3600000;0
26012;7333;85;0;0;0;0;.00nan;0;0
26012;9378;85;17;25;6;19;.760;3600000;0
26013;3867;95;0;0;0;0;.00nan;0;0
26013;4697;84;76;18;0;18;1.000;3100000;0
26013;6448;95;62;41;5;36;.878;3844000;0
26013;7801;84;32;15;4;11;.733;744000;0
26014;4705;91;71;41;4;37;.902;3624000;0
26014;6631;98;58;26;3;23;.885;3589000;0
26014;7426;98;0;0;0;0;.00nan;0;0
26014;8043;91;0;0;0;0;.00nan;0;0
26015;4523;90;0;0;0;0;.00nan;0;0
26015;6367;90;52;31;4;27;.871;3900000;0
26015;6401;88;67;38;4;34;.895;3900000;0
26015;6593;103;0;0;0;0;.00nan;0;0
26016;4838;102;0;0;0;0;.00nan;0;0
26016;4872;89;33;18;5;13;.722;3600000;0
26016;5966;89;0;0;0;0;.00nan;0;0
26016;9426;102;77;29;2;27;.931;3600000;0
26017;4523;90;53;45;6;39;.867;3424000;0
26017;4754;96;32;35;6;29;.829;3581000;0
26017;6367;90;47;4;1;3;.750;165000;0
26017;9413;96;50;0;0;0;.00nan;19000;0
26018;5976;94;0;0;0;0;.00nan;0;0
26018;6418;92;76;36;3;33;.917;3600000;0
26018;7876;100;75;42;4;38;.905;3599000;0
26018;9400;92;0;0;0;0;.00nan;0;0
26019;6579;87;55;20;3;17;.850;3600000;0
26019;7329;87;0;0;0;0;.00nan;0;0
26019;7333;85;66;38;4;34;.895;3578000;0
26019;9378;85;0;0;0;0;.00nan;0;0
26020;4603;86;0;0;0;0;.00nan;0;0
26020;4643;99;29;36;6;30;.833;3600000;0
26020;4771;86;62;28;3;25;.893;3600000;0
26020;6581;99;0;0;0;0;.00nan;0;0
26021;4480;100;0;0;0;0;.00nan;0;0
26021;4838;102;71;38;3;35;.921;3900000;0
26021;6503;100;51;27;3;24;.889;3900000;0
26021;9426;102;0;0;0;0;.00nan;0;0
26022;4872;89;0;0;0;0;.00nan;0;0
26022;5966;89;60;26;3;23;.885;3600000;0
26022;5987;103;59;6;0;6;1.000;648000;0
26022;7323;103;28;32;6;26;.813;2952000;0
26023;4666;93;74;24;1;23;.958;3557000;0
26023;7333;85;0;0;0;0;.00nan;0;0
26023;8839;85;100;37;0;37;1.000;3600000;0
26023;9273;93;0;0;0;0;.00nan;0;0
26024;6631;98;0;0;0;0;.00nan;0;0
26024;7426;98;85;38;2;36;.947;3600000;0
26024;7790;101;66;36;4;32;.889;3600000;0
26024;9386;101;0;0;0;0;.00nan;0;0
26025;4697;84;17;20;6;14;.700;2285000;0
26025;6579;87;62;41;4;37;.902;3600000;0
26025;7329;87;0;0;0;0;.00nan;0;0
26025;7801;84;57;11;1;10;.909;1315000;0
26026;3867;95;67;35;4;31;.886;3600000;0
26026;6448;95;0;0;0;0;.00nan;0;0
26026;6631;98;38;33;6;27;.818;3544000;0
26026;7426;98;0;0;0;0;.00nan;0;0
26027;4629;100;0;0;0;0;.00nan;0;0
26027;5976;94;76;44;4;40;.909;3600000;0
26027;7787;97;99;35;1;34;.971;3600000;0
26027;7876;100;0;0;0;0;.00nan;0;0
26028;4523;90;0;0;0;0;.00nan;0;0
26028;6367;90;50;30;4;26;.867;3600000;0
26028;7333;85;48;0;0;0;.00nan;228000;0
26028;8839;85;50;47;7;40;.851;3372000;0
26029;4603;86;0;0;0;0;.00nan;0;0
26029;4771;86;81;47;4;43;.915;3600000;0
26029;6418;92;90;20;0;20;1.000;3600000;0
26029;9400;92;0;0;0;0;.00nan;0;0
26030;4705;91;0;0;0;0;.00nan;0;0
26030;4872;89;0;0;0;0;.00nan;0;0
26030;5966;89;61;31;4;27;.871;3600000;0
26030;8043;91;74;20;1;19;.950;3600000;0
26031;4666;93;0;0;0;0;.00nan;0;0
26031;4838;102;70;49;5;44;.898;3600000;0
26031;9273;93;67;15;1;14;.933;3600000;0
26031;9426;102;0;0;0;0;.00nan;0;0
26032;4643;99;74;31;2;29;.935;3600000;0
26032;6581;99;0;0;0;0;.00nan;0;0
26032;7790;101;60;44;5;39;.886;3600000;0
26032;9386;101;0;0;0;0;.00nan;0;0
26033;4480;100;65;40;4;36;.900;3820000;0
26033;4754;96;0;0;0;0;.00nan;0;0
26033;6503;100;0;0;0;0;.00nan;0;0
26033;9413;96;64;28;3;25;.893;3820000;0
26034;4603;86;51;35;5;30;.857;3600000;0
26034;4629;100;61;24;3;21;.875;3600000;0
26034;4771;86;0;0;0;0;.00nan;0;0
26034;7787;97;0;0;0;0;.00nan;0;0
26035;4666;93;47;12;2;10;.833;3600000;0
26035;7790;101;0;0;0;0;.00nan;0;0
26035;9273;93;0;0;0;0;.00nan;0;0
26035;9386;101;41;41;6;35;.854;3600000;0
26036;4523;90;82;47;3;44;.936;3900000;0
26036;6367;90;0;0;0;0;.00nan;0;0
26036;6418;92;74;26;3;23;.885;3900000;0
26036;9400;92;0;0;0;0;.00nan;0;0
26037;4643;99;0;0;0;0;.00nan;0;0
26037;6581;99;34;23;5;18;.783;3600000;0
26037;6631;98;0;0;0;0;.00nan;0;0
26037;7426;98;93;28;1;27;.964;3600000;0
26038;4754;96;42;27;5;22;.815;3600000;0
26038;4838;102;32;10;3;7;.700;593000;0
26038;9413;96;0;0;0;0;.00nan;0;0
26038;9426;102;46;35;6;29;.829;3007000;0
26039;4480;100;0;0;0;0;.00nan;0;0
26039;5987;103;0;0;0;0;.00nan;0;0
26039;6503;100;48;29;5;24;.828;3645000;0
26039;7323;103;66;43;4;39;.907;3645000;0
26040;4872;89;51;33;5;28;.848;3900000;0
26040;5966;89;0;0;0;0;.00nan;0;0
26040;6401;88;0;0;0;0;.00nan;0;0
26040;6593;103;52;39;5;34;.872;3900000;0
26041;4629;100;0;0;0;0;.00nan;0;0
26041;6418;92;0;0;0;0;.00nan;0;0
26041;7787;97;57;26;3;23;.885;3600000;0
26041;9400;92;36;21;4;17;.810;3598000;0
26042;4603;86;0;0;0;0;.00nan;0;0
26042;4771;86;84;28;1;27;.964;3600000;0
26042;7333;85;55;24;3;21;.875;1855000;0
26042;8839;85;11;17;6;11;.647;1745000;0
26043;4705;91;67;22;2;20;.909;3900000;0
26043;6401;88;64;30;2;28;.933;3900000;0
26043;6593;103;0;0;0;0;.00nan;0;0
26043;8043;91;0;0;0;0;.00nan;0;0
26044;5976;94;55;25;3;22;.880;3600000;0
26044;6579;87;44;27;4;23;.852;3550000;0
26044;7329;87;0;0;0;0;.00nan;0;0
26044;7876;100;0;0;0;0;.00nan;0;0
26045;4697;84;91;37;2;35;.946;3600000;0
26045;6401;88;0;0;0;0;.00nan;0;0
26045;6593;103;42;23;4;19;.826;3552000;0
26045;7801;84;0;0;0;0;.00nan;0;0
26046;4523;90;61;19;2;17;.895;3600000;0
26046;6367;90;0;0;0;0;.00nan;0;0
26046;7790;101;41;33;5;28;.848;3600000;0
26046;9386;101;0;0;0;0;.00nan;0;0
26047;4697;84;63;26;4;22;.846;3600000;0
26047;6401;88;49;37;6;31;.838;3600000;0
26047;6593;103;0;0;0;0;.00nan;0;0
26047;7801;84;0;0;0;0;.00nan;0;0
26048;3867;95;84;36;2;34;.944;3600000;0
26048;4754;96;34;29;6;23;.793;3157000;0
26048;7909;95;0;0;0;0;.00nan;0;0
26048;9413;96;48;7;1;6;.857;443000;0
26049;4705;91;0;0;0;0;.00nan;0;0
26049;5976;94;72;29;2;27;.931;3600000;0
26049;7876;100;0;0;0;0;.00nan;0;0
26049;8043;91;69;39;3;36;.923;3566000;0
26050;4603;86;0;0;0;0;.00nan;0;0
26050;4771;86;60;52;7;45;.865;3600000;0
26050;6579;87;62;33;4;29;.879;3600000;0
26050;7329;87;0;0;0;0;.00nan;0;0
26051;4480;100;59;33;4;29;.879;3600000;0
26051;4643;99;21;10;4;6;.600;786000;0
26051;6503;100;0;0;0;0;.00nan;0;0
26051;6581;99;76;30;2;28;.933;2748000;0
26052;4872;89;0;0;0;0;.00nan;0;0
26052;5966;89;68;19;1;18;.947;3600000;0
26052;6418;92;51;44;6;38;.864;3566000;0
26052;9400;92;50;0;0;0;.00nan;34000;0
26053;4629;100;61;22;2;20;.909;2106000;0
26053;4666;93;50;27;4;23;.852;3600000;0
26053;7787;97;15;20;6;14;.700;1494000;0
26053;9273;93;0;0;0;0;.00nan;0;0
26054;4480;100;0;0;0;0;.00nan;0;0
26054;6503;100;78;50;6;44;.880;3600000;0
26054;7790;101;0;0;0;0;.00nan;0;0
26054;9386;101;58;21;3;18;.857;3600000;0
26055;4697;84;0;0;0;0;.00nan;0;0
26055;4754;96;0;0;0;0;.00nan;0;0
26055;7801;84;83;31;3;28;.903;3600000;0
26055;9413;96;55;45;5;40;.889;3595000;0
26056;4872;89;27;23;5;18;.783;3560000;0
26056;5966;89;0;0;0;0;.00nan;0;0
26056;7333;85;0;0;0;0;.00nan;0;0
26056;8839;85;74;46;4;42;.913;3600000;0
26057;5976;94;0;0;0;0;.00nan;0;0
26057;6631;98;0;0;0;0;.00nan;0;0
26057;7426;98;68;29;3;26;.897;3557000;0
26057;7876;100;77;30;1;29;.967;3600000;0
26058;4523;90;0;0;0;0;.00nan;0;0
26058;4838;102;53;13;1;12;.923;1498000;0
26058;6367;90;67;31;3;28;.903;3600000;0
26058;9426;102;21;23;6;17;.739;2102000;0
26059;4705;91;58;19;2;17;.895;3600000;0
26059;5987;103;0;0;0;0;.00nan;0;0
26059;7323;103;50;36;5;31;.861;3600000;0
26059;8043;91;0;0;0;0;.00nan;0;0
26060;6418;92;30;26;5;21;.808;3900000;0
26060;7333;85;65;43;5;38;.884;3900000;0
26060;8839;85;0;0;0;0;.00nan;0;0
26060;9400;92;0;0;0;0;.00nan;0;0
26061;3867;95;79;41;3;38;.927;3893000;0
26061;6579;87;65;34;3;31;.912;3900000;0
26061;7329;87;0;0;0;0;.00nan;0;0
26061;7909;95;0;0;0;0;.00nan;0;0
26062;4629;100;0;0;0;0;.00nan;0;0
26062;6631;98;49;31;5;26;.839;3462000;0
26062;7426;98;54;4;0;4;1.000;290000;0
26062;7787;97;28;24;6;18;.750;3752000;0
26063;4603;86;0;0;0;0;.00nan;0;0
26063;4771;86;53;30;4;26;.867;3600000;0
26063;6401;88;0;0;0;0;.00nan;0;0
26063;6593;103;94;57;5;52;.912;3544000;0
26064;4643;99;22;38;7;31;.816;3598000;0
26064;4705;91;61;20;2;18;.900;3068000;0
26064;6581;99;0;0;0;0;.00nan;0;0
26064;8043;91;31;8;3;5;.625;532000;0
26065;4838;102;65;36;4;32;.889;3600000;0
26065;5987;103;70;46;5;41;.891;3577000;0
26065;7323;103;0;0;0;0;.00nan;0;0
26065;9426;102;0;0;0;0;.00nan;0;0
26066;4643;99;59;27;3;24;.889;3832000;0
26066;6581;99;0;0;0;0;.00nan;0;0
26066;7790;101;65;25;2;23;.920;3832000;0
26066;9386;101;0;0;0;0;.00nan;0;0
26067;4480;100;79;36;3;33;.917;3573000;0
26067;4872;89;0;0;0;0;.00nan;0;0
26067;5966;89;77;20;1;19;.950;3600000;0
26067;6503;100;0;0;0;0;.00nan;0;0
26068;4666;93;62;19;2;17;.895;3600000;0
26068;6631;98;0;0;0;0;.00nan;0;0
26068;7426;98;68;41;4;37;.902;3600000;0
26068;9273;93;0;0;0;0;.00nan;0;0
26069;4705;91;63;22;2;20;.909;3600000;0
26069;7333;85;63;5;0;5;1.000;446000;0
26069;8043;91;0;0;0;0;.00nan;0;0
26069;8839;85;48;40;6;34;.850;3154000;0
26070;6401;88;47;18;3;15;.833;3600000;0
26070;6418;92;50;43;6;37;.860;3600000;0
26070;6593;103;0;0;0;0;.00nan;0;0
26070;9400;92;0;0;0;0;.00nan;0;0
26071;4603;86;0;0;0;0;.00nan;0;0
26071;4771;86;63;46;5;41;.891;3900000;0
26071;4838;102;63;45;5;40;.889;3900000;0
26071;9426;102;0;0;0;0;.00nan;0;0
26072;4629;100;60;27;4;23;.852;3600000;0
26072;5987;103;0;0;0;0;.00nan;0;0
26072;7323;103;74;39;3;36;.923;3600000;0
26072;7787;97;0;0;0;0;.00nan;0;0
26073;4754;96;0;0;0;0;.00nan;0;0
26073;6631;98;89;32;1;31;.969;3600000;0
26073;7426;98;0;0;0;0;.00nan;0;0
26073;9413;96;52;31;4;27;.871;3600000;0
26074;3867;95;45;39;6;33;.846;2876000;0
26074;4697;84;72;33;3;30;.909;3600000;0
26074;7801;84;0;0;0;0;.00nan;0;0
26074;7909;95;71;14;0;14;1.000;724000;0
26075;5976;94;87;20;0;20;1.000;3600000;0
26075;7790;101;0;0;0;0;.00nan;0;0
26075;7876;100;0;0;0;0;.00nan;0;0
26075;9386;101;72;35;3;32;.914;3600000;0
26076;4523;90;74;33;3;30;.909;3600000;0
26076;4643;99;43;30;4;26;.867;3578000;0
26076;6367;90;0;0;0;0;.00nan;0;0
26076;6581;99;0;0;0;0;.00nan;0;0
26077;4480;100;0;0;0;0;.00nan;0;0
26077;6503;100;67;30;4;26;.867;3590000;0
26077;7333;85;0;0;0;0;.00nan;0;0
26077;8839;85;79;30;2;28;.933;3600000;0
26078;4872;89;0;0;0;0;.00nan;0;0
26078;5966;89;75;41;4;37;.902;3600000;0
26078;6579;87;30;23;5;18;.783;3593000;0
26078;7329;87;0;0;0;0;.00nan;0;0
26079;4666;93;0;0;0;0;.00nan;0;0
26079;6401;88;59;15;1;14;.933;1501000;0
26079;6593;103;42;31;6;25;.806;2099000;0
26079;9273;93;34;26;5;21;.808;3600000;0
26080;4523;90;0;0;0;0;.00nan;0;0
26080;4629;100;0;0;0;0;.00nan;0;0
26080;6367;90;69;35;3;32;.914;3600000;0
26080;7787;97;48;29;4;25;.862;3562000;0
26081;4603;86;0;0;0;0;.00nan;0;0
26081;4771;86;53;27;3;24;.889;3551000;0
26081;7790;101;95;39;2;37;.949;3600000;0
26081;9386;101;0;0;0;0;.00nan;0;0
26082;4754;96;61;22;2;20;.909;3600000;0
26082;4838;102;0;0;0;0;.00nan;0;0
26082;9413;96;0;0;0;0;.00nan;0;0
26082;9426;102;46;39;5;34;.872;3600000;0
26083;5987;103;54;37;5;32;.865;3600000;0
26083;6418;92;51;2;0;2;1.000;265000;0
26083;7323;103;0;0;0;0;.00nan;0;0
26083;9400;92;13;20;6;14;.700;3306000;0
26084;4697;84;0;0;0;0;.00nan;0;0
26084;6631;98;0;0;0;0;.00nan;0;0
26084;7426;98;74;46;4;42;.913;3900000;0
26084;7801;84;36;26;4;22;.846;3900000;0
26085;4480;100;100;48;1;47;.979;3900000;0
26085;6503;100;0;0;0;0;.00nan;0;0
26085;6579;87;0;0;0;0;.00nan;0;0
26085;7329;87;64;23;1;22;.957;3900000;0
26086;3867;95;40;22;5;17;.773;3600000;0
26086;5976;94;42;43;6;37;.860;3594000;0
26086;7876;100;0;0;0;0;.00nan;0;0
26086;7909;95;0;0;0;0;.00nan;0;0
26087;4523;90;67;36;5;31;.861;3737000;0
26087;4629;100;47;26;4;22;.846;3737000;0
26087;6367;90;0;0;0;0;.00nan;0;0
26087;7787;97;0;0;0;0;.00nan;0;0
26088;4666;93;49;27;4;23;.852;3600000;0
26088;4705;91;0;0;0;0;.00nan;0;0
26088;8043;91;58;38;5;33;.868;3559000;0
26088;9273;93;0;0;0;0;.00nan;0;0
26089;4603;86;38;25;5;20;.800;3562000;0
26089;4643;99;56;33;4;29;.879;3600000;0
26089;4771;86;50;0;0;0;.00nan;6000;0
26089;6581;99;0;0;0;0;.00nan;0;0
26090;4872;89;0;0;0;0;.00nan;0;0
26090;5966;89;47;10;2;8;.800;3600000;0
26090;7333;85;34;11;3;8;.727;709000;0
26090;8839;85;21;39;8;31;.795;2891000;0
26091;3867;95;0;0;0;0;.00nan;0;0
26091;4754;96;0;0;0;0;.00nan;0;0
26091;7909;95;58;29;3;26;.897;3879000;0
26091;9413;96;76;53;4;49;.925;3879000;0
26092;6401;88;0;0;0;0;.00nan;0;0
26092;6593;103;56;25;4;21;.840;3600000;0
26092;7333;85;0;0;0;0;.00nan;0;0
26092;8839;85;49;49;6;43;.878;3600000;0
26093;4643;99;0;0;0;0;.00nan;0;0
26093;6581;99;80;28;1;27;.964;3600000;0
26093;7790;101;68;36;3;33;.917;3600000;0
26093;9386;101;0;0;0;0;.00nan;0;0
26094;4523;90;57;35;5;30;.857;3687000;0
26094;5976;94;56;32;4;28;.875;3721000;0
26094;6367;90;0;0;0;0;.00nan;0;0
26094;7876;100;0;0;0;0;.00nan;0;0
26095;4629;100;0;0;0;0;.00nan;0;0
26095;6418;92;63;36;4;32;.889;3578000;0
26095;7787;97;51;28;3;25;.893;3600000;0
26095;9400;92;0;0;0;0;.00nan;0;0
26096;4705;91;0;0;0;0;.00nan;0;0
26096;6579;87;91;37;2;35;.946;3600000;0
26096;7329;87;0;0;0;0;.00nan;0;0
26096;8043;91;58;25;3;22;.880;3583000;0
26097;4603;86;0;0;0;0;.00nan;0;0
26097;4771;86;91;46;3;43;.935;3900000;0
26097;4872;89;78;37;3;34;.919;3900000;0
26097;5966;89;0;0;0;0;.00nan;0;0
26098;4697;84;70;31;3;28;.903;3600000;0
26098;6401;88;18;23;6;17;.739;1908000;0
26098;6593;103;52;10;1;9;.900;1692000;0
26098;7801;84;0;0;0;0;.00nan;0;0
26099;4838;102;67;37;4;33;.892;3562000;0
26099;6631;98;0;0;0;0;.00nan;0;0
26099;7426;98;46;19;3;16;.842;3600000;0
26099;9426;102;0;0;0;0;.00nan;0;0
26100;4480;100;0;0;0;0;.00nan;0;0
26100;5987;103;0;0;0;0;.00nan;0;0
26100;6503;100;67;37;3;34;.919;3600000;0
26100;7323;103;48;29;4;25;.862;3585000;0
26101;4480;100;57;35;4;31;.886;3600000;0
26101;7790;101;0;0;0;0;.00nan;0;0
26101;7876;100;0;0;0;0;.00nan;0;0
26101;9386;101;57;34;5;29;.853;3598000;0
26102;4643;99;28;8;3;5;.625;443000;0
26102;4754;96;0;0;0;0;.00nan;0;0
26102;6581;99;82;42;3;39;.929;3146000;0
26102;9413;96;61;38;4;34;.895;3600000;0
26103;4705;91;81;18;1;17;.944;3600000;0
26103;7333;85;49;15;2;13;.867;1304000;0
26103;8043;91;0;0;0;0;.00nan;0;0
26103;8839;85;23;33;7;26;.788;2296000;0
26104;4697;84;0;0;0;0;.00nan;0;0
26104;4872;89;0;0;0;0;.00nan;0;0
26104;5966;89;78;31;2;29;.935;3660000;0
26104;7801;84;93;38;1;37;.974;3660000;0
26105;3867;95;80;34;3;31;.912;3600000;0
26105;4534;94;0;0;0;0;.00nan;0;0
26105;5976;94;48;42;6;36;.857;3600000;0
26105;7909;95;0;0;0;0;.00nan;0;0
26106;4629;100;74;45;5;40;.889;3582000;0
26106;6579;87;44;17;3;14;.824;3600000;0
26106;7329;87;0;0;0;0;.00nan;0;0
26106;7787;97;0;0;0;0;.00nan;0;0
26107;4666;93;88;30;1;29;.967;3600000;0
26107;6418;92;0;0;0;0;.00nan;0;0
26107;9273;93;0;0;0;0;.00nan;0;0
26107;9400;92;93;48;2;46;.958;3568000;0
26108;6631;98;0;0;0;0;.00nan;0;0
26108;7426;98;58;12;1;11;.917;3600000;0
26108;7790;101;74;45;4;41;.911;3600000;0
26108;9386;101;0;0;0;0;.00nan;0;0
26109;4754;96;29;23;5;18;.783;3559000;0
26109;7333;85;0;0;0;0;.00nan;0;0
26109;8839;85;78;43;3;40;.930;3600000;0
26109;9413;96;0;0;0;0;.00nan;0;0
26110;4523;90;0;0;0;0;.00nan;0;0
26110;4603;86;0;0;0;0;.00nan;0;0
26110;4771;86;63;31;4;27;.871;3869000;0
26110;6367;90;40;25;4;21;.840;3900000;0
26111;3867;95;49;1;0;1;1.000;108000;0
26111;6401;88;0;0;0;0;.00nan;0;0
26111;6593;103;87;39;3;36;.923;3600000;0
26111;7909;95;22;28;6;22;.786;3492000;0
26112;4838;102;54;30;3;27;.900;3600000;0
26112;5987;103;34;35;6;29;.829;3581000;0
26112;7323;103;0;0;0;0;.00nan;0;0
26112;9426;102;0;0;0;0;.00nan;0;0
26113;4534;94;0;0;0;0;.00nan;0;0
26113;4629;100;0;0;0;0;.00nan;0;0
26113;5976;94;65;31;4;27;.871;3900000;0
26113;7787;97;41;24;4;20;.833;3900000;0
26114;4523;90;86;31;2;29;.935;3600000;0
26114;4697;84;49;48;7;41;.854;3600000;0
26114;6367;90;0;0;0;0;.00nan;0;0
26114;7801;84;0;0;0;0;.00nan;0;0
26115;4705;91;0;0;0;0;.00nan;0;0
26115;6418;92;44;41;6;35;.854;3600000;0
26115;8043;91;71;23;2;21;.913;3600000;0
26115;9400;92;0;0;0;0;.00nan;0;0
26116;4872;89;0;0;0;0;.00nan;0;0
26116;5966;89;70;37;4;33;.892;3600000;0
26116;6579;87;7;33;8;25;.758;3600000;0
26116;7329;87;0;0;0;0;.00nan;0;0
26117;4480;100;0;0;0;0;.00nan;0;0
26117;4643;99;70;31;2;29;.935;3600000;0
26117;6581;99;0;0;0;0;.00nan;0;0
26117;7876;100;56;25;3;22;.880;3570000;0
26118;5987;103;0;0;0;0;.00nan;0;0
26118;6631;98;39;27;5;22;.815;3600000;0
26118;7323;103;51;41;6;35;.854;3591000;0
26118;7426;98;0;0;0;0;.00nan;0;0
26119;4838;102;0;0;0;0;.00nan;0;0
26119;7790;101;73;41;4;37;.902;3600000;0
26119;9386;101;0;0;0;0;.00nan;0;0
26119;9426;102;48;35;5;30;.857;3596000;0
26120;4603;86;0;0;0;0;.00nan;0;0
26120;4697;84;0;0;0;0;.00nan;0;0
26120;4771;86;51;33;4;29;.879;3900000;0
26120;7801;84;72;39;4;35;.897;3900000;0
26121;4523;90;39;24;5;19;.792;3600000;0
26121;4754;96;0;0;0;0;.00nan;0;0
26121;6367;90;0;0;0;0;.00nan;0;0
26121;9413;96;76;26;2;24;.923;3600000;0
26122;3867;95;49;17;2;15;.882;3600000;0
26122;4629;100;72;42;4;38;.905;3600000;0
26122;7787;97;0;0;0;0;.00nan;0;0
26122;7909;95;0;0;0;0;.00nan;0;0
26123;4523;90;43;11;2;9;.818;998000;0
26123;6367;90;44;35;6;29;.829;2602000;0
26123;6579;87;49;20;3;17;.850;3600000;0
26123;7329;87;0;0;0;0;.00nan;0;0
26124;4705;91;100;32;0;32;1.000;3600000;0
26124;6401;88;78;50;4;46;.920;3600000;0
26124;6593;103;0;0;0;0;.00nan;0;0
26124;8043;91;0;0;0;0;.00nan;0;0
26125;4754;96;0;0;0;0;.00nan;0;0
26125;4838;102;0;0;0;0;.00nan;0;0
26125;9413;96;69;28;3;25;.893;3792000;0
26125;9426;102;66;35;4;31;.886;3792000;0
26126;6401;88;0;0;0;0;.00nan;0;0
26126;6593;103;45;24;4;20;.833;3600000;0
26126;7333;85;0;0;0;0;.00nan;0;0
26126;8839;85;91;36;1;35;.972;3600000;0
26127;4697;84;73;54;5;49;.907;3600000;0
26127;4705;91;81;25;1;24;.960;3600000;0
26127;7801;84;0;0;0;0;.00nan;0;0
26127;8043;91;0;0;0;0;.00nan;0;0
26128;3867;95;0;0;0;0;.00nan;0;0
26128;6631;98;52;2;0;2;1.000;69000;0
26128;7426;98;63;39;5;34;.872;3473000;0
26128;7909;95;53;35;4;31;.886;3600000;0
26129;4534;94;0;0;0;0;.00nan;0;0
26129;5976;94;62;30;3;27;.900;3600000;0
26129;5987;103;0;0;0;0;.00nan;0;0
26129;7323;103;92;34;2;32;.941;3600000;0
26130;4643;99;30;26;6;20;.769;2276000;0
26130;6418;92;59;16;1;15;.938;3600000;0
26130;6581;99;35;7;2;5;.714;1324000;0
26130;9400;92;0;0;0;0;.00nan;0;0
26131;4666;93;62;31;4;27;.871;3600000;0
26131;4872;89;0;0;0;0;.00nan;0;0
26131;5966;89;45;34;5;29;.853;3600000;0
26131;9273;93;0;0;0;0;.00nan;0;0
26132;4666;93;0;0;0;0;.00nan;0;0
26132;7333;85;0;0;0;0;.00nan;0;0
26132;8839;85;70;45;5;40;.889;3555000;0
26132;9273;93;34;9;3;6;.667;3600000;0
26133;4629;100;0;0;0;0;.00nan;0;0
26133;6401;88;48;34;5;29;.853;3600000;0
26133;6593;103;0;0;0;0;.00nan;0;0
26133;7787;97;55;30;4;26;.867;3600000;0
26134;4534;94;85;29;2;27;.931;3600000;0
26134;5976;94;0;0;0;0;.00nan;0;0
26134;7790;101;47;45;8;37;.822;3600000;0
26134;9386;101;0;0;0;0;.00nan;0;0
26135;4603;86;0;0;0;0;.00nan;0;0
26135;4771;86;90;55;4;51;.927;3600000;0
26135;6579;87;60;19;2;17;.895;3600000;0
26135;7329;87;0;0;0;0;.00nan;0;0
26136;4838;102;64;43;5;38;.884;3600000;0
26136;6631;98;51;21;4;17;.810;3600000;0
26136;7426;98;0;0;0;0;.00nan;0;0
26136;9426;102;0;0;0;0;.00nan;0;0
26137;4480;100;74;31;3;28;.903;3600000;0
26137;4643;99;50;0;0;0;.00nan;39000;0
26137;6581;99;41;40;6;34;.850;3557000;0
26137;7876;100;0;0;0;0;.00nan;0;0
26138;5987;103;41;34;6;28;.824;3554000;0
26138;6418;92;0;0;0;0;.00nan;0;0
26138;7323;103;0;0;0;0;.00nan;0;0
26138;9400;92;59;33;4;29;.879;3600000;0
26139;4643;99;76;28;1;27;.964;3600000;0
26139;6581;99;0;0;0;0;.00nan;0;0
26139;7790;101;0;0;0;0;.00nan;0;0
26139;9386;101;48;22;3;19;.864;3573000;0
26140;3867;95;43;32;5;27;.844;3600000;0
26140;4754;96;0;0;0;0;.00nan;0;0
26140;7909;95;0;0;0;0;.00nan;0;0
26140;9413;96;66;39;4;35;.897;3600000;0
26141;4697;84;0;0;0;0;.00nan;0;0
26141;6579;87;50;0;0;0;.00nan;42000;0
26141;7329;87;34;35;6;29;.829;3558000;0
26141;7801;84;67;32;3;29;.906;3600000;0
26142;4603;86;14;34;8;26;.765;3310000;0
26142;4705;91;32;23;5;18;.783;3600000;0
26142;4771;86;54;3;0;3;1.000;290000;0
26142;8043;91;0;0;0;0;.00nan;0;0
26143;4480;100;65;9;0;9;1.000;1127000;0
26143;4534;94;0;0;0;0;.00nan;0;0
26143;5976;94;49;20;3;17;.850;3600000;0
26143;7876;100;37;28;5;23;.821;2400000;0
26144;4523;90;0;0;0;0;.00nan;0;0
26144;4872;89;81;39;3;36;.923;3753000;0
26144;5966;89;0;0;0;0;.00nan;0;0
26144;6367;90;57;35;4;31;.886;3753000;0
26145;6418;92;76;30;2;28;.933;3600000;0
26145;6631;98;0;0;0;0;.00nan;0;0
26145;7426;98;65;31;3;28;.903;3550000;0
26145;9400;92;0;0;0;0;.00nan;0;0
26146;4666;93;42;21;3;18;.857;3600000;0
26146;7790;101;49;41;6;35;.854;3345000;0
26146;9273;93;0;0;0;0;.00nan;0;0
26146;9386;101;51;2;0;2;1.000;255000;0
26147;4480;100;0;0;0;0;.00nan;0;0
26147;6418;92;0;0;0;0;.00nan;0;0
26147;7876;100;68;39;4;35;.897;3600000;0
26147;9400;92;72;25;1;24;.960;3600000;0
26148;4534;94;0;0;0;0;.00nan;0;0
26148;5976;94;60;39;5;34;.872;3572000;0
26148;6401;88;0;0;0;0;.00nan;0;0
26148;6593;103;68;31;3;28;.903;3600000;0
26149;3867;95;78;40;5;35;.875;3600000;0
26149;5987;103;24;5;3;2;.400;527000;0
26149;7323;103;7;30;8;22;.733;3073000;0
26149;7909;95;0;0;0;0;.00nan;0;0
26150;4480;100;70;43;5;38;.884;3600000;0
26150;4629;100;0;0;0;0;.00nan;0;0
26150;7787;97;0;0;0;0;.00nan;0;0
26150;7870;97;58;23;2;21;.913;3600000;0
26151;4666;93;0;0;0;0;.00nan;0;0
26151;4754;96;0;0;0;0;.00nan;0;0
26151;9273;93;46;31;5;26;.839;3600000;0
26151;9413;96;70;30;2;28;.933;3600000;0
26152;4697;84;52;19;2;17;.895;3542000;0
26152;6401;88;98;39;1;38;.974;3600000;0
26152;6593;103;0;0;0;0;.00nan;0;0
26152;7801;84;0;0;0;0;.00nan;0;0
26153;3867;95;0;0;0;0;.00nan;0;0
26153;6579;87;93;19;0;19;1.000;3600000;0
26153;7329;87;0;0;0;0;.00nan;0;0
26153;7909;95;87;45;3;42;.933;3600000;0
26154;4534;94;45;53;7;46;.868;3531000;0
26154;5976;94;49;1;0;1;1.000;69000;0
26154;6631;98;0;0;0;0;.00nan;0;0
26154;7426;98;40;23;4;19;.826;3600000;0
26155;4523;90;80;26;1;25;.962;3600000;0
26155;6367;90;0;0;0;0;.00nan;0;0
26155;7333;85;0;0;0;0;.00nan;0;0
26155;8839;85;33;30;5;25;.833;3600000;0
26156;4643;99;0;0;0;0;.00nan;0;0
26156;4838;102;76;42;3;39;.929;3761000;0
26156;6581;99;46;24;4;20;.833;3761000;0
26156;9426;102;0;0;0;0;.00nan;0;0
26157;4872;89;0;0;0;0;.00nan;0;0
26157;5966;89;60;25;3;22;.880;3600000;0
26157;7790;101;0;0;0;0;.00nan;0;0
26157;9386;101;58;33;4;29;.879;3600000;0
26158;4523;90;0;0;0;0;.00nan;0;0
26158;6367;90;72;27;2;25;.926;3600000;0
26158;7333;85;45;29;5;24;.828;3600000;0
26158;8839;85;0;0;0;0;.00nan;0;0
26159;4643;99;32;30;6;24;.800;3361000;0
26159;6418;92;43;23;4;19;.826;3600000;0
26159;6581;99;48;0;0;0;.00nan;184000;0
26159;9400;92;0;0;0;0;.00nan;0;0
26160;3867;95;100;26;0;26;1.000;3600000;0
26160;6631;98;62;33;4;29;.879;3600000;0
26160;7426;98;0;0;0;0;.00nan;0;0
26160;7909;95;0;0;0;0;.00nan;0;0
26161;4697;84;0;0;0;0;.00nan;0;0
26161;6401;88;0;0;0;0;.00nan;0;0
26161;6593;103;55;30;4;26;.867;3600000;0
26161;7801;84;65;41;5;36;.878;3566000;0
26162;4838;102;0;0;0;0;.00nan;0;0
26162;5987;103;0;0;0;0;.00nan;0;0
26162;7323;103;52;36;5;31;.861;3630000;0
26162;9426;102;50;46;6;40;.870;3630000;0
26163;4643;99;73;40;4;36;.900;3699000;0
26163;6581;99;0;0;0;0;.00nan;0;0
26163;7787;97;61;29;3;26;.897;3699000;0
26163;7870;97;0;0;0;0;.00nan;0;0
26164;4534;94;0;0;0;0;.00nan;0;0
26164;4754;96;6;15;6;9;.600;2773000;0
26164;5976;94;77;43;4;39;.907;3600000;0
26164;9413;96;45;6;1;5;.833;827000;0
26165;4480;100;0;0;0;0;.00nan;0;0
26165;4523;90;44;30;6;24;.800;3600000;0
26165;4629;100;82;44;4;40;.909;3600000;0
26165;6367;90;0;0;0;0;.00nan;0;0
26166;4705;91;0;0;0;0;.00nan;0;0
26166;7790;101;36;20;4;16;.800;1848000;0
26166;8043;91;57;15;2;13;.867;3600000;0
26166;9386;101;54;27;3;24;.889;1752000;0
26167;4666;93;85;19;0;19;1.000;3600000;0
26167;4872;89;0;0;0;0;.00nan;0;0
26167;5966;89;59;39;4;35;.897;3600000;0
26167;9273;93;0;0;0;0;.00nan;0;0
26168;4603;86;19;9;4;5;.556;650000;0
26168;4771;86;20;24;6;18;.750;2950000;0
26168;7333;85;0;0;0;0;.00nan;0;0
26168;8839;85;69;30;3;27;.900;3600000;0
26169;3867;95;58;26;3;23;.885;3600000;0
26169;4534;94;0;0;0;0;.00nan;0;0
26169;5976;94;42;32;5;27;.844;3577000;0
26169;7909;95;0;0;0;0;.00nan;0;0
26170;4754;96;0;0;0;0;.00nan;0;0
26170;6631;98;0;0;0;0;.00nan;0;0
26170;7426;98;38;26;4;22;.846;3900000;0
26170;9413;96;81;45;4;41;.911;3900000;0
26171;4480;100;0;0;0;0;.00nan;0;0
26171;4629;100;66;17;1;16;.941;3600000;0
26171;4872;89;0;0;0;0;.00nan;0;0
26171;5966;89;56;33;4;29;.879;3600000;0
26172;4603;86;40;27;5;22;.815;3600000;0
26172;4771;86;0;0;0;0;.00nan;0;0
26172;6401;88;91;40;2;38;.950;3600000;0
26172;6593;103;0;0;0;0;.00nan;0;0
26173;4534;94;75;42;4;38;.905;3600000;0
26173;5976;94;0;0;0;0;.00nan;0;0
26173;6418;92;27;14;4;10;.714;933000;0
26173;9400;92;49;19;2;17;.895;2606000;0
26174;4705;91;76;24;1;23;.958;3600000;0
26174;7787;97;51;46;6;40;.870;2854000;0
26174;7870;97;58;5;0;5;1.000;746000;0
26174;8043;91;0;0;0;0;.00nan;0;0
26175;4838;102;21;21;6;15;.714;3181000;0
26175;5987;103;0;0;0;0;.00nan;0;0
26175;7323;103;78;48;3;45;.938;3600000;0
26175;9426;102;49;1;0;1;1.000;419000;0
26176;4838;102;0;0;0;0;.00nan;0;0
26176;7790;101;26;29;6;23;.793;3582000;0
26176;9386;101;0;0;0;0;.00nan;0;0
26176;9426;102;41;28;5;23;.821;3600000;0
26177;4754;96;71;20;1;19;.950;3600000;0
26177;5987;103;82;34;2;32;.941;3572000;0
26177;7323;103;0;0;0;0;.00nan;0;0
26177;9413;96;0;0;0;0;.00nan;0;0
26178;4666;93;8;25;8;17;.680;3453000;0
26178;4697;84;52;30;4;26;.867;3106000;0
26178;7801;84;41;13;3;10;.769;494000;0
26178;9273;93;48;0;0;0;.00nan;102000;0
26179;3867;95;65;17;1;16;.941;3600000;0
26179;7333;85;51;2;0;2;1.000;320000;0
26179;7909;95;0;0;0;0;.00nan;0;0
26179;8839;85;78;45;5;40;.889;3280000;0
26180;4534;94;51;3;0;3;1.000;149000;0
26180;4643;99;54;32;5;27;.844;3600000;0
26180;5976;94;43;35;6;29;.829;3403000;0
26180;6581;99;0;0;0;0;.00nan;0;0
26181;4523;90;0;0;0;0;.00nan;0;0
26181;4705;91;0;0;0;0;.00nan;0;0
26181;6367;90;49;46;5;41;.891;3575000;0
26181;8043;91;58;19;3;16;.842;3600000;0
26182;6401;88;0;0;0;0;.00nan;0;0
26182;6579;87;64;37;4;33;.892;3572000;0
26182;6593;103;74;35;3;32;.914;3600000;0
26182;7329;87;0;0;0;0;.00nan;0;0
26183;4480;100;53;39;6;33;.846;3166000;0
26183;4629;100;52;4;0;4;1.000;434000;0
26183;6631;98;0;0;0;0;.00nan;0;0
26183;7426;98;87;33;1;32;.970;3600000;0
26184;4872;89;69;31;3;28;.903;3600000;0
26184;5966;89;0;0;0;0;.00nan;0;0
26184;7787;97;0;0;0;0;.00nan;0;0
26184;7870;97;59;43;5;38;.884;3575000;0
26185;3867;95;0;0;0;0;.00nan;0;0
26185;4754;96;0;0;0;0;.00nan;0;0
26185;7909;95;75;35;3;32;.914;3600000;0
26185;9413;96;54;31;4;27;.871;3600000;0
26186;4697;84;55;2;0;2;1.000;328000;0
26186;7333;85;30;25;6;19;.760;3061000;0
26186;7801;84;54;42;6;36;.857;3272000;0
26186;8839;85;34;5;2;3;.600;488000;0
26187;4603;86;27;22;5;17;.773;2490000;0
26187;4666;93;0;0;0;0;.00nan;0;0
26187;4771;86;24;15;5;10;.667;1110000;0
26187;9273;93;73;21;1;20;.952;3600000;0
26188;6401;88;76;29;2;27;.931;3900000;0
26188;6418;92;82;38;2;36;.947;3900000;0
26188;6593;103;0;0;0;0;.00nan;0;0
26188;9400;92;0;0;0;0;.00nan;0;0
26189;4838;102;68;31;3;28;.903;3600000;0
26189;7790;101;48;0;0;0;.00nan;185000;0
26189;9386;101;39;35;6;29;.829;3415000;0
26189;9426;102;0;0;0;0;.00nan;0;0
26190;4523;90;32;29;6;23;.793;3600000;0
26190;4643;99;0;0;0;0;.00nan;0;0
26190;6367;90;0;0;0;0;.00nan;0;0
26190;6581;99;86;36;3;33;.917;3600000;0
26191;4872;89;0;0;0;0;.00nan;0;0
26191;5966;89;80;63;4;59;.937;3574000;0
26191;6631;98;81;35;2;33;.943;3600000;0
26191;7426;98;0;0;0;0;.00nan;0;0
26192;4523;90;0;0;0;0;.00nan;0;0
26192;4697;84;88;44;5;39;.886;3637000;0
26192;6367;90;53;28;4;24;.857;3637000;0
26192;7801;84;0;0;0;0;.00nan;0;0
26193;4705;91;44;21;3;18;.857;3600000;0
26193;6631;98;65;12;0;12;1.000;1257000;0
26193;7426;98;33;30;6;24;.800;2343000;0
26193;8043;91;0;0;0;0;.00nan;0;0
26194;4754;96;90;43;2;41;.953;3600000;0
26194;6579;87;59;25;3;22;.880;3589000;0
26194;7329;87;0;0;0;0;.00nan;0;0
26194;9413;96;0;0;0;0;.00nan;0;0
26195;4603;86;0;0;0;0;.00nan;0;0
26195;4771;86;79;29;2;27;.931;3600000;0
26195;6418;92;0;0;0;0;.00nan;0;0
26195;9400;92;52;26;3;23;.885;3581000;0
26196;4480;100;72;39;4;35;.897;3550000;0
26196;4629;100;0;0;0;0;.00nan;0;0
26196;7787;97;75;33;3;30;.909;3600000;0
26196;7870;97;0;0;0;0;.00nan;0;0
26197;4534;94;0;0;0;0;.00nan;0;0
26197;5976;94;100;42;2;40;.952;3600000;0
26197;5987;103;0;0;0;0;.00nan;0;0
26197;7323;103;46;28;4;24;.857;3560000;0
26198;3867;95;46;37;6;31;.838;3600000;0
26198;6631;98;0;0;0;0;.00nan;0;0
26198;7426;98;69;18;2;16;.889;3600000;0
26198;7909;95;0;0;0;0;.00nan;0;0
26199;4480;100;44;5;1;4;.800;697000;0
26199;4629;100;66;53;6;47;.887;2903000;0
26199;4666;93;92;36;2;34;.944;3600000;0
26199;9273;93;0;0;0;0;.00nan;0;0
26200;4697;84;56;13;1;12;.923;591000;0
26200;6418;92;58;38;5;33;.868;3600000;0
26200;7801;84;14;18;6;12;.667;2962000;0
26200;9400;92;0;0;0;0;.00nan;0;0
26201;4534;94;67;27;2;25;.926;1577000;0
26201;4705;91;58;12;1;11;.917;3600000;0
26201;5976;94;14;36;8;28;.778;2023000;0
26201;8043;91;0;0;0;0;.00nan;0;0
26202;6401;88;44;24;4;20;.833;3576000;0
26202;6579;87;67;29;3;26;.897;3600000;0
26202;6593;103;0;0;0;0;.00nan;0;0
26202;7329;87;0;0;0;0;.00nan;0;0
26203;4643;99;69;43;5;38;.884;3600000;0
26203;4838;102;69;23;2;21;.913;3600000;0
26203;6581;99;0;0;0;0;.00nan;0;0
26203;9426;102;0;0;0;0;.00nan;0;0
26204;4523;90;36;27;5;22;.815;3565000;0
26204;5987;103;0;0;0;0;.00nan;0;0
26204;6367;90;0;0;0;0;.00nan;0;0
26204;7323;103;60;32;3;29;.906;3600000;0
26205;3867;95;65;15;1;14;.933;3600000;0
26205;4480;100;78;49;5;44;.898;3600000;0
26205;4629;100;0;0;0;0;.00nan;0;0
26205;7909;95;0;0;0;0;.00nan;0;0
26206;4523;90;0;0;0;0;.00nan;0;0
26206;4666;93;0;0;0;0;.00nan;0;0
26206;6367;90;48;35;5;30;.857;3558000;0
26206;9273;93;52;31;4;27;.871;3600000;0
26207;4603;86;21;9;4;5;.556;435000;0
26207;4771;86;64;41;5;36;.878;3165000;0
26207;6579;87;0;0;0;0;.00nan;0;0
26207;7329;87;63;24;2;22;.917;3600000;0
26208;4643;99;0;0;0;0;.00nan;0;0
26208;5987;103;37;27;5;22;.815;3514000;0
26208;6581;99;68;31;3;28;.903;3600000;0
26208;7323;103;0;0;0;0;.00nan;0;0
26209;4534;94;59;20;2;18;.900;3600000;0
26209;4872;89;0;0;0;0;.00nan;0;0
26209;5966;89;26;35;7;28;.800;3600000;0
26209;5976;94;0;0;0;0;.00nan;0;0
26210;4666;93;54;37;4;33;.892;3580000;0
26210;6579;87;70;29;3;26;.897;3600000;0
26210;7329;87;0;0;0;0;.00nan;0;0
26210;9273;93;0;0;0;0;.00nan;0;0
26211;6418;92;44;29;4;25;.862;3600000;0
26211;7787;97;0;0;0;0;.00nan;0;0
26211;7870;97;99;37;1;36;.973;3600000;0
26211;9400;92;0;0;0;0;.00nan;0;0
26212;4643;99;1;11;6;5;.455;1760000;0
26212;6581;99;55;16;2;14;.875;1840000;0
26212;7790;101;63;41;5;36;.878;3600000;0
26212;9386;101;0;0;0;0;.00nan;0;0
26213;4705;91;0;0;0;0;.00nan;0;0
26213;7333;85;0;0;0;0;.00nan;0;0
26213;8043;91;42;28;4;24;.857;3600000;0
26213;8839;85;53;37;5;32;.865;3589000;0
26214;4603;86;48;0;0;0;.00nan;64000;0
26214;4697;84;0;0;0;0;.00nan;0;0
26214;4771;86;45;38;6;32;.842;3536000;0
26214;7801;84;73;27;2;25;.926;3600000;0
26215;3867;95;98;31;1;30;.968;3600000;0
26215;4534;94;0;0;0;0;.00nan;0;0
26215;5976;94;66;26;2;24;.923;3595000;0
26215;7909;95;0;0;0;0;.00nan;0;0
26216;4523;90;0;0;0;0;.00nan;0;0
26216;6367;90;60;30;4;26;.867;3805000;0
26216;6631;98;0;0;0;0;.00nan;0;0
26216;7426;98;76;35;3;32;.914;3805000;0
26217;4754;96;54;16;2;14;.875;981000;0
26217;6401;88;0;0;0;0;.00nan;0;0
26217;6593;103;73;31;3;28;.903;3600000;0
26217;9413;96;21;21;6;15;.714;2619000;0
26218;4838;102;0;0;0;0;.00nan;0;0
26218;5987;103;0;0;0;0;.00nan;0;0
26218;7323;103;73;39;3;36;.923;3574000;0
26218;9426;102;64;24;2;22;.917;3600000;0
26219;4480;100;66;25;2;23;.920;3600000;0
26219;4629;100;0;0;0;0;.00nan;0;0
26219;4872;89;50;0;0;0;.00nan;48000;0
26219;5966;89;37;39;7;32;.821;3552000;0
26220;5987;103;56;26;4;22;.846;3600000;0
26220;7323;103;0;0;0;0;.00nan;0;0
26220;7790;101;43;5;1;4;.800;552000;0
26220;9386;101;21;41;8;33;.805;3048000;0
26221;4754;96;67;19;2;17;.895;3900000;0
26221;7333;85;64;29;2;27;.931;3900000;0
26221;8839;85;0;0;0;0;.00nan;0;0
26221;9413;96;0;0;0;0;.00nan;0;0
26222;3867;95;54;3;0;3;1.000;465000;0
26222;7787;97;84;33;2;31;.939;3600000;0
26222;7870;97;0;0;0;0;.00nan;0;0
26222;7909;95;30;33;7;26;.788;3135000;0
26223;4523;90;24;10;4;6;.600;747000;0
26223;4697;84;72;20;2;18;.900;3600000;0
26223;6367;90;57;39;5;34;.872;2853000;0
26223;7801;84;0;0;0;0;.00nan;0;0
26224;4705;91;77;22;1;21;.955;3600000;0
26224;6579;87;0;0;0;0;.00nan;0;0
26224;7329;87;68;37;4;33;.892;3600000;0
26224;8043;91;0;0;0;0;.00nan;0;0
26225;4603;86;67;34;3;31;.912;3600000;0
26225;4771;86;0;0;0;0;.00nan;0;0
26225;6401;88;63;33;4;29;.879;3550000;0
26225;6593;103;0;0;0;0;.00nan;0;0
26226;4666;93;0;0;0;0;.00nan;0;0
26226;6631;98;86;30;1;29;.967;3769000;0
26226;7426;98;0;0;0;0;.00nan;0;0
26226;9273;93;93;41;2;39;.951;3769000;0
26227;4534;94;78;17;1;16;.941;3600000;0
26227;4643;99;58;52;6;46;.885;3223000;0
26227;5976;94;0;0;0;0;.00nan;0;0
26227;6581;99;52;9;1;8;.889;377000;0
26228;4480;100;0;0;0;0;.00nan;0;0
26228;4629;100;84;39;2;37;.949;3600000;0
26228;4838;102;54;27;4;23;.852;3548000;0
26228;9426;102;0;0;0;0;.00nan;0;0
26229;4666;93;58;37;6;31;.838;3519000;0
26229;4754;96;0;0;0;0;.00nan;0;0
26229;9273;93;0;0;0;0;.00nan;0;0
26229;9413;96;46;20;4;16;.800;3600000;0
26230;3867;95;23;23;6;17;.739;2566000;0
26230;7787;97;0;0;0;0;.00nan;0;0
26230;7870;97;68;36;3;33;.917;3600000;0
26230;7909;95;32;10;3;7;.700;1034000;0
26231;4523;90;88;20;0;20;1.000;3600000;0
26231;6367;90;0;0;0;0;.00nan;0;0
26231;7333;85;0;0;0;0;.00nan;0;0
26231;8839;85;51;34;5;29;.853;3600000;0
26232;4534;94;0;0;0;0;.00nan;0;0
26232;4643;99;79;37;2;35;.946;3900000;0
26232;5976;94;76;27;2;25;.926;3900000;0
26232;6581;99;0;0;0;0;.00nan;0;0
26233;6401;88;0;0;0;0;.00nan;0;0
26233;6418;92;79;29;1;28;.966;3600000;0
26233;6593;103;70;36;3;33;.917;3600000;0
26233;9400;92;0;0;0;0;.00nan;0;0
26234;4705;91;0;0;0;0;.00nan;0;0
26234;4872;89;0;0;0;0;.00nan;0;0
26234;5966;89;71;52;6;46;.885;3600000;0
26234;8043;91;73;19;2;17;.895;3600000;0
26235;5987;103;0;0;0;0;.00nan;0;0
26235;7323;103;46;18;3;15;.833;3600000;0
26235;7790;101;79;21;0;21;1.000;2429000;0
26235;9386;101;37;22;4;18;.818;1135000;0
26236;4603;86;56;6;0;6;1.000;447000;0
26236;4771;86;14;29;7;22;.759;3153000;0
26236;6579;87;64;22;2;20;.909;3600000;0
26236;7329;87;0;0;0;0;.00nan;0;0
26237;4705;91;54;9;1;8;.889;3600000;0
26237;6418;92;0;0;0;0;.00nan;0;0
26237;8043;91;0;0;0;0;.00nan;0;0
26237;9400;92;64;43;5;38;.884;3600000;0
26238;4603;86;0;0;0;0;.00nan;0;0
26238;4697;84;0;0;0;0;.00nan;0;0
26238;4771;86;93;47;3;44;.936;3600000;0
26238;7801;84;38;27;5;22;.815;3540000;0
26239;6401;88;25;25;6;19;.760;3248000;0
26239;6593;103;47;6;1;5;.833;352000;0
26239;7787;97;58;29;4;25;.862;3600000;0
26239;7870;97;0;0;0;0;.00nan;0;0
26240;6579;87;60;12;1;11;.917;3600000;0
26240;7329;87;0;0;0;0;.00nan;0;0
26240;7790;101;36;34;6;28;.824;2221000;0
26240;9386;101;46;10;2;8;.800;1379000;0
26241;4754;96;0;0;0;0;.00nan;0;0
26241;6401;88;0;0;0;0;.00nan;0;0
26241;6593;103;58;47;6;41;.872;3600000;0
26241;9413;96;63;24;2;22;.917;3600000;0
26242;4697;84;88;40;2;38;.950;3600000;0
26242;7787;97;0;0;0;0;.00nan;0;0
26242;7801;84;0;0;0;0;.00nan;0;0
26242;7870;97;54;35;5;30;.857;3600000;0
26243;3867;95;73;28;3;25;.893;3600000;0
26243;4838;102;0;0;0;0;.00nan;0;0
26243;7909;95;0;0;0;0;.00nan;0;0
26243;9426;102;60;44;5;39;.886;3534000;0
26244;4523;90;54;35;5;30;.857;3600000;0
26244;4534;94;8;15;6;9;.600;1588000;0
26244;5976;94;8;14;6;8;.571;2012000;0
26244;6367;90;0;0;0;0;.00nan;0;0
26245;4643;99;0;0;0;0;.00nan;0;0
26245;6581;99;58;30;3;27;.900;3600000;0
26245;6631;98;0;0;0;0;.00nan;0;0
26245;7426;98;22;24;6;18;.750;3600000;0
26246;4480;100;63;22;2;20;.909;3900000;0
26246;4629;100;0;0;0;0;.00nan;0;0
26246;5987;103;0;0;0;0;.00nan;0;0
26246;7323;103;79;27;2;25;.926;3900000;0
26247;4666;93;0;0;0;0;.00nan;0;0
26247;4872;89;0;0;0;0;.00nan;0;0
26247;5966;89;85;37;2;35;.946;3600000;0
26247;9273;93;56;27;4;23;.852;3566000;0
26248;4666;93;99;41;2;39;.951;3600000;0
26248;4705;91;0;0;0;0;.00nan;0;0
26248;8043;91;45;20;3;17;.850;3548000;0
26248;9273;93;0;0;0;0;.00nan;0;0
26249;4534;94;0;0;0;0;.00nan;0;0
26249;5976;94;91;33;1;32;.970;3600000;0
26249;7790;101;12;19;6;13;.684;2702000;0
26249;9386;101;48;9;1;8;.889;898000;0
26250;4697;84;0;0;0;0;.00nan;0;0
26250;7333;85;0;0;0;0;.00nan;0;0
26250;7801;84;79;32;2;30;.938;3600000;0
26250;8839;85;65;37;4;33;.892;3578000;0
26251;3867;95;0;0;0;0;.00nan;0;0
26251;6418;92;26;6;3;3;.500;450000;0
26251;7909;95;87;20;1;19;.950;3600000;0
26251;9400;92;54;24;3;21;.875;3150000;0
26252;4754;96;56;32;4;28;.875;3568000;0
26252;6631;98;0;0;0;0;.00nan;0;0
26252;7426;98;74;29;3;26;.897;3600000;0
26252;9413;96;0;0;0;0;.00nan;0;0
26253;4838;102;33;36;6;30;.833;2540000;0
26253;6579;87;0;0;0;0;.00nan;0;0
26253;7329;87;43;29;6;23;.793;3600000;0
26253;9426;102;47;6;1;5;.833;1001000;0
26254;4480;100;0;0;0;0;.00nan;0;0
26254;4629;100;73;21;1;20;.952;3600000;0
26254;4643;99;82;48;5;43;.896;3600000;0
26254;6581;99;0;0;0;0;.00nan;0;0
26255;4872;89;49;25;3;22;.880;3900000;0
26255;5966;89;0;0;0;0;.00nan;0;0
26255;5987;103;67;31;3;28;.903;3900000;0
26255;7323;103;0;0;0;0;.00nan;0;0
26256;3867;95;63;24;2;22;.917;3600000;0
26256;4754;96;0;0;0;0;.00nan;0;0
26256;7909;95;0;0;0;0;.00nan;0;0
26256;9413;96;60;26;3;23;.885;3600000;0
26257;6418;92;22;31;7;24;.774;3600000;0
26257;7333;85;71;23;2;21;.913;3600000;0
26257;8839;85;0;0;0;0;.00nan;0;0
26257;9400;92;0;0;0;0;.00nan;0;0
26258;4523;90;0;0;0;0;.00nan;0;0
26258;6367;90;61;31;4;27;.871;3600000;0
26258;6401;88;100;30;0;30;1.000;3600000;0
26258;6593;103;0;0;0;0;.00nan;0;0
26259;4705;91;76;19;1;18;.947;3600000;0
26259;5987;103;0;0;0;0;.00nan;0;0
26259;7323;103;92;59;5;54;.915;3600000;0
26259;8043;91;0;0;0;0;.00nan;0;0
26260;4603;86;0;0;0;0;.00nan;0;0
26260;4771;86;30;29;5;24;.828;3900000;0
26260;7787;97;66;43;5;38;.884;3437000;0
26260;7870;97;65;4;0;4;1.000;463000;0
26261;4643;99;0;0;0;0;.00nan;0;0
26261;4838;102;0;0;0;0;.00nan;0;0
26261;6581;99;97;36;1;35;.972;3600000;0
26261;9426;102;41;16;3;13;.813;3538000;0
26262;4838;102;75;27;2;25;.926;3600000;0
26262;7790;101;69;41;4;37;.902;3565000;0
26262;9386;101;0;0;0;0;.00nan;0;0
26262;9426;102;0;0;0;0;.00nan;0;0
26263;4666;93;63;30;3;27;.900;3739000;0
26263;4872;89;0;0;0;0;.00nan;0;0
26263;5966;89;62;38;4;34;.895;3739000;0
26263;9273;93;0;0;0;0;.00nan;0;0
26264;6418;92;47;37;6;31;.838;3869000;0
26264;7333;85;49;0;0;0;.00nan;318000;0
26264;8839;85;37;33;6;27;.818;3582000;0
26264;9400;92;0;0;0;0;.00nan;0;0
26265;4523;90;42;34;6;28;.824;3600000;0
26265;4705;91;85;20;0;20;1.000;3600000;0
26265;6367;90;0;0;0;0;.00nan;0;0
26265;8043;91;0;0;0;0;.00nan;0;0
26266;6401;88;42;43;6;37;.860;3519000;0
26266;6593;103;50;0;0;0;.00nan;43000;0
26266;6631;98;42;23;4;19;.826;3600000;0
26266;7426;98;0;0;0;0;.00nan;0;0
26267;5987;103;0;0;0;0;.00nan;0;0
26267;6579;87;20;17;5;12;.706;3600000;0
26267;7323;103;51;28;4;24;.857;3600000;0
26267;7329;87;0;0;0;0;.00nan;0;0
26268;4838;102;65;25;2;23;.920;3577000;0
26268;7790;101;0;0;0;0;.00nan;0;0
26268;9386;101;93;28;1;27;.964;3600000;0
26268;9426;102;0;0;0;0;.00nan;0;0
26269;4697;84;76;35;4;31;.886;3600000;0
26269;6631;98;0;0;0;0;.00nan;0;0
26269;7426;98;38;27;5;22;.815;3564000;0
26269;7801;84;0;0;0;0;.00nan;0;0
26270;3867;95;57;14;1;13;.929;3600000;0
26270;6418;92;31;17;4;13;.765;1640000;0
26270;7909;95;0;0;0;0;.00nan;0;0
26270;9400;92;29;31;6;25;.806;1960000;0
26271;4534;94;0;0;0;0;.00nan;0;0
26271;4666;93;0;0;0;0;.00nan;0;0
26271;5976;94;57;38;4;34;.895;3528000;0
26271;9273;93;64;27;2;25;.926;3600000;0
26272;4603;86;86;38;2;36;.947;3052000;0
26272;4754;96;0;0;0;0;.00nan;0;0
26272;4771;86;26;8;3;5;.625;548000;0
26272;9413;96;80;24;1;23;.958;3600000;0
26273;4643;99;99;39;2;37;.949;3759000;0
26273;6579;87;0;0;0;0;.00nan;0;0
26273;6581;99;0;0;0;0;.00nan;0;0
26273;7329;87;67;28;3;25;.893;3759000;0
26274;4480;100;68;30;3;27;.900;3687000;0
26274;4523;90;0;0;0;0;.00nan;0;0
26274;4629;100;0;0;0;0;.00nan;0;0
26274;6367;90;53;28;4;24;.857;3687000;0
26275;4705;91;0;0;0;0;.00nan;0;0
26275;4872;89;78;42;4;38;.905;3559000;0
26275;5966;89;0;0;0;0;.00nan;0;0
26275;8043;91;64;17;2;15;.882;3600000;0
26276;3867;95;0;0;0;0;.00nan;0;0
26276;4666;93;56;27;3;24;.889;3600000;0
26276;7909;95;40;28;5;23;.821;3592000;0
26276;9273;93;0;0;0;0;.00nan;0;0
26277;6418;92;26;27;6;21;.778;3113000;0
26277;7787;97;0;0;0;0;.00nan;0;0
26277;7870;97;81;28;2;26;.929;3600000;0
26277;9400;92;48;6;1;5;.833;487000;0
26278;5987;103;78;26;1;25;.962;3600000;0
26278;6593;103;0;0;0;0;.00nan;0;0
26278;7790;101;65;35;3;32;.914;3519000;0
26278;9386;101;0;0;0;0;.00nan;0;0
26279;4643;99;0;0;0;0;.00nan;0;0
26279;6581;99;69;30;3;27;.900;3565000;0
26279;7333;85;0;0;0;0;.00nan;0;0
26279;8839;85;75;29;2;27;.931;3600000;0
26280;4697;84;0;0;0;0;.00nan;0;0
26280;4754;96;69;33;3;30;.909;3600000;0
26280;7801;84;37;26;5;21;.808;3563000;0
26280;9413;96;0;0;0;0;.00nan;0;0
26281;4603;86;0;0;0;0;.00nan;0;0
26281;4771;86;83;34;2;32;.941;3600000;0
26281;6401;88;0;0;0;0;.00nan;0;0
26281;7964;88;57;30;3;27;.900;3546000;0
26282;4534;94;67;25;2;23;.920;3600000;0
26282;4838;102;44;5;1;4;.800;726000;0
26282;5976;94;0;0;0;0;.00nan;0;0
26282;9426;102;34;40;6;34;.850;2874000;0
26283;4643;99;65;49;6;43;.878;3600000;0
26283;6581;99;0;0;0;0;.00nan;0;0
26283;7787;97;40;12;3;9;.750;3600000;0
26283;7870;97;0;0;0;0;.00nan;0;0
26284;3867;95;39;31;6;25;.806;3539000;0
26284;5987;103;0;0;0;0;.00nan;0;0
26284;6593;103;64;38;4;34;.895;3600000;0
26284;7909;95;0;0;0;0;.00nan;0;0
26285;6401;88;13;19;6;13;.684;1726000;0
26285;6579;87;74;29;3;26;.897;3600000;0
26285;7329;87;0;0;0;0;.00nan;0;0
26285;7964;88;48;19;3;16;.842;1874000;0
26286;4603;86;53;35;4;31;.886;3532000;0
26286;4771;86;0;0;0;0;.00nan;0;0
26286;6631;98;0;0;0;0;.00nan;0;0
26286;7426;98;65;23;2;21;.913;3600000;0
26287;4480;100;0;0;0;0;.00nan;0;0
26287;4534;94;0;0;0;0;.00nan;0;0
26287;4629;100;55;28;4;24;.857;3900000;0
26287;5976;94;86;51;4;47;.922;3900000;0
26288;4523;90;0;0;0;0;.00nan;0;0
26288;4872;89;0;0;0;0;.00nan;0;0
26288;5966;89;73;30;2;28;.933;3600000;0
26288;6367;90;51;38;6;32;.842;3600000;0
26289;4666;93;80;25;1;24;.960;3600000;0
26289;6631;98;49;24;4;20;.833;3600000;0
26289;7426;98;0;0;0;0;.00nan;0;0
26289;9273;93;0;0;0;0;.00nan;0;0
26290;4754;96;0;0;0;0;.00nan;0;0
26290;6631;98;0;0;0;0;.00nan;0;0
26290;7426;98;65;28;4;24;.857;3900000;0
26290;9413;96;45;27;4;23;.852;3900000;0
26291;4697;84;58;28;3;25;.893;3600000;0
26291;7333;85;0;0;0;0;.00nan;0;0
26291;7801;84;0;0;0;0;.00nan;0;0
26291;8839;85;61;40;5;35;.875;3535000;0
26292;3867;95;33;33;6;27;.818;3284000;0
26292;4705;91;90;22;0;22;1.000;3600000;0
26292;7909;95;53;4;0;4;1.000;316000;0
26292;8043;91;0;0;0;0;.00nan;0;0
26293;4534;94;0;0;0;0;.00nan;0;0
26293;4872;89;0;0;0;0;.00nan;0;0
26293;5966;89;88;29;1;28;.966;3600000;0
26293;5976;94;76;35;2;33;.943;3557000;0
26294;4666;93;0;0;0;0;.00nan;0;0
26294;6418;92;46;36;5;31;.861;3517000;0
26294;9273;93;51;20;3;17;.850;3600000;0
26294;9400;92;0;0;0;0;.00nan;0;0
26295;4523;90;62;38;4;34;.895;3600000;0
26295;6367;90;0;0;0;0;.00nan;0;0
26295;6579;87;51;28;5;23;.821;3600000;0
26295;7329;87;0;0;0;0;.00nan;0;0
26296;4603;86;0;0;0;0;.00nan;0;0
26296;4771;86;84;23;1;22;.957;3600000;0
26296;7790;101;42;34;6;28;.824;3166000;0
26296;9386;101;49;1;0;1;1.000;434000;0
26297;4643;99;75;34;2;32;.941;3562000;0
26297;6581;99;0;0;0;0;.00nan;0;0
26297;7787;97;0;0;0;0;.00nan;0;0
26297;7870;97;80;19;1;18;.947;3600000;0
26298;4480;100;78;23;2;21;.913;3600000;0
26298;4629;100;0;0;0;0;.00nan;0;0
26298;4838;102;42;20;3;17;.850;3600000;0
26298;9426;102;0;0;0;0;.00nan;0;0
26299;4523;90;0;0;0;0;.00nan;0;0
26299;4666;93;58;18;2;16;.889;3735000;0
26299;6367;90;61;34;3;31;.912;3735000;0
26299;9273;93;0;0;0;0;.00nan;0;0
26300;3867;95;35;34;7;27;.794;3600000;0
26300;4754;96;82;33;2;31;.939;3600000;0
26300;7909;95;0;0;0;0;.00nan;0;0
26300;9413;96;0;0;0;0;.00nan;0;0
26301;4705;91;66;16;1;15;.938;3600000;0
26301;6418;92;0;0;0;0;.00nan;0;0
26301;8043;91;0;0;0;0;.00nan;0;0
26301;9400;92;67;57;6;51;.895;3600000;0
26302;4603;86;100;38;0;38;1.000;3600000;0
26302;4771;86;0;0;0;0;.00nan;0;0
26302;7333;85;22;25;6;19;.760;3002000;0
26302;8839;85;45;8;1;7;.875;598000;0
26303;6579;87;0;0;0;0;.00nan;0;0
26303;6631;98;84;48;3;45;.938;3600000;0
26303;7329;87;90;15;0;15;1.000;3600000;0
26303;7426;98;0;0;0;0;.00nan;0;0
26304;7790;101;0;0;0;0;.00nan;0;0
26304;7964;88;0;0;0;0;.00nan;0;0
26304;9386;101;35;46;7;39;.848;3589000;0
26304;9454;88;44;27;5;22;.815;3600000;0
26305;4480;100;0;0;0;0;.00nan;0;0
26305;4629;100;51;30;4;26;.867;3600000;0
26305;4838;102;0;0;0;0;.00nan;0;0
26305;9426;102;69;53;5;48;.906;3583000;0
26306;4643;99;0;0;0;0;.00nan;0;0
26306;4872;89;100;29;0;29;1.000;3600000;0
26306;5966;89;0;0;0;0;.00nan;0;0
26306;6581;99;37;30;5;25;.833;3600000;0
26307;5987;103;0;0;0;0;.00nan;0;0
26307;6593;103;75;34;3;31;.912;3600000;0
26307;7787;97;51;32;4;28;.875;3538000;0
26307;7870;97;0;0;0;0;.00nan;0;0
26308;4697;84;0;0;0;0;.00nan;0;0
26308;7790;101;23;31;7;24;.774;2189000;0
26308;7801;84;45;28;5;23;.821;3600000;0
26308;9386;101;26;14;4;10;.714;1411000;0
26309;3867;95;0;0;0;0;.00nan;0;0
26309;4754;96;74;21;1;20;.952;2359000;0
26309;7909;95;41;24;4;20;.833;3600000;0
26309;9413;96;28;19;5;14;.737;1180000;0
26310;4534;94;0;0;0;0;.00nan;0;0
26310;5976;94;41;36;7;29;.806;3600000;0
26310;7787;97;0;0;0;0;.00nan;0;0
26310;7870;97;96;31;1;30;.968;3600000;0
26311;4603;86;63;39;4;35;.897;3600000;0
26311;4771;86;0;0;0;0;.00nan;0;0
26311;6579;87;0;0;0;0;.00nan;0;0
26311;7329;87;57;20;2;18;.900;3600000;0
26312;4838;102;24;35;7;28;.800;2950000;0
26312;5987;103;63;32;3;29;.906;3600000;0
26312;6593;103;0;0;0;0;.00nan;0;0
26312;9426;102;64;9;0;9;1.000;650000;0
26313;4643;99;70;32;3;29;.906;3600000;0
26313;6581;99;0;0;0;0;.00nan;0;0
26313;6631;98;0;0;0;0;.00nan;0;0
26313;7426;98;78;23;1;22;.957;3600000;0
26314;4480;100;100;28;0;28;1.000;3600000;0
26314;4629;100;0;0;0;0;.00nan;0;0
26314;7790;101;32;35;6;29;.829;3417000;0
26314;9386;101;53;3;0;3;1.000;183000;0
26315;4666;93;79;31;1;30;.968;3600000;0
26315;6579;87;28;29;6;23;.793;3600000;0
26315;7329;87;0;0;0;0;.00nan;0;0
26315;9273;93;0;0;0;0;.00nan;0;0
26316;4523;90;82;38;4;34;.895;3900000;0
26316;6367;90;0;0;0;0;.00nan;0;0
26316;6418;92;59;35;4;31;.886;3900000;0
26316;9400;92;0;0;0;0;.00nan;0;0
26317;4705;91;62;24;2;22;.917;3600000;0
26317;4872;89;65;42;5;37;.881;3600000;0
26317;5966;89;0;0;0;0;.00nan;0;0
26317;8043;91;0;0;0;0;.00nan;0;0
26318;4838;102;85;56;4;52;.929;3648000;0
26318;6401;88;0;0;0;0;.00nan;0;0
26318;7964;88;52;15;3;12;.800;3648000;0
26318;9426;102;0;0;0;0;.00nan;0;0
26319;4534;94;0;0;0;0;.00nan;0;0
26319;5976;94;43;36;5;31;.861;3558000;0
26319;5987;103;0;0;0;0;.00nan;0;0
26319;6593;103;53;27;4;23;.852;3600000;0
26320;6631;98;43;17;3;14;.824;894000;0
26320;7426;98;20;28;7;21;.750;2706000;0
26320;7787;97;0;0;0;0;.00nan;0;0
26320;7870;97;88;33;2;31;.939;3600000;0
26321;4754;96;0;0;0;0;.00nan;0;0
26321;7790;101;36;42;7;35;.833;3600000;0
26321;9386;101;0;0;0;0;.00nan;0;0
26321;9413;96;67;15;1;14;.933;3600000;0
26322;4697;84;63;20;2;18;.900;3600000;0
26322;4838;102;0;0;0;0;.00nan;0;0
26322;7801;84;0;0;0;0;.00nan;0;0
26322;9426;102;98;67;5;62;.925;3600000;0
26323;3867;95;55;30;4;26;.867;3600000;0
26323;4643;99;21;32;7;25;.781;3600000;0
26323;6581;99;0;0;0;0;.00nan;0;0
26323;7909;95;0;0;0;0;.00nan;0;0
26324;4534;94;79;33;2;31;.939;3900000;0
26324;5976;94;0;0;0;0;.00nan;0;0
26324;7333;85;0;0;0;0;.00nan;0;0
26324;8839;85;76;39;2;37;.949;3900000;0
26325;4523;90;0;0;0;0;.00nan;0;0
26325;6367;90;56;33;4;29;.879;3768000;0
26325;6401;88;58;32;5;27;.844;3768000;0
26325;7964;88;0;0;0;0;.00nan;0;0
26326;4705;91;0;0;0;0;.00nan;0;0
26326;4872;89;79;35;2;33;.943;2530000;0
26326;5966;89;34;29;5;24;.828;1070000;0
26326;8043;91;57;24;3;21;.875;3600000;0
26327;4666;93;48;25;4;21;.840;3600000;0
26327;7333;85;24;43;8;35;.814;3471000;0
26327;8839;85;50;1;0;1;1.000;129000;0
26327;9273;93;0;0;0;0;.00nan;0;0
26328;6631;98;0;0;0;0;.00nan;0;0
26328;7426;98;68;33;2;31;.939;3900000;0
26328;7787;97;66;28;2;26;.929;3900000;0
26328;7870;97;0;0;0;0;.00nan;0;0
26329;4754;96;49;25;4;21;.840;3600000;0
26329;7790;101;0;0;0;0;.00nan;0;0
26329;9386;101;66;50;5;45;.900;3584000;0
26329;9413;96;0;0;0;0;.00nan;0;0
26330;4697;84;0;0;0;0;.00nan;0;0
26330;4849;87;45;26;3;23;.885;3565000;0
26330;7329;87;0;0;0;0;.00nan;0;0
26330;7801;84;92;33;1;32;.970;3600000;0
26331;4603;86;56;26;3;23;.885;2532000;0
26331;4771;86;31;15;4;11;.733;1068000;0
26331;6418;92;25;27;6;21;.778;3600000;0
26331;9400;92;0;0;0;0;.00nan;0;0
26332;4480;100;83;37;2;35;.946;3600000;0
26332;4629;100;0;0;0;0;.00nan;0;0
26332;4872;89;0;0;0;0;.00nan;0;0
26332;5966;89;63;31;3;28;.903;3569000;0
26333;6401;88;0;0;0;0;.00nan;0;0
26333;7333;85;35;18;4;14;.778;1530000;0
26333;7964;88;64;15;1;14;.933;3600000;0
26333;8839;85;34;20;4;16;.800;2070000;0
26334;4697;84;52;31;4;27;.871;3900000;0
26334;6418;92;0;0;0;0;.00nan;0;0
26334;7801;84;0;0;0;0;.00nan;0;0
26334;9400;92;71;44;4;40;.909;3896000;0
26335;4534;94;0;0;0;0;.00nan;0;0
26335;4754;96;0;0;0;0;.00nan;0;0
26335;5976;94;60;35;4;31;.886;3600000;0
26335;9413;96;57;20;2;18;.900;3600000;0
26336;3867;95;46;27;4;23;.852;3579000;0
26336;4523;90;93;33;1;32;.970;3600000;0
26336;6367;90;0;0;0;0;.00nan;0;0
26336;7909;95;0;0;0;0;.00nan;0;0
26337;4480;100;49;1;0;1;1.000;481000;0
26337;4629;100;50;41;6;35;.854;3119000;0
26337;4705;91;62;21;2;19;.905;3600000;0
26337;8043;91;0;0;0;0;.00nan;0;0
26338;4666;93;0;0;0;0;.00nan;0;0
26338;4849;87;0;0;0;0;.00nan;0;0
26338;7329;87;50;37;5;32;.865;3588000;0
26338;9273;93;79;39;3;36;.923;3600000;0
26339;4603;86;0;0;0;0;.00nan;0;0
26339;4771;86;67;35;4;31;.886;3600000;0
26339;4838;102;31;18;4;14;.778;2642000;0
26339;9426;102;21;10;4;6;.600;958000;0
26340;4643;99;0;0;0;0;.00nan;0;0
26340;5987;103;57;5;0;5;1.000;680000;0
26340;6581;99;65;25;2;23;.920;3600000;0
26340;6593;103;19;26;6;20;.769;2920000;0
26341;4666;93;67;25;3;22;.880;3600000;0
26341;4872;89;53;2;0;2;1.000;233000;0
26341;5966;89;61;49;6;43;.878;3367000;0
26341;9273;93;0;0;0;0;.00nan;0;0
26342;4603;86;51;29;5;24;.828;3600000;0
26342;4771;86;0;0;0;0;.00nan;0;0
26342;6418;92;82;31;2;29;.935;3600000;0
26342;9400;92;0;0;0;0;.00nan;0;0
26343;4705;91;48;21;3;18;.857;3900000;0
26343;4754;96;0;0;0;0;.00nan;0;0
26343;8043;91;0;0;0;0;.00nan;0;0
26343;9413;96;75;40;3;37;.925;3900000;0
26344;4480;100;45;6;1;5;.833;507000;0
26344;4629;100;45;39;6;33;.846;3093000;0
26344;6401;88;0;0;0;0;.00nan;0;0
26344;7964;88;97;31;1;30;.968;3600000;0
26345;5987;103;0;0;0;0;.00nan;0;0
26345;6593;103;51;27;5;22;.815;3625000;0
26345;7790;101;46;26;4;22;.846;3625000;0
26345;9386;101;0;0;0;0;.00nan;0;0
26346;7787;97;0;0;0;0;.00nan;0;0
26346;7790;101;39;36;6;30;.833;2565000;0
26346;7870;97;37;25;6;19;.760;3600000;0
26346;9386;101;20;9;4;5;.556;1035000;0
26347;4603;86;54;22;3;19;.864;3021000;0
26347;4771;86;24;5;3;2;.400;515000;0
26347;7333;85;0;0;0;0;.00nan;0;0
26347;8839;85;65;36;4;32;.889;3600000;0
26348;4480;100;48;0;0;0;.00nan;144000;0
26348;4629;100;55;48;7;41;.854;3456000;0
26348;4697;84;33;20;4;16;.800;2376000;0
26348;7801;84;60;6;0;6;1.000;1224000;0
26349;3867;95;76;21;1;20;.952;3600000;0
26349;6631;98;84;40;4;36;.900;3600000;0
26349;7426;98;0;0;0;0;.00nan;0;0
26349;7909;95;0;0;0;0;.00nan;0;0
26350;4534;94;0;0;0;0;.00nan;0;0
26350;5976;94;82;29;2;27;.931;3600000;0
26350;5987;103;38;32;6;26;.813;3600000;0
26350;6593;103;0;0;0;0;.00nan;0;0
26351;4523;90;0;0;0;0;.00nan;0;0
26351;4705;91;0;0;0;0;.00nan;0;0
26351;6367;90;24;33;7;26;.788;3600000;0
26351;8043;91;46;19;3;16;.842;3600000;0
26352;4666;93;0;0;0;0;.00nan;0;0
26352;6418;92;0;0;0;0;.00nan;0;0
26352;9273;93;58;24;2;22;.917;3600000;0
26352;9400;92;42;37;6;31;.838;3600000;0
26353;4849;87;0;0;0;0;.00nan;0;0
26353;6401;88;78;42;4;38;.905;3600000;0
26353;6579;87;21;23;6;17;.739;3520000;0
26353;7964;88;0;0;0;0;.00nan;0;0
26354;4643;99;42;22;4;18;.818;3790000;0
26354;4838;102;65;28;3;25;.893;3790000;0
26354;6581;99;0;0;0;0;.00nan;0;0
26354;9426;102;0;0;0;0;.00nan;0;0
26355;4754;96;55;27;4;23;.852;3753000;0
26355;4872;89;67;29;3;26;.897;3753000;0
26355;5966;89;0;0;0;0;.00nan;0;0
26355;9413;96;0;0;0;0;.00nan;0;0
26356;4666;93;66;26;3;23;.885;3600000;0
26356;4697;84;41;30;5;25;.833;3517000;0
26356;7801;84;0;0;0;0;.00nan;0;0
26356;9273;93;0;0;0;0;.00nan;0;0
26357;3867;95;0;0;0;0;.00nan;0;0
26357;7790;101;50;37;6;31;.838;2378000;0
26357;7909;95;69;27;3;24;.889;3600000;0
26357;9386;101;60;16;1;15;.938;1222000;0
26358;6418;92;37;22;4;18;.818;3535000;0
26358;7333;85;98;38;2;36;.947;3600000;0
26358;8839;85;0;0;0;0;.00nan;0;0
26358;9400;92;0;0;0;0;.00nan;0;0
26359;5987;103;0;0;0;0;.00nan;0;0
26359;6593;103;80;28;2;26;.929;3600000;0
26359;6631;98;59;14;1;13;.929;1607000;0
26359;7426;98;9;17;6;11;.647;1993000;0
26360;4849;87;45;20;3;17;.850;3614000;0
26360;6401;88;0;0;0;0;.00nan;0;0
26360;6579;87;0;0;0;0;.00nan;0;0
26360;7964;88;94;39;2;37;.949;3614000;0
26361;4838;102;0;0;0;0;.00nan;0;0
26361;7787;97;48;24;3;21;.875;3600000;0
26361;7870;97;0;0;0;0;.00nan;0;0
26361;9426;102;60;40;4;36;.900;3596000;0
26362;4534;94;72;29;2;27;.931;3600000;0
26362;4643;99;50;3;0;3;1.000;650000;0
26362;5976;94;0;0;0;0;.00nan;0;0
26362;6581;99;22;22;6;16;.727;2950000;0
26363;4523;90;44;32;5;27;.844;3600000;0
26363;4872;89;0;0;0;0;.00nan;0;0
26363;5966;89;73;34;3;31;.912;3600000;0
26363;6367;90;0;0;0;0;.00nan;0;0
26364;4697;84;49;41;6;35;.854;2215000;0
26364;4705;91;56;21;3;18;.857;3600000;0
26364;7801;84;32;12;4;8;.667;1385000;0
26364;8043;91;0;0;0;0;.00nan;0;0
26365;4849;87;0;0;0;0;.00nan;0;0
26365;6579;87;60;18;2;16;.889;3600000;0
26365;7333;85;0;0;0;0;.00nan;0;0
26365;8839;85;85;55;5;50;.909;3600000;0
26366;4480;100;53;38;6;32;.842;2964000;0
26366;4603;86;64;21;2;19;.905;3600000;0
26366;4629;100;54;6;0;6;1.000;636000;0
26366;4771;86;0;0;0;0;.00nan;0;0
26367;4754;96;0;0;0;0;.00nan;0;0
26367;7787;97;0;0;0;0;.00nan;0;0
26367;7870;97;84;14;0;14;1.000;3600000;0
26367;9413;96;54;31;4;27;.871;3600000;0
26368;4697;84;0;0;0;0;.00nan;0;0
26368;6401;88;0;0;0;0;.00nan;0;0
26368;7801;84;57;33;4;29;.879;3600000;0
26368;7964;88;69;29;3;26;.897;3600000;0
26369;3867;95;50;19;3;16;.842;3600000;0
26369;4480;100;63;42;5;37;.881;3566000;0
26369;4629;100;0;0;0;0;.00nan;0;0
26369;7909;95;0;0;0;0;.00nan;0;0
26370;4523;90;0;0;0;0;.00nan;0;0
26370;4666;93;29;27;6;21;.778;3600000;0
26370;6367;90;89;21;0;21;1.000;3600000;0
26370;9273;93;0;0;0;0;.00nan;0;0
26371;6418;92;78;47;4;43;.915;3600000;0
26371;6631;98;26;30;6;24;.800;3519000;0
26371;7426;98;0;0;0;0;.00nan;0;0
26371;9400;92;0;0;0;0;.00nan;0;0
26372;4705;91;17;16;5;11;.688;3567000;0
26372;6401;88;66;29;4;25;.862;3600000;0
26372;7964;88;0;0;0;0;.00nan;0;0
26372;8043;91;0;0;0;0;.00nan;0;0
26373;5987;103;86;31;1;30;.968;3600000;0
26373;6593;103;0;0;0;0;.00nan;0;0
26373;7333;85;0;0;0;0;.00nan;0;0
26373;8839;85;48;30;4;26;.867;3600000;0
26374;7787;97;0;0;0;0;.00nan;0;0
26374;7790;101;68;44;5;39;.886;3513000;0
26374;7870;97;47;18;3;15;.833;3600000;0
26374;9386;101;0;0;0;0;.00nan;0;0
26375;4603;86;0;0;0;0;.00nan;0;0
26375;4771;86;33;26;5;21;.808;3561000;0
26375;7333;85;70;35;3;32;.914;3600000;0
26375;8839;85;0;0;0;0;.00nan;0;0
26376;4697;84;57;25;3;22;.880;3600000;0
26376;4705;91;0;0;0;0;.00nan;0;0
26376;7801;84;0;0;0;0;.00nan;0;0
26376;8043;91;34;33;6;27;.818;3600000;0
26377;3867;95;71;21;2;19;.905;3600000;0
26377;4523;90;0;0;0;0;.00nan;0;0
26377;6367;90;87;48;3;45;.938;3600000;0
26377;7909;95;0;0;0;0;.00nan;0;0
26378;4534;94;0;0;0;0;.00nan;0;0
26378;4838;102;64;29;4;25;.862;3900000;0
26378;5976;94;71;35;4;31;.886;3900000;0
26378;9426;102;0;0;0;0;.00nan;0;0
26379;4849;87;0;0;0;0;.00nan;0;0
26379;4872;89;0;0;0;0;.00nan;0;0
26379;5966;89;86;38;2;36;.947;3600000;0
26379;6579;87;65;32;3;29;.906;3552000;0
26380;4643;99;51;2;0;2;1.000;392000;0
26380;5987;103;46;4;1;3;.750;304000;0
26380;6581;99;29;31;6;25;.806;3177000;0
26380;6593;103;65;31;4;27;.871;3296000;0
26381;4480;100;0;0;0;0;.00nan;0;0
26381;4629;100;81;42;3;39;.929;3600000;0
26381;4754;96;0;0;0;0;.00nan;0;0
26381;9413;96;97;21;0;21;1.000;3600000;0
26382;4666;93;0;0;0;0;.00nan;0;0
26382;4872;89;89;42;3;39;.929;3600000;0
26382;5966;89;0;0;0;0;.00nan;0;0
26382;9273;93;66;24;2;22;.917;3600000;0
26383;6631;98;24;20;5;15;.750;2413000;0
26383;7426;98;19;11;4;7;.636;1187000;0
26383;7787;97;59;33;4;29;.879;3600000;0
26383;7870;97;0;0;0;0;.00nan;0;0
26384;7333;85;0;0;0;0;.00nan;0;0
26384;7790;101;0;0;0;0;.00nan;0;0
26384;8839;85;50;27;4;23;.852;3900000;0
26384;9386;101;57;43;4;39;.907;3900000;0
26385;4603;86;48;31;5;26;.839;3600000;0
26385;4771;86;0;0;0;0;.00nan;0;0
26385;6401;88;0;0;0;0;.00nan;0;0
26385;7964;88;51;30;4;26;.867;3600000;0
26386;4754;96;0;0;0;0;.00nan;0;0
26386;4838;102;48;0;0;0;.00nan;99000;0
26386;9413;96;40;20;4;16;.800;3600000;0
26386;9426;102;48;51;7;44;.863;3501000;0
26387;4480;100;93;34;1;33;.971;3600000;0
26387;4629;100;0;0;0;0;.00nan;0;0
26387;6418;92;52;25;3;22;.880;3511000;0
26387;9400;92;0;0;0;0;.00nan;0;0
26388;4643;99;66;22;2;20;.909;3600000;0
26388;5987;103;89;45;3;42;.933;3561000;0
26388;6581;99;0;0;0;0;.00nan;0;0
26388;6593;103;0;0;0;0;.00nan;0;0
26389;4523;90;64;37;3;34;.919;3568000;0
26389;4697;84;0;0;0;0;.00nan;0;0
26389;6367;90;0;0;0;0;.00nan;0;0
26389;7801;84;73;30;2;28;.933;3600000;0
26390;4849;87;90;18;0;18;1.000;3600000;0
26390;6579;87;0;0;0;0;.00nan;0;0
26390;7790;101;91;56;5;51;.911;3600000;0
26390;9386;101;0;0;0;0;.00nan;0;0
26391;4603;86;0;0;0;0;.00nan;0;0
26391;4705;91;79;22;1;21;.955;3600000;0
26391;4771;86;75;31;2;29;.935;3598000;0
26391;8043;91;0;0;0;0;.00nan;0;0
26392;3867;95;29;25;6;19;.760;2357000;0
26392;4643;99;0;0;0;0;.00nan;0;0
26392;6581;99;50;32;5;27;.844;3600000;0
26392;7909;95;77;12;0;12;1.000;1204000;0
26393;4872;89;0;0;0;0;.00nan;0;0
26393;5966;89;51;25;3;22;.880;3719000;0
26393;6418;92;0;0;0;0;.00nan;0;0
26393;9400;92;86;43;4;39;.907;3719000;0
26394;3867;95;45;37;6;31;.838;3600000;0
26394;7787;97;0;0;0;0;.00nan;0;0
26394;7870;97;59;29;3;26;.897;3600000;0
26394;7909;95;0;0;0;0;.00nan;0;0
26395;4534;94;0;0;0;0;.00nan;0;0
26395;4754;96;0;0;0;0;.00nan;0;0
26395;5976;94;61;25;2;23;.920;3600000;0
26395;9413;96;70;36;4;32;.889;3542000;0
26396;4666;93;40;15;4;11;.733;3600000;0
26396;7787;97;20;27;6;21;.778;2751000;0
26396;7870;97;64;9;0;9;1.000;827000;0
26396;9273;93;0;0;0;0;.00nan;0;0
26397;4697;84;40;33;5;28;.848;3600000;0
26397;4849;87;0;0;0;0;.00nan;0;0
26397;6579;87;100;33;0;33;1.000;3600000;0
26397;7801;84;0;0;0;0;.00nan;0;0
26398;6631;98;0;0;0;0;.00nan;0;0
26398;7333;85;0;0;0;0;.00nan;0;0
26398;7426;98;73;28;2;26;.929;3600000;0
26398;8839;85;43;31;5;26;.839;3600000;0
26399;4480;100;66;20;1;19;.950;1673000;0
26399;4629;100;13;15;6;9;.600;1927000;0
26399;4838;102;53;37;5;32;.865;3600000;0
26399;9426;102;0;0;0;0;.00nan;0;0
26400;4666;93;0;0;0;0;.00nan;0;0
26400;6418;92;55;39;5;34;.872;3600000;0
26400;9273;93;70;28;2;26;.929;3600000;0
26400;9400;92;0;0;0;0;.00nan;0;0
26401;4643;99;54;32;4;28;.875;3600000;0
26401;4705;91;79;25;1;24;.960;3600000;0
26401;6581;99;0;0;0;0;.00nan;0;0
26401;8043;91;0;0;0;0;.00nan;0;0
26402;5987;103;0;0;0;0;.00nan;0;0
26402;6401;88;0;0;0;0;.00nan;0;0
26402;6593;103;57;30;3;27;.900;3564000;0
26402;7964;88;82;36;2;34;.944;3600000;0
26403;4754;96;0;0;0;0;.00nan;0;0
26403;6631;98;31;37;7;30;.811;2897000;0
26403;7426;98;56;4;0;4;1.000;703000;0
26403;9413;96;39;18;4;14;.778;3600000;0
26404;4697;84;0;0;0;0;.00nan;0;0
26404;5987;103;17;7;4;3;.429;894000;0
26404;6593;103;79;21;2;19;.905;2716000;0
26404;7801;84;42;26;5;21;.808;3610000;0
26405;3867;95;44;33;5;28;.848;3600000;0
26405;4534;94;50;1;0;1;1.000;209000;0
26405;5976;94;48;40;7;33;.825;3380000;0
26405;7909;95;0;0;0;0;.00nan;0;0
26406;4523;90;31;33;6;27;.818;3358000;0
26406;4603;86;43;27;5;22;.815;3600000;0
26406;4771;86;0;0;0;0;.00nan;0;0
26406;6367;90;48;0;0;0;.00nan;185000;0
26407;6418;92;0;0;0;0;.00nan;0;0
26407;7333;85;60;28;3;25;.893;3600000;0
26407;8839;85;0;0;0;0;.00nan;0;0
26407;9400;92;66;38;4;34;.895;3600000;0
26408;4480;100;0;0;0;0;.00nan;0;0
26408;4629;100;76;35;3;32;.914;3576000;0
26408;4849;87;0;0;0;0;.00nan;0;0
26408;6579;87;59;17;2;15;.882;3600000;0
26409;4838;102;0;0;0;0;.00nan;0;0
26409;7790;101;48;37;5;32;.865;3562000;0
26409;9386;101;0;0;0;0;.00nan;0;0
26409;9426;102;66;30;3;27;.900;3600000;0
26410;4643;99;32;20;4;16;.800;1495000;0
26410;4872;89;0;0;0;0;.00nan;0;0
26410;5966;89;76;31;2;29;.935;3600000;0
26410;6581;99;37;20;4;16;.800;2105000;0
26411;4666;93;82;25;1;24;.960;3600000;0
26411;4705;91;44;3;1;2;.667;461000;0
26411;8043;91;19;30;7;23;.767;3139000;0
26411;9273;93;0;0;0;0;.00nan;0;0
26412;4849;87;24;26;6;20;.769;3600000;0
26412;6579;87;0;0;0;0;.00nan;0;0
26412;7787;97;0;0;0;0;.00nan;0;0
26412;7870;97;45;19;3;16;.842;3600000;0
26413;4754;96;46;10;2;8;.800;3600000;0
26413;7790;101;0;0;0;0;.00nan;0;0
26413;9386;101;85;61;5;56;.918;3600000;0
26413;9413;96;0;0;0;0;.00nan;0;0
26414;4480;100;73;41;3;38;.927;3600000;0
26414;4629;100;0;0;0;0;.00nan;0;0
26414;7333;85;0;0;0;0;.00nan;0;0
26414;8839;85;80;24;1;23;.958;3600000;0
26415;4534;94;62;38;4;34;.895;3600000;0
26415;4697;84;80;22;1;21;.955;3600000;0
26415;5976;94;0;0;0;0;.00nan;0;0
26415;7801;84;0;0;0;0;.00nan;0;0
26416;6401;88;0;0;0;0;.00nan;0;0
26416;6631;98;0;0;0;0;.00nan;0;0
26416;7426;98;91;32;1;31;.969;3900000;0
26416;7964;88;77;23;1;22;.957;3900000;0
26417;3867;95;0;0;0;0;.00nan;0;0
26417;4838;102;43;27;4;23;.852;3600000;0
26417;7909;95;40;30;5;25;.833;3595000;0
26417;9426;102;0;0;0;0;.00nan;0;0
26418;4872;89;0;0;0;0;.00nan;0;0
26418;5966;89;67;34;4;30;.882;3819000;0
26418;6418;92;50;32;5;27;.844;3819000;0
26418;9400;92;0;0;0;0;.00nan;0;0
26419;4523;90;0;0;0;0;.00nan;0;0
26419;4705;91;74;32;3;29;.906;3600000;0
26419;6367;90;62;36;4;32;.889;3547000;0
26419;8043;91;0;0;0;0;.00nan;0;0
26420;4603;86;63;32;5;27;.844;3600000;0
26420;4771;86;0;0;0;0;.00nan;0;0
26420;5987;103;0;0;0;0;.00nan;0;0
26420;6593;103;100;35;1;34;.971;3600000;0
26421;4480;100;0;0;0;0;.00nan;0;0
26421;4629;100;61;29;3;26;.897;3546000;0
26421;4754;96;0;0;0;0;.00nan;0;0
26421;9413;96;70;30;2;28;.933;3600000;0
26422;3867;95;46;19;4;15;.789;3600000;0
26422;7333;85;50;0;0;0;.00nan;10000;0
26422;7909;95;0;0;0;0;.00nan;0;0
26422;8839;85;41;34;6;28;.824;3590000;0
26423;4666;93;0;0;0;0;.00nan;0;0
26423;4697;84;0;0;0;0;.00nan;0;0
26423;7801;84;85;42;4;38;.905;3600000;0
26423;9273;93;43;32;5;27;.844;3563000;0
26424;4523;90;57;20;3;17;.850;3600000;0
26424;6367;90;0;0;0;0;.00nan;0;0
26424;7787;97;50;35;5;30;.857;3515000;0
26424;7870;97;0;0;0;0;.00nan;0;0
26425;4849;87;0;0;0;0;.00nan;0;0
26425;6579;87;69;16;1;15;.938;3600000;0
26425;6631;98;71;34;3;31;.912;3548000;0
26425;7426;98;0;0;0;0;.00nan;0;0
26426;4534;94;0;0;0;0;.00nan;0;0
26426;4603;86;0;0;0;0;.00nan;0;0
26426;4771;86;48;23;4;19;.826;3600000;0
26426;5976;94;67;48;5;43;.896;3600000;0
26427;4872;89;73;37;4;33;.892;3651000;0
26427;5966;89;0;0;0;0;.00nan;0;0
26427;6401;88;63;25;3;22;.880;3651000;0
26427;7964;88;0;0;0;0;.00nan;0;0
26428;4643;99;0;0;0;0;.00nan;0;0
26428;6581;99;4;24;7;17;.708;3560000;0
26428;7790;101;58;47;6;41;.872;3600000;0
26428;9386;101;0;0;0;0;.00nan;0;0
26429;4643;99;51;30;5;25;.833;3600000;0
26429;5987;103;45;3;1;2;.667;719000;0
26429;6581;99;0;0;0;0;.00nan;0;0
26429;6593;103;1;25;9;16;.640;2881000;0
26430;4666;93;28;28;6;22;.786;3217000;0
26430;4838;102;50;6;1;5;.833;818000;0
26430;9273;93;55;3;0;3;1.000;470000;0
26430;9426;102;39;35;6;29;.829;2869000;0
26431;6418;92;70;16;1;15;.938;3600000;0
26431;7790;101;19;31;7;24;.774;1906000;0
26431;9386;101;38;29;5;24;.828;1694000;0
26431;9400;92;0;0;0;0;.00nan;0;0
26432;4603;86;27;34;7;27;.794;2970000;0
26432;4705;91;0;0;0;0;.00nan;0;0
26432;4771;86;46;6;1;5;.833;630000;0
26432;8043;91;63;24;2;22;.917;3600000;0
26433;6401;88;0;0;0;0;.00nan;0;0
26433;7333;85;52;27;4;23;.852;3649000;0
26433;7964;88;67;28;3;25;.893;3649000;0
26433;8839;85;0;0;0;0;.00nan;0;0
26434;4534;94;0;0;0;0;.00nan;0;0
26434;5976;94;50;29;4;25;.862;3600000;0
26434;5987;103;41;9;2;7;.778;420000;0
26434;6593;103;23;26;6;20;.769;3180000;0
26435;4534;94;56;29;4;25;.862;3552000;0
26435;4754;96;0;0;0;0;.00nan;0;0
26435;5976;94;0;0;0;0;.00nan;0;0
26435;9413;96;68;32;3;29;.906;3600000;0
26436;4697;84;0;0;0;0;.00nan;0;0
26436;4849;87;0;0;0;0;.00nan;0;0
26436;6579;87;67;21;2;19;.905;3600000;0
26436;7801;84;55;29;4;25;.862;3591000;0
26437;3867;95;70;21;1;20;.952;3600000;0
26437;7787;97;0;0;0;0;.00nan;0;0
26437;7870;97;79;34;2;32;.941;3560000;0
26437;7909;95;0;0;0;0;.00nan;0;0
26438;4523;90;0;0;0;0;.00nan;0;0
26438;6367;90;66;37;4;33;.892;3600000;0
26438;7790;101;93;34;1;33;.971;3600000;0
26438;9386;101;0;0;0;0;.00nan;0;0
26439;4480;100;69;33;3;30;.909;3600000;0
26439;4603;86;0;0;0;0;.00nan;0;0
26439;4629;100;0;0;0;0;.00nan;0;0
26439;4771;86;39;26;5;21;.808;3526000;0
26440;4838;102;79;36;2;34;.944;3900000;0
26440;4872;89;0;0;0;0;.00nan;0;0
26440;5966;89;73;23;2;21;.913;3900000;0
26440;9426;102;0;0;0;0;.00nan;0;0
26441;4666;93;57;17;2;15;.882;3600000;0
26441;5987;103;76;38;3;35;.921;3600000;0
26441;6593;103;0;0;0;0;.00nan;0;0
26441;9273;93;0;0;0;0;.00nan;0;0
26442;3867;95;0;0;0;0;.00nan;0;0
26442;7790;101;0;0;0;0;.00nan;0;0
26442;7909;95;60;12;1;11;.917;3600000;0
26442;9386;101;96;51;3;48;.941;3600000;0
26443;4849;87;48;19;3;16;.842;3894000;0
26443;6579;87;0;0;0;0;.00nan;0;0
26443;7333;85;0;0;0;0;.00nan;0;0
26443;8839;85;96;43;2;41;.953;3894000;0
26444;6631;98;96;19;0;19;1.000;3600000;0
26444;7426;98;0;0;0;0;.00nan;0;0
26444;7787;97;60;32;4;28;.875;3600000;0
26444;7870;97;0;0;0;0;.00nan;0;0
26445;4754;96;0;0;0;0;.00nan;0;0
26445;6418;92;77;33;2;31;.939;3600000;0
26445;9400;92;0;0;0;0;.00nan;0;0
26445;9413;96;57;35;4;31;.886;3540000;0
26446;4523;90;33;28;5;23;.821;3556000;0
26446;4666;93;0;0;0;0;.00nan;0;0
26446;6367;90;50;0;0;0;.00nan;42000;0
26446;9273;93;61;21;2;19;.905;3600000;0
26447;4705;91;68;28;2;26;.929;3600000;0
26447;4838;102;50;0;0;0;.00nan;28000;0
26447;8043;91;0;0;0;0;.00nan;0;0
26447;9426;102;30;43;8;35;.814;3572000;0
26448;4849;87;0;0;0;0;.00nan;0;0
26448;5987;103;0;0;0;0;.00nan;0;0
26448;6579;87;56;19;3;16;.842;3760000;0
26448;6593;103;64;41;4;37;.902;3760000;0
26449;6631;98;0;0;0;0;.00nan;0;0
26449;7426;98;79;24;1;23;.958;3600000;0
26449;7787;97;44;4;1;3;.750;126000;0
26449;7870;97;19;23;6;17;.739;3474000;0
26450;4480;100;0;0;0;0;.00nan;0;0
26450;4629;100;77;36;3;33;.917;3600000;0
26450;4643;99;0;0;0;0;.00nan;0;0
26450;6581;99;25;37;7;30;.811;3600000;0
26451;4603;86;43;19;3;16;.842;3580000;0
26451;4771;86;0;0;0;0;.00nan;0;0
26451;4872;89;0;0;0;0;.00nan;0;0
26451;5966;89;76;31;2;29;.935;3600000;0
26452;4603;86;0;0;0;0;.00nan;0;0
26452;4697;84;63;25;2;23;.920;3600000;0
26452;4771;86;67;37;4;33;.892;3593000;0
26452;7801;84;0;0;0;0;.00nan;0;0
26453;6631;98;0;0;0;0;.00nan;0;0
26453;7333;85;0;0;0;0;.00nan;0;0
26453;7426;98;75;36;3;33;.917;3600000;0
26453;8839;85;76;32;2;30;.938;3600000;0
26454;4534;94;0;0;0;0;.00nan;0;0
26454;4754;96;50;1;0;1;1.000;138000;0
26454;5976;94;66;31;4;27;.871;3600000;0
26454;9413;96;29;26;6;20;.769;3428000;0
26455;4705;91;0;0;0;0;.00nan;0;0
26455;4872;89;0;0;0;0;.00nan;0;0
26455;5966;89;58;27;3;24;.889;3550000;0
26455;8043;91;73;28;2;26;.929;3600000;0
26456;4643;99;0;0;0;0;.00nan;0;0
26456;6581;99;50;30;4;26;.867;3872000;0
26456;7790;101;69;36;4;32;.889;3900000;0
26456;9386;101;0;0;0;0;.00nan;0;0
26457;4666;93;70;22;2;20;.909;3600000;0
26457;6418;92;15;25;6;19;.760;3600000;0
26457;9273;93;0;0;0;0;.00nan;0;0
26457;9400;92;0;0;0;0;.00nan;0;0
26458;4849;87;0;0;0;0;.00nan;0;0
26458;6401;88;0;0;0;0;.00nan;0;0
26458;6579;87;61;28;3;25;.893;3600000;0
26458;7964;88;44;24;4;20;.833;3592000;0
26459;4480;100;28;28;6;22;.786;3200000;0
26459;4629;100;52;2;0;2;1.000;400000;0
26459;5987;103;0;0;0;0;.00nan;0;0
26459;6593;103;76;36;3;33;.917;3600000;0
26460;7333;85;44;18;3;15;.833;3600000;0
26460;7790;101;77;39;4;35;.897;3558000;0
26460;8839;85;0;0;0;0;.00nan;0;0
26460;9386;101;0;0;0;0;.00nan;0;0
26461;4754;96;51;21;3;18;.857;1516000;0
26461;7787;97;0;0;0;0;.00nan;0;0
26461;7870;97;65;22;2;20;.909;3600000;0
26461;9413;96;35;23;4;19;.826;2084000;0
26462;3867;95;29;23;5;18;.783;3586000;0
26462;4643;99;54;35;4;31;.886;3600000;0
26462;6581;99;0;0;0;0;.00nan;0;0
26462;7909;95;0;0;0;0;.00nan;0;0
26463;4480;100;67;8;0;8;1.000;909000;0
26463;4534;94;0;0;0;0;.00nan;0;0
26463;4629;100;34;35;6;29;.829;2634000;0
26463;5976;94;45;26;4;22;.846;3600000;0
26464;4523;90;57;19;2;17;.895;3600000;0
26464;6367;90;0;0;0;0;.00nan;0;0
26464;6631;98;7;22;6;16;.727;2916000;0
26464;7426;98;50;8;1;7;.875;684000;0
26465;4603;86;26;20;5;15;.750;3600000;0
26465;4771;86;0;0;0;0;.00nan;0;0
26465;4849;87;62;34;3;31;.912;3600000;0
26465;6579;87;0;0;0;0;.00nan;0;0
26466;4697;84;0;0;0;0;.00nan;0;0
26466;4838;102;47;44;6;38;.864;3178000;0
26466;7801;84;60;22;2;20;.909;3600000;0
26466;9426;102;48;0;0;0;.00nan;422000;0
26467;4872;89;64;24;3;21;.875;3600000;0
26467;5966;89;0;0;0;0;.00nan;0;0
26467;6418;92;0;0;0;0;.00nan;0;0
26467;9400;92;83;49;4;45;.918;3596000;0
26468;4705;91;92;45;2;43;.956;3834000;0
26468;7787;97;69;36;3;33;.917;3834000;0
26468;7870;97;0;0;0;0;.00nan;0;0
26468;8043;91;0;0;0;0;.00nan;0;0
26469;4697;84;63;18;1;17;.944;3600000;0
26469;7790;101;49;7;1;6;.857;585000;0
26469;7801;84;0;0;0;0;.00nan;0;0
26469;9386;101;49;43;6;37;.860;3015000;0
26470;4603;86;0;0;0;0;.00nan;0;0
26470;4666;93;59;25;3;22;.880;3900000;0
26470;4771;86;100;52;3;49;.942;3900000;0
26470;9273;93;0;0;0;0;.00nan;0;0
26471;3867;95;50;2;0;2;1.000;269000;0
26471;6631;98;0;0;0;0;.00nan;0;0
26471;7426;98;68;22;2;20;.909;3600000;0
26471;7909;95;36;35;7;28;.800;3331000;0
26472;4838;102;0;0;0;0;.00nan;0;0
26472;7333;85;45;4;1;3;.750;459000;0
26472;8839;85;51;33;5;28;.848;3441000;0
26472;9426;102;30;31;6;25;.806;3900000;0
26473;4754;96;0;0;0;0;.00nan;0;0
26473;5987;103;61;29;3;26;.897;3600000;0
26473;6593;103;0;0;0;0;.00nan;0;0
26473;9413;96;53;28;4;24;.857;3567000;0
26474;4534;94;0;0;0;0;.00nan;0;0
26474;5976;94;79;40;3;37;.925;3900000;0
26474;7787;97;84;22;0;22;1.000;3404000;0
26474;7870;97;23;6;3;3;.500;496000;0
26475;4705;91;0;0;0;0;.00nan;0;0
26475;6418;92;30;31;6;25;.806;2386000;0
26475;8043;91;75;27;2;25;.926;3600000;0
26475;9400;92;47;6;1;5;.833;1214000;0
26476;4603;86;58;39;5;34;.872;3600000;0
26476;4771;86;0;0;0;0;.00nan;0;0
26476;4849;87;0;0;0;0;.00nan;0;0
26476;6579;87;72;22;2;20;.909;3600000;0
26477;4666;93;0;0;0;0;.00nan;0;0
26477;6401;88;38;33;6;27;.818;2955000;0
26477;7964;88;51;2;0;2;1.000;645000;0
26477;9273;93;74;34;3;31;.912;3600000;0
26478;4480;100;0;0;0;0;.00nan;0;0
26478;4629;100;85;50;4;46;.920;3779000;0
26478;4643;99;0;0;0;0;.00nan;0;0
26478;6581;99;49;34;5;29;.853;3779000;0
26479;4523;90;0;0;0;0;.00nan;0;0
26479;4872;89;0;0;0;0;.00nan;0;0
26479;5966;89;75;28;2;26;.929;3600000;0
26479;6367;90;58;32;4;28;.875;3600000;0
26480;4697;84;0;0;0;0;.00nan;0;0
26480;5987;103;0;0;0;0;.00nan;0;0
26480;6593;103;100;32;0;32;1.000;3600000;0
26480;7801;84;52;20;2;18;.900;3566000;0
26481;3867;95;6;23;7;16;.696;2389000;0
26481;4534;94;100;33;0;33;1.000;3600000;0
26481;5976;94;0;0;0;0;.00nan;0;0
26481;7909;95;68;12;0;12;1.000;1211000;0
26482;4754;96;0;0;0;0;.00nan;0;0
26482;7787;97;0;0;0;0;.00nan;0;0
26482;7870;97;43;27;4;23;.852;3600000;0
26482;9413;96;94;38;1;37;.974;3600000;0
26483;6631;98;58;16;2;14;.875;3563000;0
26483;7426;98;0;0;0;0;.00nan;0;0
26483;7790;101;100;46;1;45;.978;3600000;0
26483;9386;101;0;0;0;0;.00nan;0;0
26484;4666;93;100;22;0;22;1.000;3600000;0
26484;4872;89;0;0;0;0;.00nan;0;0
26484;5966;89;69;36;4;32;.889;3600000;0
26484;9273;93;0;0;0;0;.00nan;0;0
26485;4523;90;0;0;0;0;.00nan;0;0
26485;4838;102;33;33;6;27;.818;2499000;0
26485;6367;90;67;26;2;24;.923;3600000;0
26485;9426;102;40;11;2;9;.818;1101000;0
26486;4697;84;57;26;3;23;.885;3900000;0
26486;4705;91;80;37;3;34;.919;3900000;0
26486;7801;84;0;0;0;0;.00nan;0;0
26486;8043;91;0;0;0;0;.00nan;0;0
26487;6401;88;0;0;0;0;.00nan;0;0
26487;7333;85;0;0;0;0;.00nan;0;0
26487;7964;88;78;24;2;22;.917;3600000;0
26487;8839;85;71;39;3;36;.923;3600000;0
26488;5987;103;48;20;3;17;.850;3168000;0
26488;6593;103;25;6;3;3;.500;432000;0
26488;6631;98;0;0;0;0;.00nan;0;0
26488;7426;98;64;27;3;24;.889;3600000;0
26489;4754;96;0;0;0;0;.00nan;0;0
26489;4849;87;0;0;0;0;.00nan;0;0
26489;6579;87;74;22;2;20;.909;3900000;0
26489;9413;96;81;36;2;34;.944;3900000;0
26490;3867;95;0;0;0;0;.00nan;0;0
26490;4666;93;76;26;2;24;.923;3600000;0
26490;7909;95;97;33;1;32;.970;3600000;0
26490;9273;93;0;0;0;0;.00nan;0;0
26491;4534;94;62;28;3;25;.893;3600000;0
26491;4643;99;66;42;5;37;.881;3588000;0
26491;5976;94;0;0;0;0;.00nan;0;0
26491;6581;99;0;0;0;0;.00nan;0;0
26492;4523;90;67;30;2;28;.933;3600000;0
26492;4705;91;0;0;0;0;.00nan;0;0
26492;6367;90;0;0;0;0;.00nan;0;0
26492;8043;91;99;32;1;31;.969;3600000;0
26493;4480;100;0;0;0;0;.00nan;0;0
26493;4629;100;74;36;4;32;.889;3782000;0
26493;4872;89;67;25;3;22;.880;3782000;0
26493;5966;89;0;0;0;0;.00nan;0;0
26494;4603;86;0;0;0;0;.00nan;0;0
26494;4666;93;0;0;0;0;.00nan;0;0
26494;4771;86;73;37;4;33;.892;3575000;0
26494;9273;93;75;27;2;25;.926;3600000;0
26495;5987;103;0;0;0;0;.00nan;0;0
26495;6593;103;34;23;4;19;.826;3596000;0
26495;7790;101;83;42;3;39;.929;3600000;0
26495;9386;101;0;0;0;0;.00nan;0;0
26496;4838;102;57;36;4;32;.889;3600000;0
26496;7333;85;34;36;6;30;.833;3052000;0
26496;8839;85;53;3;0;3;1.000;516000;0
26496;9426;102;0;0;0;0;.00nan;0;0
26497;6418;92;30;37;7;30;.811;3600000;0
26497;7787;97;47;27;4;23;.852;3600000;0
26497;7870;97;0;0;0;0;.00nan;0;0
26497;9400;92;0;0;0;0;.00nan;0;0
26498;4534;94;50;0;0;0;.00nan;41000;0
26498;5976;94;58;43;6;37;.860;3511000;0
26498;6631;98;40;24;4;20;.833;3600000;0
26498;7426;98;0;0;0;0;.00nan;0;0
26499;4523;90;0;0;0;0;.00nan;0;0
26499;6367;90;70;45;5;40;.889;3600000;0
26499;6401;88;0;0;0;0;.00nan;0;0
26499;7964;88;89;18;0;18;1.000;3600000;0
26500;4480;100;89;35;1;34;.971;3600000;0
26500;4629;100;0;0;0;0;.00nan;0;0
26500;4697;84;49;1;0;1;1.000;364000;0
26500;7801;84;17;21;6;15;.714;3236000;0
26501;4838;102;0;0;0;0;.00nan;0;0
26501;7787;97;0;0;0;0;.00nan;0;0
26501;7870;97;100;30;0;30;1.000;3600000;0
26501;9426;102;72;39;3;36;.923;3600000;0
26502;4534;94;0;0;0;0;.00nan;0;0
26502;4849;87;0;0;0;0;.00nan;0;0
26502;5976;94;97;42;2;40;.952;3544000;0
26502;6579;87;56;10;1;9;.900;3600000;0
26503;6401;88;42;3;1;2;.667;627000;0
26503;6418;92;0;0;0;0;.00nan;0;0
26503;7964;88;19;34;8;26;.765;2973000;0
26503;9400;92;54;25;3;22;.880;3600000;0
26504;4603;86;71;30;3;27;.900;3600000;0
26504;4705;91;45;37;6;31;.838;2613000;0
26504;4771;86;0;0;0;0;.00nan;0;0
26504;8043;91;64;10;0;10;1.000;987000;0
26505;4643;99;0;0;0;0;.00nan;0;0
26505;4754;96;77;25;2;23;.920;3782000;0
26505;6581;99;65;35;3;32;.914;3782000;0
26505;9413;96;0;0;0;0;.00nan;0;0
26506;4697;84;60;27;3;24;.889;3535000;0
26506;4872;89;0;0;0;0;.00nan;0;0
26506;5966;89;91;32;1;31;.969;3600000;0
26506;7801;84;0;0;0;0;.00nan;0;0
26507;3867;95;50;8;1;7;.875;3600000;0
26507;5987;103;69;40;4;36;.900;3600000;0
26507;6593;103;0;0;0;0;.00nan;0;0
26507;7909;95;0;0;0;0;.00nan;0;0
26508;3867;95;75;23;1;22;.957;3600000;0
26508;4754;96;50;0;0;0;.00nan;50000;0
26508;7909;95;0;0;0;0;.00nan;0;0
26508;9413;96;67;47;6;41;.872;3550000;0
26509;4666;93;67;34;3;31;.912;3600000;0
26509;6631;98;0;0;0;0;.00nan;0;0
26509;7426;98;15;21;6;15;.714;3600000;0
26509;9273;93;0;0;0;0;.00nan;0;0
26510;4480;100;38;39;6;33;.846;3162000;0
26510;4629;100;42;3;1;2;.667;438000;0
26510;7790;101;63;25;3;22;.880;3600000;0
26510;9386;101;0;0;0;0;.00nan;0;0
26511;4523;90;11;18;6;12;.667;2394000;0
26511;4705;91;56;20;3;17;.850;3600000;0
26511;6367;90;45;10;2;8;.800;1206000;0
26511;8043;91;0;0;0;0;.00nan;0;0
26512;4872;89;45;5;1;4;.800;771000;0
26512;5966;89;19;24;6;18;.750;2829000;0
26512;6401;88;51;1;0;1;1.000;223000;0
26512;7964;88;32;30;6;24;.800;3377000;0
26513;4838;102;24;10;4;6;.600;2372000;0
26513;5987;103;0;0;0;0;.00nan;0;0
26513;6593;103;46;39;7;32;.821;3641000;0
26513;9426;102;52;12;2;10;.833;1269000;0
26514;4754;96;0;0;0;0;.00nan;0;0
26514;5987;103;33;32;6;26;.813;2980000;0
26514;6593;103;60;7;0;7;1.000;620000;0
26514;9413;96;69;18;1;17;.944;3600000;0
26515;4697;84;0;0;0;0;.00nan;0;0
26515;7333;85;0;0;0;0;.00nan;0;0
26515;7801;84;72;22;1;21;.955;3600000;0
26515;8839;85;52;41;5;36;.878;3600000;0
26516;3867;95;80;21;1;20;.952;3600000;0
26516;4480;100;0;0;0;0;.00nan;0;0
26516;4629;100;98;47;3;44;.936;3600000;0
26516;7909;95;0;0;0;0;.00nan;0;0
26517;4534;94;0;0;0;0;.00nan;0;0
26517;5976;94;53;32;4;28;.875;3581000;0
26517;7790;101;0;0;0;0;.00nan;0;0
26517;9386;101;65;24;2;22;.917;3600000;0
26518;4523;90;0;0;0;0;.00nan;0;0
26518;6367;90;52;39;5;34;.872;3600000;0
26518;6418;92;60;27;2;25;.926;3600000;0
26518;9400;92;0;0;0;0;.00nan;0;0
26519;4603;86;56;26;3;23;.885;3600000;0
26519;4771;86;0;0;0;0;.00nan;0;0
26519;4849;87;0;0;0;0;.00nan;0;0
26519;6579;87;61;31;4;27;.871;3579000;0
26520;4838;102;64;44;4;40;.909;3900000;0
26520;7787;97;58;2;0;2;1.000;598000;0
26520;7870;97;56;30;4;26;.867;3302000;0
26520;9426;102;0;0;0;0;.00nan;0;0
26521;4643;99;37;40;6;34;.850;3254000;0
26521;6581;99;54;4;0;4;1.000;346000;0
26521;6631;98;94;21;0;21;1.000;3600000;0
26521;7426;98;0;0;0;0;.00nan;0;0
26522;4666;93;48;24;4;20;.833;3553000;0
26522;4705;91;0;0;0;0;.00nan;0;0
26522;8043;91;86;42;3;39;.929;3600000;0
26522;9273;93;0;0;0;0;.00nan;0;0
26523;6550;97;0;0;0;0;.00nan;0;0
26523;7787;97;100;26;0;26;1.000;3600000;0
26523;7790;101;50;29;4;25;.862;3600000;0
26523;9386;101;0;0;0;0;.00nan;0;0
26524;4523;90;78;27;2;25;.926;3600000;0
26524;6367;90;0;0;0;0;.00nan;0;0
26524;7333;85;44;23;4;19;.826;3545000;0
26524;8839;85;0;0;0;0;.00nan;0;0
26525;4603;86;0;0;0;0;.00nan;0;0
26525;4697;84;62;29;3;26;.897;3600000;0
26525;4771;86;80;48;5;43;.896;3542000;0
26525;7801;84;0;0;0;0;.00nan;0;0
26526;4480;100;69;33;4;29;.879;3900000;0
26526;4534;94;47;22;4;18;.818;3900000;0
26526;4629;100;0;0;0;0;.00nan;0;0
26526;5976;94;0;0;0;0;.00nan;0;0
26527;4872;89;0;0;0;0;.00nan;0;0
26527;5966;89;51;35;5;30;.857;3579000;0
26527;6418;92;0;0;0;0;.00nan;0;0
26527;9400;92;72;37;3;34;.919;3600000;0
26528;5987;103;0;0;0;0;.00nan;0;0
26528;6593;103;64;52;7;45;.865;3600000;0
26528;6631;98;0;0;0;0;.00nan;0;0
26528;7426;98;60;18;2;16;.889;3600000;0
26529;4849;87;0;0;0;0;.00nan;0;0
26529;6401;88;0;0;0;0;.00nan;0;0
26529;6579;87;53;36;5;31;.861;3600000;0
26529;7964;88;68;31;3;28;.903;3600000;0
26530;4643;99;0;0;0;0;.00nan;0;0
26530;4838;102;0;0;0;0;.00nan;0;0
26530;6581;99;71;27;2;25;.926;3600000;0
26530;9426;102;70;35;3;32;.914;3600000;0
26531;4534;94;0;0;0;0;.00nan;0;0
26531;4754;96;0;0;0;0;.00nan;0;0
26531;5976;94;59;48;6;42;.875;3600000;0
26531;9413;96;31;18;4;14;.778;3600000;0
26532;4872;89;96;41;2;39;.951;3600000;0
26532;5966;89;0;0;0;0;.00nan;0;0
26532;7333;85;59;6;0;6;1.000;691000;0
26532;8839;85;35;27;6;21;.778;2909000;0
26533;3867;95;0;0;0;0;.00nan;0;0
26533;6401;88;58;33;4;29;.879;3533000;0
26533;7909;95;69;22;2;20;.909;3600000;0
26533;7964;88;0;0;0;0;.00nan;0;0
26534;4666;93;0;0;0;0;.00nan;0;0
26534;4705;91;42;37;6;31;.838;3409000;0
26534;8043;91;42;3;1;2;.667;191000;0
26534;9273;93;57;25;3;22;.880;3600000;0
26535;4849;87;45;21;4;17;.810;3589000;0
26535;6418;92;72;29;2;27;.931;3600000;0
26535;6579;87;0;0;0;0;.00nan;0;0
26535;9400;92;0;0;0;0;.00nan;0;0
26536;4603;86;62;33;4;29;.879;3717000;0
26536;4771;86;0;0;0;0;.00nan;0;0
26536;7801;84;67;30;3;27;.900;3717000;0
26536;7823;84;0;0;0;0;.00nan;0;0
26537;4643;99;50;20;3;17;.850;3559000;0
26537;6550;97;0;0;0;0;.00nan;0;0
26537;6581;99;0;0;0;0;.00nan;0;0
26537;7787;97;78;31;2;29;.935;3600000;0
26538;4705;91;12;22;6;16;.727;2393000;0
26538;4872;89;0;0;0;0;.00nan;0;0
26538;5966;89;59;32;4;28;.875;3600000;0
26538;8043;91;67;12;0;12;1.000;1155000;0
26539;4838;102;46;24;3;21;.875;3600000;0
26539;7790;101;54;36;5;31;.861;3581000;0
26539;9386;101;0;0;0;0;.00nan;0;0
26539;9426;102;0;0;0;0;.00nan;0;0
26540;4666;93;50;24;4;20;.833;3600000;0
26540;4849;87;0;0;0;0;.00nan;0;0
26540;6579;87;29;27;5;22;.815;3572000;0
26540;9273;93;0;0;0;0;.00nan;0;0
26541;4534;94;0;0;0;0;.00nan;0;0
26541;5976;94;47;35;5;30;.857;3600000;0
26541;6631;98;60;20;2;18;.900;3600000;0
26541;7426;98;0;0;0;0;.00nan;0;0
26542;3867;95;82;21;1;20;.952;3600000;0
26542;4643;99;93;37;2;35;.946;3545000;0
26542;6581;99;0;0;0;0;.00nan;0;0
26542;7909;95;0;0;0;0;.00nan;0;0
26543;4523;90;50;0;0;0;.00nan;9000;0
26543;6367;90;6;25;8;17;.680;3591000;0
26543;6418;92;55;33;4;29;.879;3600000;0
26543;9400;92;0;0;0;0;.00nan;0;0
26544;4705;91;96;39;1;38;.974;3600000;0
26544;7333;85;0;0;0;0;.00nan;0;0
26544;8043;91;0;0;0;0;.00nan;0;0
26544;8839;85;52;24;3;21;.875;3541000;0
26545;6401;88;0;0;0;0;.00nan;0;0
26545;7801;84;0;0;0;0;.00nan;0;0
26545;7823;84;45;28;5;23;.821;3553000;0
26545;7964;88;47;26;4;22;.846;3600000;0
26546;4754;96;0;0;0;0;.00nan;0;0
26546;5987;103;0;0;0;0;.00nan;0;0
26546;6593;103;46;34;5;29;.853;3600000;0
26546;9413;96;74;20;1;19;.950;3600000;0
26547;4643;99;0;0;0;0;.00nan;0;0
26547;4754;96;60;20;2;18;.900;3599000;0
26547;6581;99;73;21;1;20;.952;3600000;0
26547;9413;96;0;0;0;0;.00nan;0;0
26548;4849;87;0;0;0;0;.00nan;0;0
26548;6579;87;46;26;5;21;.808;3595000;0
26548;7801;84;73;32;3;29;.906;3600000;0
26548;7823;84;0;0;0;0;.00nan;0;0
26549;3867;95;61;14;1;13;.929;3600000;0
26549;7790;101;56;4;0;4;1.000;874000;0
26549;7909;95;0;0;0;0;.00nan;0;0
26549;9386;101;61;49;6;43;.878;2726000;0
26550;4534;94;0;0;0;0;.00nan;0;0
26550;5976;94;86;52;4;48;.923;3600000;0
26550;6631;98;0;0;0;0;.00nan;0;0
26550;7426;98;30;26;5;21;.808;3544000;0
26551;4523;90;68;44;4;40;.909;3600000;0
26551;4666;93;0;0;0;0;.00nan;0;0
26551;6367;90;0;0;0;0;.00nan;0;0
26551;9273;93;54;12;1;11;.917;3600000;0
26552;4603;86;0;0;0;0;.00nan;0;0
26552;4771;86;86;45;3;42;.933;3600000;0
26552;6401;88;10;32;8;24;.750;3600000;0
26552;7964;88;0;0;0;0;.00nan;0;0
26553;4480;100;52;27;5;22;.815;3564000;0
26553;4629;100;0;0;0;0;.00nan;0;0
26553;4838;102;0;0;0;0;.00nan;0;0
26553;9426;102;45;23;4;19;.826;3600000;0
26554;4872;89;0;0;0;0;.00nan;0;0
26554;5966;89;79;32;2;30;.938;3600000;0
26554;7333;85;27;40;7;33;.825;3600000;0
26554;8839;85;0;0;0;0;.00nan;0;0
26555;4603;86;51;30;4;26;.867;1975000;0
26555;4666;93;66;28;3;25;.893;3600000;0
26555;4771;86;65;12;0;12;1.000;1595000;0
26555;9273;93;0;0;0;0;.00nan;0;0
26556;6550;97;0;0;0;0;.00nan;0;0
26556;7787;97;68;17;2;15;.882;3600000;0
26556;7790;101;77;39;3;36;.923;3600000;0
26556;9386;101;0;0;0;0;.00nan;0;0
26557;4754;96;0;0;0;0;.00nan;0;0
26557;6631;98;65;23;2;21;.913;3600000;0
26557;7426;98;0;0;0;0;.00nan;0;0
26557;9413;96;59;43;5;38;.884;3600000;0
26558;4838;102;58;45;6;39;.867;2939000;0
26558;5987;103;31;28;6;22;.786;3536000;0
26558;6593;103;48;5;1;4;.800;76000;0
26558;9426;102;51;1;0;1;1.000;673000;0
26559;4534;94;75;35;4;31;.886;3600000;0
26559;4643;99;47;35;5;30;.857;3544000;0
26559;5976;94;0;0;0;0;.00nan;0;0
26559;6581;99;0;0;0;0;.00nan;0;0
26560;3867;95;0;0;0;0;.00nan;0;0
26560;6550;97;33;26;5;21;.808;3600000;0
26560;7787;97;0;0;0;0;.00nan;0;0
26560;7909;95;49;41;6;35;.854;3557000;0
26561;4697;84;42;37;6;31;.838;3669000;0
26561;6401;88;0;0;0;0;.00nan;0;0
26561;7801;84;0;0;0;0;.00nan;0;0
26561;7964;88;34;30;5;25;.833;3665000;0
26562;4523;90;0;0;0;0;.00nan;0;0
26562;4603;86;64;33;3;30;.909;3600000;0
26562;4771;86;0;0;0;0;.00nan;0;0
26562;6367;90;29;32;7;25;.781;3600000;0
26563;4705;91;0;0;0;0;.00nan;0;0
26563;6418;92;88;29;1;28;.966;3673000;0
26563;8043;91;100;32;0;32;1.000;3673000;0
26563;9400;92;0;0;0;0;.00nan;0;0
26564;4849;87;0;0;0;0;.00nan;0;0
26564;6579;87;85;18;0;18;1.000;3600000;0
26564;7333;85;48;0;0;0;.00nan;147000;0
26564;8839;85;8;29;8;21;.724;3453000;0
26565;4480;100;0;0;0;0;.00nan;0;0
26565;4629;100;44;36;5;31;.861;3600000;0
26565;5987;103;60;8;0;8;1.000;548000;0
26565;6593;103;40;32;6;26;.813;3038000;0
26567;4771;86;56;27;4;23;.852;3900000;0
26567;4838;102;85;49;4;45;.918;3900000;0
26567;9240;-1;0;0;0;0;.00nan;0;0
26567;9426;102;0;0;0;0;.00nan;0;0
26569;4754;96;0;0;0;0;.00nan;0;0
26569;6631;98;71;30;2;28;.933;3600000;0
26569;7426;98;0;0;0;0;.00nan;0;0
26569;9413;96;57;34;5;29;.853;3600000;0
26571;4872;89;0;0;0;0;.00nan;0;0
26571;5966;89;41;28;5;23;.821;3600000;0
26571;7323;103;30;8;3;5;.625;394000;0
26571;8857;103;29;24;5;19;.792;3206000;0
26573;4480;100;13;39;8;31;.795;2446000;0
26573;6503;100;41;10;2;8;.800;1154000;0
26573;6579;87;63;13;1;12;.923;3600000;0
26573;8790;87;0;0;0;0;.00nan;0;0
26575;3867;95;67;23;2;21;.913;3600000;0
26575;6448;95;0;0;0;0;.00nan;0;0
26575;7790;101;72;45;5;40;.889;3600000;0
26575;9386;101;0;0;0;0;.00nan;0;0
26577;4523;90;18;26;7;19;.731;2009000;0
26577;4697;84;92;40;2;38;.950;3600000;0
26577;6367;90;73;13;0;13;1.000;1591000;0
26577;7801;84;0;0;0;0;.00nan;0;0
26579;4666;93;80;26;1;25;.962;3600000;0
26579;7333;85;74;35;3;32;.914;3600000;0
26579;9273;93;0;0;0;0;.00nan;0;0
26579;9378;85;0;0;0;0;.00nan;0;0
26581;4705;91;54;25;4;21;.840;3600000;0
26581;5976;94;43;43;6;37;.860;3571000;0
26581;7876;100;0;0;0;0;.00nan;0;0
26581;8043;91;0;0;0;0;.00nan;0;0
26583;4643;99;0;0;0;0;.00nan;0;0
26583;6418;92;51;16;2;14;.875;3600000;0
26583;6581;99;26;35;8;27;.771;3600000;0
26583;9400;92;0;0;0;0;.00nan;0;0
26585;4629;100;63;39;4;35;.897;3600000;0
26585;6593;103;0;0;0;0;.00nan;0;0
26585;7870;97;0;0;0;0;.00nan;0;0
26585;9454;88;60;23;2;21;.913;3600000;0
26587;4838;102;0;0;0;0;.00nan;0;0
26587;6579;87;13;21;6;15;.714;3307000;0
26587;8790;87;49;1;0;1;1.000;293000;0
26587;9426;102;86;44;3;41;.932;3600000;0
26589;3867;95;85;39;3;36;.923;3571000;0
26589;4666;93;0;0;0;0;.00nan;0;0
26589;6448;95;0;0;0;0;.00nan;0;0
26589;9273;93;79;37;2;35;.946;3600000;0
26591;6593;103;50;25;3;22;.880;3519000;0
26591;7323;103;0;0;0;0;.00nan;0;0
26591;8857;103;81;32;1;31;.969;3600000;0
26591;9454;88;0;0;0;0;.00nan;0;0
26593;4705;91;0;0;0;0;.00nan;0;0
26593;7790;101;63;29;3;26;.897;1773000;0
26593;8043;91;63;18;1;17;.944;3600000;0
26593;9386;101;27;27;6;21;.778;1827000;0
26595;4872;89;34;29;5;24;.828;3581000;0
26595;5966;89;0;0;0;0;.00nan;0;0
26595;5976;94;0;0;0;0;.00nan;0;0
26595;7876;100;58;25;3;22;.880;3600000;0
26597;4771;86;0;0;0;0;.00nan;0;0
26597;6631;98;0;0;0;0;.00nan;0;0
26597;7426;98;83;48;4;44;.917;3900000;0
26597;9240;-1;57;26;4;22;.846;3900000;0
26599;4480;100;68;44;5;39;.886;3600000;0
26599;4523;90;77;26;2;24;.923;3600000;0
26599;6367;90;0;0;0;0;.00nan;0;0
26599;6503;100;0;0;0;0;.00nan;0;0
26601;4754;96;88;32;2;30;.938;3600000;0
26601;7333;85;0;0;0;0;.00nan;0;0
26601;9378;85;41;28;4;24;.857;3600000;0
26601;9413;96;0;0;0;0;.00nan;0;0
26603;4629;100;51;14;2;12;.857;1153000;0
26603;4697;84;0;0;0;0;.00nan;0;0
26603;7801;84;35;25;5;20;.800;3600000;0
26603;7870;97;38;37;6;31;.838;2447000;0
26605;4643;99;77;38;3;35;.921;3546000;0
26605;6418;92;64;17;1;16;.941;3600000;0
26605;6581;99;0;0;0;0;.00nan;0;0
26605;9400;92;0;0;0;0;.00nan;0;0
26607;4523;90;41;15;3;12;.800;1272000;0
26607;6367;90;41;30;5;25;.833;2328000;0
26607;6593;103;0;0;0;0;.00nan;0;0
26607;9454;88;44;33;5;28;.848;3600000;0
26609;4697;84;29;27;6;21;.778;2383000;0
26609;5976;94;70;28;2;26;.929;3600000;0
26609;7801;84;56;12;1;11;.917;1217000;0
26609;7876;100;0;0;0;0;.00nan;0;0
26611;4643;99;0;0;0;0;.00nan;0;0
26611;6581;99;90;35;2;33;.943;3600000;0
26611;7333;85;72;38;4;34;.895;3572000;0
26611;9378;85;0;0;0;0;.00nan;0;0
26613;4629;100;67;29;2;27;.931;3600000;0
26613;4666;93;66;37;4;33;.892;3600000;0
26613;7787;97;0;0;0;0;.00nan;0;0
26613;9273;93;0;0;0;0;.00nan;0;0
26615;4705;91;40;23;5;18;.783;3600000;0
26615;4771;86;90;42;2;40;.952;3600000;0
26615;8043;91;0;0;0;0;.00nan;0;0
26615;9240;-1;0;0;0;0;.00nan;0;0
26617;3867;95;63;7;0;7;1.000;1454000;0
26617;4838;102;63;45;5;40;.889;3794000;0
26617;6448;95;34;18;4;14;.778;2340000;0
26617;9426;102;0;0;0;0;.00nan;0;0
26619;4754;96;0;0;0;0;.00nan;0;0
26619;6418;92;48;0;0;0;.00nan;69000;0
26619;9400;92;44;43;6;37;.860;3531000;0
26619;9413;96;56;23;2;21;.913;3600000;0
26621;6579;87;0;0;0;0;.00nan;0;0
26621;7323;103;74;54;5;49;.907;3595000;0
26621;8790;87;32;17;4;13;.765;3600000;0
26621;8857;103;0;0;0;0;.00nan;0;0
26623;4480;100;55;13;1;12;.923;912000;0
26623;4872;89;64;9;0;9;1.000;797000;0
26623;5966;89;49;25;4;21;.840;2803000;0
26623;6503;100;25;26;6;20;.769;2688000;0
26625;6631;98;54;36;5;31;.861;3598000;0
26625;7426;98;0;0;0;0;.00nan;0;0
26625;7790;101;0;0;0;0;.00nan;0;0
26625;9386;101;45;21;4;17;.810;3600000;0
26627;4643;99;0;0;0;0;.00nan;0;0
26627;5976;94;32;31;5;26;.839;3600000;0
26627;6581;99;70;29;2;27;.931;3600000;0
26627;7876;100;0;0;0;0;.00nan;0;0
26629;4666;93;0;0;0;0;.00nan;0;0
26629;6418;92;62;31;3;28;.903;3599000;0
26629;9273;93;70;30;2;28;.933;3600000;0
26629;9400;92;0;0;0;0;.00nan;0;0
26631;4629;100;0;0;0;0;.00nan;0;0
26631;4705;91;0;0;0;0;.00nan;0;0
26631;7787;97;85;37;3;34;.919;3545000;0
26631;8043;91;55;21;2;19;.905;3600000;0
26633;4872;89;51;2;0;2;1.000;415000;0
26633;5966;89;40;40;7;33;.825;3185000;0
26633;7790;101;84;40;2;38;.950;3600000;0
26633;9386;101;0;0;0;0;.00nan;0;0
26635;6631;98;0;0;0;0;.00nan;0;0
26635;7333;85;0;0;0;0;.00nan;0;0
26635;7426;98;99;24;0;24;1.000;3600000;0
26635;9378;85;72;41;4;37;.902;3600000;0
26637;4480;100;20;26;7;19;.731;3084000;0
26637;4838;102;0;0;0;0;.00nan;0;0
26637;6503;100;62;9;0;9;1.000;516000;0
26637;9426;102;43;26;4;22;.846;3600000;0
26639;3867;95;0;0;0;0;.00nan;0;0
26639;4697;84;92;37;1;36;.973;3600000;0
26639;6448;95;37;26;5;21;.808;3600000;0
26639;7801;84;0;0;0;0;.00nan;0;0
26641;4523;90;0;0;0;0;.00nan;0;0
26641;4771;86;36;24;5;19;.792;3593000;0
26641;6367;90;79;33;3;30;.909;3600000;0
26641;9240;-1;0;0;0;0;.00nan;0;0
26643;6579;87;64;32;3;29;.906;3578000;0
26643;6593;103;83;33;2;31;.939;3600000;0
26643;8790;87;0;0;0;0;.00nan;0;0
26643;9454;88;0;0;0;0;.00nan;0;0
26645;4754;96;0;0;0;0;.00nan;0;0
26645;7323;103;0;0;0;0;.00nan;0;0
26645;8857;103;51;39;5;34;.872;3600000;0
26645;9413;96;66;22;2;20;.909;3600000;0
26647;4629;100;60;20;2;18;.900;3548000;0
26647;5976;94;0;0;0;0;.00nan;0;0
26647;7787;97;0;0;0;0;.00nan;0;0
26647;7876;100;100;45;1;44;.978;3600000;0
26649;4697;84;0;0;0;0;.00nan;0;0
26649;4771;86;0;0;0;0;.00nan;0;0
26649;7801;84;63;30;3;27;.900;3600000;0
26649;9240;-1;65;40;4;36;.900;3552000;0
26651;4754;96;31;12;3;9;.750;578000;0
26651;6579;87;0;0;0;0;.00nan;0;0
26651;8790;87;70;21;1;20;.952;3600000;0
26651;9413;96;60;17;1;16;.941;3022000;0
26653;4872;89;80;40;3;37;.925;3709000;0
26653;5966;89;0;0;0;0;.00nan;0;0
26653;7333;85;86;58;4;54;.931;3709000;0
26653;9378;85;0;0;0;0;.00nan;0;0
26655;4643;99;32;35;7;28;.800;3600000;0
26655;4838;102;36;27;5;22;.815;3600000;0
26655;6581;99;0;0;0;0;.00nan;0;0
26655;9426;102;0;0;0;0;.00nan;0;0
26657;4523;90;49;45;6;39;.867;3600000;0
26657;4666;93;60;19;2;17;.895;3600000;0
26657;6367;90;0;0;0;0;.00nan;0;0
26657;9273;93;0;0;0;0;.00nan;0;0
26659;4480;100;0;0;0;0;.00nan;0;0
26659;6418;92;0;0;0;0;.00nan;0;0
26659;6503;100;55;37;5;32;.865;3564000;0
26659;9400;92;43;24;4;20;.833;3600000;0
26661;4705;91;95;32;1;31;.969;3600000;0
26661;7790;101;0;0;0;0;.00nan;0;0
26661;8043;91;0;0;0;0;.00nan;0;0
26661;9386;101;69;34;2;32;.941;3600000;0
26663;3867;95;63;34;4;30;.882;3530000;0
26663;6448;95;0;0;0;0;.00nan;0;0
26663;6593;103;0;0;0;0;.00nan;0;0
26663;9454;88;73;31;2;29;.935;3600000;0
26665;6631;98;0;0;0;0;.00nan;0;0
26665;7323;103;66;47;5;42;.894;3600000;0
26665;7426;98;63;13;1;12;.923;3600000;0
26665;8857;103;0;0;0;0;.00nan;0;0
26667;4629;100;0;0;0;0;.00nan;0;0
26667;4872;89;57;6;0;6;1.000;595000;0
26667;5966;89;33;33;6;27;.818;3005000;0
26667;7787;97;93;30;1;29;.967;3600000;0
26669;4754;96;0;0;0;0;.00nan;0;0
26669;4771;86;69;33;3;30;.909;3900000;0
26669;9240;-1;0;0;0;0;.00nan;0;0
26669;9413;96;75;36;3;33;.917;3900000;0
26671;4838;102;0;0;0;0;.00nan;0;0
26671;6418;92;62;26;3;23;.885;3900000;0
26671;9400;92;0;0;0;0;.00nan;0;0
26671;9426;102;97;42;3;39;.929;3900000;0
26673;4480;100;72;47;4;43;.915;3900000;0
26673;5976;94;44;24;4;20;.833;3900000;0
26673;6503;100;0;0;0;0;.00nan;0;0
26673;7876;100;0;0;0;0;.00nan;0;0
26675;6579;87;49;21;3;18;.857;3600000;0
26675;7323;103;0;0;0;0;.00nan;0;0
26675;8790;87;0;0;0;0;.00nan;0;0
26675;8857;103;72;43;4;39;.907;3588000;0
26677;4643;99;0;0;0;0;.00nan;0;0
26677;4666;93;48;0;0;0;.00nan;104000;0
26677;6581;99;67;30;3;27;.900;3600000;0
26677;9273;93;47;34;6;28;.824;3496000;0
26679;3867;95;21;34;7;27;.794;2873000;0
26679;6448;95;43;4;1;3;.750;727000;0
26679;7333;85;0;0;0;0;.00nan;0;0
26679;9378;85;38;33;5;28;.848;3600000;0
26681;4697;84;70;44;5;39;.886;3798000;0
26681;4705;91;0;0;0;0;.00nan;0;0
26681;7801;84;0;0;0;0;.00nan;0;0
26681;8043;91;37;18;4;14;.778;3831000;0
26683;4523;90;44;11;2;9;.818;626000;0
26683;6367;90;28;34;7;27;.794;2974000;0
26683;7790;101;69;34;3;31;.912;3600000;0
26683;9386;101;0;0;0;0;.00nan;0;0
26685;6593;103;53;26;3;23;.885;3600000;0
26685;6631;98;76;46;4;42;.913;3579000;0
26685;7426;98;0;0;0;0;.00nan;0;0
26685;9454;88;0;0;0;0;.00nan;0;0
26687;4771;86;0;0;0;0;.00nan;0;0
26687;4872;89;74;27;2;25;.926;3600000;0
26687;5966;89;0;0;0;0;.00nan;0;0
26687;9240;-1;57;36;4;32;.889;3580000;0
26689;4523;90;68;28;3;25;.893;3600000;0
26689;4643;99;42;28;5;23;.821;3587000;0
26689;6367;90;0;0;0;0;.00nan;0;0
26689;6581;99;0;0;0;0;.00nan;0;0
26691;4629;100;59;15;1;14;.933;3600000;0
26691;7333;85;2;20;7;13;.650;2073000;0
26691;7787;97;0;0;0;0;.00nan;0;0
26691;9378;85;27;19;4;15;.789;1527000;0
26693;7323;103;67;42;5;37;.881;3584000;0
26693;7790;101;0;0;0;0;.00nan;0;0
26693;8857;103;0;0;0;0;.00nan;0;0
26693;9386;101;64;33;3;30;.909;3600000;0
26695;4697;84;0;0;0;0;.00nan;0;0
26695;6631;98;0;0;0;0;.00nan;0;0
26695;7426;98;100;51;2;49;.961;3600000;0
26695;7801;84;54;17;3;14;.824;3543000;0
26697;4705;91;60;29;4;25;.862;3544000;0
26697;6593;103;0;0;0;0;.00nan;0;0
26697;8043;91;0;0;0;0;.00nan;0;0
26697;9454;88;71;29;3;26;.897;3600000;0
26699;4666;93;38;23;4;19;.826;3600000;0
26699;6418;92;40;26;4;22;.846;2762000;0
26699;9273;93;0;0;0;0;.00nan;0;0
26699;9400;92;16;9;4;5;.556;838000;0
26701;3867;95;0;0;0;0;.00nan;0;0
26701;4754;96;75;38;3;35;.921;3520000;0
26701;6448;95;88;31;1;30;.968;3600000;0
26701;9413;96;0;0;0;0;.00nan;0;0
26703;4480;100;0;0;0;0;.00nan;0;0
26703;6503;100;78;35;2;33;.943;3600000;0
26703;6579;87;0;0;0;0;.00nan;0;0
26703;8790;87;56;18;3;15;.833;3560000;0
26705;4838;102;28;14;4;10;.714;1181000;0
26705;5976;94;0;0;0;0;.00nan;0;0
26705;7876;100;68;18;1;17;.944;3600000;0
26705;9426;102;43;25;4;21;.840;2419000;0
28442;4523;90;44;37;6;31;.838;3539000;0
28442;4705;91;0;0;0;0;.00nan;0;0
28442;6367;90;48;0;0;0;.00nan;61000;0
28442;8043;91;85;18;0;18;1.000;3600000;0
28443;4697;84;49;22;3;19;.864;3600000;0
28443;6418;92;100;35;0;35;1.000;3600000;0
28443;7801;84;0;0;0;0;.00nan;0;0
28443;9400;92;0;0;0;0;.00nan;0;0
28444;4666;93;35;19;5;14;.737;3547000;0
28444;4872;89;73;44;4;40;.909;3600000;0
28444;5966;89;0;0;0;0;.00nan;0;0
28444;9273;93;0;0;0;0;.00nan;0;0
28445;4849;87;0;0;0;0;.00nan;0;0
28445;6401;88;0;0;0;0;.00nan;0;0
28445;6579;87;48;24;3;21;.875;3600000;0
28445;7964;88;63;36;4;32;.889;3600000;0
28446;5987;103;0;0;0;0;.00nan;0;0
28446;6550;97;0;0;0;0;.00nan;0;0
28446;6593;103;64;43;4;39;.907;3600000;0
28446;7787;97;60;20;2;18;.900;3600000;0
28447;4480;100;79;38;3;35;.921;3656000;0
28447;4629;100;0;0;0;0;.00nan;0;0
28447;4838;102;42;19;4;15;.789;3658000;0
28447;9426;102;0;0;0;0;.00nan;0;0
28448;3867;95;78;20;1;19;.950;3600000;0
28448;4534;94;0;0;0;0;.00nan;0;0
28448;5976;94;53;35;5;30;.857;3600000;0
28448;7909;95;0;0;0;0;.00nan;0;0
28449;4754;96;0;0;0;0;.00nan;0;0
28449;6631;98;48;32;5;27;.844;3554000;0
28449;7426;98;0;0;0;0;.00nan;0;0
28449;9413;96;58;33;4;29;.879;3600000;0
28450;4523;90;92;31;2;29;.935;3600000;0
28450;4705;91;0;0;0;0;.00nan;0;0
28450;6367;90;0;0;0;0;.00nan;0;0
28450;8043;91;69;33;4;29;.879;3545000;0
28451;4697;84;91;34;1;33;.971;3600000;0
28451;6418;92;76;31;2;29;.935;3557000;0
28451;7801;84;0;0;0;0;.00nan;0;0
28451;9400;92;0;0;0;0;.00nan;0;0
28452;4666;93;20;27;7;20;.741;3600000;0
28452;4872;89;66;42;4;38;.905;3600000;0
28452;5966;89;0;0;0;0;.00nan;0;0
28452;9273;93;0;0;0;0;.00nan;0;0
28453;4849;87;0;0;0;0;.00nan;0;0
28453;6401;88;0;0;0;0;.00nan;0;0
28453;6579;87;58;21;3;18;.857;3600000;0
28453;7964;88;60;49;5;44;.898;3600000;0
28454;5987;103;0;0;0;0;.00nan;0;0
28454;6550;97;0;0;0;0;.00nan;0;0
28454;6593;103;39;28;5;23;.821;3600000;0
28454;7787;97;94;19;0;19;1.000;3600000;0
28455;4480;100;25;33;6;27;.818;3529000;0
28455;4629;100;48;0;0;0;.00nan;67000;0
28455;4838;102;37;24;5;19;.792;3600000;0
28455;9426;102;0;0;0;0;.00nan;0;0
28456;3867;95;84;16;0;16;1.000;3600000;0
28456;4534;94;0;0;0;0;.00nan;0;0
28456;5976;94;71;48;5;43;.896;3600000;0
28456;7909;95;0;0;0;0;.00nan;0;0
28457;4754;96;0;0;0;0;.00nan;0;0
28457;6631;98;54;33;5;28;.848;3552000;0
28457;7426;98;0;0;0;0;.00nan;0;0
28457;9413;96;55;30;4;26;.867;3600000;0
28458;4523;90;32;31;6;25;.806;2752000;0
28458;4705;91;35;13;3;10;.769;2200000;0
28458;6367;90;57;11;1;10;.909;848000;0
28458;8043;91;7;14;6;8;.571;1333000;0
28459;4697;84;40;23;4;19;.826;3572000;0
28459;6418;92;66;27;3;24;.889;3600000;0
28459;7801;84;0;0;0;0;.00nan;0;0
28459;9400;92;0;0;0;0;.00nan;0;0
28460;4666;93;51;23;3;20;.870;3600000;0
28460;4872;89;55;30;4;26;.867;3581000;0
28460;5966;89;0;0;0;0;.00nan;0;0
28460;9273;93;0;0;0;0;.00nan;0;0
28461;4849;87;0;0;0;0;.00nan;0;0
28461;6401;88;56;2;0;2;1.000;425000;0
28461;6579;87;74;27;2;25;.926;3600000;0
28461;7964;88;48;36;5;31;.861;3175000;0
28462;5987;103;54;18;2;16;.889;1850000;0
28462;6550;97;0;0;0;0;.00nan;0;0
28462;6593;103;28;13;4;9;.692;1750000;0
28462;7787;97;62;25;3;22;.880;3600000;0
28463;4480;100;49;23;4;19;.826;3600000;0
28463;4629;100;0;0;0;0;.00nan;0;0
28463;4838;102;70;37;3;34;.919;3600000;0
28463;9426;102;0;0;0;0;.00nan;0;0
28464;3867;95;54;19;3;16;.842;3792000;0
28464;4534;94;0;0;0;0;.00nan;0;0
28464;5976;94;75;39;4;35;.897;3792000;0
28464;7909;95;0;0;0;0;.00nan;0;0
28465;4754;96;0;0;0;0;.00nan;0;0
28465;6631;98;79;30;2;28;.933;3600000;0
28465;7426;98;0;0;0;0;.00nan;0;0
28465;9413;96;51;24;3;21;.875;3600000;0
28466;4523;90;0;0;0;0;.00nan;0;0
28466;4705;91;93;24;0;24;1.000;3600000;0
28466;6367;90;25;30;6;24;.800;3600000;0
28466;8043;91;0;0;0;0;.00nan;0;0
28467;4697;84;60;28;2;26;.929;4448000;0
28467;6418;92;76;31;3;28;.903;4448000;0
28467;7801;84;0;0;0;0;.00nan;0;0
28467;9400;92;0;0;0;0;.00nan;0;0
28468;4666;93;52;20;3;17;.850;3600000;0
28468;4872;89;66;37;4;33;.892;3562000;0
28468;5966;89;0;0;0;0;.00nan;0;0
28468;9273;93;0;0;0;0;.00nan;0;0
28469;4849;87;0;0;0;0;.00nan;0;0
28469;6401;88;25;25;6;19;.760;3318000;0
28469;6579;87;63;26;3;23;.885;3600000;0
28469;7964;88;55;4;0;4;1.000;282000;0
28470;5987;103;0;0;0;0;.00nan;0;0
28470;6550;97;0;0;0;0;.00nan;0;0
28470;6593;103;65;37;3;34;.919;3737000;0
28470;7787;97;42;21;4;17;.810;3718000;0
28471;4480;100;66;45;5;40;.889;3600000;0
28471;4629;100;0;0;0;0;.00nan;0;0
28471;4838;102;37;29;6;23;.793;2436000;0
28471;9426;102;50;1;0;1;1.000;1113000;0
28472;3867;95;89;19;0;19;1.000;3600000;0
28472;4534;94;0;0;0;0;.00nan;0;0
28472;5976;94;41;43;6;37;.860;3600000;0
28472;7909;95;0;0;0;0;.00nan;0;0
28473;4754;96;0;0;0;0;.00nan;0;0
28473;6631;98;53;27;3;24;.889;4121000;0
28473;7426;98;0;0;0;0;.00nan;0;0
28473;9413;96;51;31;4;27;.871;4121000;0
28485;4523;90;0;0;0;0;.00nan;0;0
28485;4705;91;97;18;0;18;1.000;3600000;0
28485;6367;90;79;36;2;34;.944;3600000;0
28485;8043;91;0;0;0;0;.00nan;0;0
28486;4697;84;7;18;6;12;.667;2763000;0
28486;6418;92;57;34;4;30;.882;3600000;0
28486;7801;84;42;9;2;7;.778;837000;0
28486;9400;92;0;0;0;0;.00nan;0;0
28487;4666;93;41;26;5;21;.808;3536000;0
28487;4872;89;75;38;3;35;.921;3600000;0
28487;5966;89;0;0;0;0;.00nan;0;0
28487;9273;93;0;0;0;0;.00nan;0;0
28488;5987;103;0;0;0;0;.00nan;0;0
28488;6550;97;0;0;0;0;.00nan;0;0
28488;6593;103;56;43;5;38;.884;3551000;0
28488;7787;97;43;20;4;16;.800;3600000;0
28489;4480;100;25;28;6;22;.786;3600000;0
28489;4629;100;0;0;0;0;.00nan;0;0
28489;4838;102;0;0;0;0;.00nan;0;0
28489;9426;102;52;21;2;19;.905;3600000;0
28490;4754;96;0;0;0;0;.00nan;0;0
28490;6631;98;31;15;4;11;.733;3575000;0
28490;7426;98;0;0;0;0;.00nan;0;0
28490;9413;96;75;29;2;27;.931;3600000;0
28499;4523;90;0;0;0;0;.00nan;0;0
28499;4705;91;52;28;5;23;.821;3588000;0
28499;6367;90;57;33;4;29;.879;3600000;0
28499;8043;91;0;0;0;0;.00nan;0;0
28500;4697;84;0;0;0;0;.00nan;0;0
28500;6418;92;60;32;4;28;.875;3600000;0
28500;7801;84;23;40;8;32;.800;3600000;0
28500;9400;92;0;0;0;0;.00nan;0;0
28501;4666;93;46;17;3;14;.824;3558000;0
28501;4872;89;73;30;2;28;.933;3600000;0
28501;5966;89;0;0;0;0;.00nan;0;0
28501;9273;93;0;0;0;0;.00nan;0;0
28502;4480;100;30;30;6;24;.800;3261000;0
28502;4629;100;53;3;0;3;1.000;281000;0
28502;4838;102;0;0;0;0;.00nan;0;0
28502;9426;102;61;44;5;39;.886;3600000;0
28503;4754;96;0;0;0;0;.00nan;0;0
28503;6631;98;54;27;3;24;.889;3576000;0
28503;7426;98;0;0;0;0;.00nan;0;0
28503;9413;96;64;26;2;24;.923;3600000;0
28514;4523;90;0;0;0;0;.00nan;0;0
28514;4705;91;97;32;1;31;.969;3600000;0
28514;6367;90;72;30;2;28;.933;3587000;0
28514;8043;91;0;0;0;0;.00nan;0;0
28554;4705;91;64;33;3;30;.909;3556000;0
28554;6418;92;68;24;2;22;.917;3600000;0
28554;8043;91;0;0;0;0;.00nan;0;0
28554;9400;92;0;0;0;0;.00nan;0;0
28555;4849;87;0;0;0;0;.00nan;0;0
28555;4872;89;32;27;5;22;.815;2139000;0
28555;5966;89;62;19;2;17;.895;1723000;0
28555;6579;87;20;24;6;18;.750;3862000;0
28556;4838;102;0;0;0;0;.00nan;0;0
28556;6550;97;0;0;0;0;.00nan;0;0
28556;7787;97;65;18;2;16;.889;3600000;0
28556;9426;102;66;33;3;30;.909;3575000;0
28557;3867;95;57;30;4;26;.867;3600000;0
28557;4754;96;0;0;0;0;.00nan;0;0
28557;7909;95;0;0;0;0;.00nan;0;0
28557;9413;96;78;31;1;30;.968;3600000;0
28558;4705;91;93;41;2;39;.951;3600000;0
28558;6418;92;10;23;7;16;.696;2907000;0
28558;8043;91;0;0;0;0;.00nan;0;0
28558;9400;92;52;2;0;2;1.000;693000;0
28559;4849;87;0;0;0;0;.00nan;0;0
28559;4872;89;70;32;3;29;.906;3600000;0
28559;5966;89;0;0;0;0;.00nan;0;0
28559;6579;87;100;29;0;29;1.000;3600000;0
28560;4838;102;0;0;0;0;.00nan;0;0
28560;6550;97;0;0;0;0;.00nan;0;0
28560;7787;97;78;37;3;34;.919;3600000;0
28560;9426;102;95;26;0;26;1.000;3600000;0
28561;3867;95;61;35;4;31;.886;3702000;0
28561;4754;96;0;0;0;0;.00nan;0;0
28561;7909;95;0;0;0;0;.00nan;0;0
28561;9413;96;69;30;3;27;.900;3702000;0
28562;4705;91;40;28;5;23;.821;3595000;0
28562;6418;92;61;31;4;27;.871;3600000;0
28562;8043;91;0;0;0;0;.00nan;0;0
28562;9400;92;0;0;0;0;.00nan;0;0
28563;4849;87;0;0;0;0;.00nan;0;0
28563;4872;89;63;22;2;20;.909;3963000;0
28563;5966;89;0;0;0;0;.00nan;0;0
28563;6579;87;59;23;3;20;.870;3967000;0
28564;4838;102;0;0;0;0;.00nan;0;0
28564;6550;97;0;0;0;0;.00nan;0;0
28564;7787;97;42;22;4;18;.818;3525000;0
28564;9426;102;77;33;2;31;.939;3600000;0
28565;3867;95;67;38;5;33;.868;4019000;0
28565;4754;96;0;0;0;0;.00nan;0;0
28565;7909;95;0;0;0;0;.00nan;0;0
28565;9413;96;57;27;4;23;.852;3967000;0
28566;4705;91;89;29;1;28;.966;3600000;0
28566;6418;92;34;11;3;8;.727;492000;0
28566;8043;91;0;0;0;0;.00nan;0;0
28566;9400;92;55;28;3;25;.893;3108000;0
28567;4849;87;0;0;0;0;.00nan;0;0
28567;4872;89;73;35;3;32;.914;3600000;0
28567;5966;89;0;0;0;0;.00nan;0;0
28567;6579;87;37;20;4;16;.800;3577000;0
28568;4838;102;0;0;0;0;.00nan;0;0
28568;6550;97;0;0;0;0;.00nan;0;0
28568;7787;97;52;14;2;12;.857;3600000;0
28568;9426;102;50;40;5;35;.875;3600000;0
28569;3867;95;24;34;7;27;.794;3570000;0
28569;4754;96;50;0;0;0;.00nan;22000;0
28569;7909;95;0;0;0;0;.00nan;0;0
28569;9413;96;69;48;6;42;.875;3578000;0
28629;4705;91;70;25;2;23;.920;3600000;0
28629;6418;92;63;37;4;33;.892;3532000;0
28629;8043;91;0;0;0;0;.00nan;0;0
28629;9400;92;0;0;0;0;.00nan;0;0
28630;4849;87;0;0;0;0;.00nan;0;0
28630;4872;89;8;19;6;13;.684;2320000;0
28630;5966;89;35;12;3;9;.750;1280000;0
28630;6579;87;74;35;3;32;.914;3600000;0
28631;4838;102;0;0;0;0;.00nan;0;0
28631;6550;97;0;0;0;0;.00nan;0;0
28631;7787;97;59;31;4;27;.871;3600000;0
28631;9426;102;67;52;6;46;.885;3600000;0
28635;4705;91;54;36;4;32;.889;3600000;0
28635;6418;92;87;16;0;16;1.000;3600000;0
28635;8043;91;0;0;0;0;.00nan;0;0
28635;9400;92;0;0;0;0;.00nan;0;0
28636;4849;87;0;0;0;0;.00nan;0;0
28636;4872;89;0;0;0;0;.00nan;0;0
28636;5966;89;67;40;4;36;.900;3600000;0
28636;6579;87;100;20;0;20;1.000;3600000;0
28637;4838;102;0;0;0;0;.00nan;0;0
28637;6550;97;0;0;0;0;.00nan;0;0
28637;7787;97;47;28;5;23;.821;3600000;0
28637;9426;102;69;36;3;33;.917;3600000;0
28640;4705;91;87;26;2;24;.923;3600000;0
28640;6418;92;60;27;3;24;.889;3584000;0
28640;8043;91;0;0;0;0;.00nan;0;0
28640;9400;92;0;0;0;0;.00nan;0;0
28641;4838;102;0;0;0;0;.00nan;0;0
28641;6550;97;0;0;0;0;.00nan;0;0
28641;7787;97;40;28;5;23;.821;3600000;0
28641;9426;102;80;32;2;30;.938;3600000;0
28658;4705;91;46;37;6;31;.838;3587000;0
28658;4849;87;0;0;0;0;.00nan;0;0
28658;6579;87;34;23;5;18;.783;3600000;0
28658;8043;91;0;0;0;0;.00nan;0;0
28659;4754;96;0;0;0;0;.00nan;0;0
28659;4838;102;56;30;4;26;.867;3562000;0
28659;8881;102;0;0;0;0;.00nan;0;0
28659;9413;96;48;23;3;20;.870;3600000;0
28660;4705;91;29;25;5;20;.800;3600000;0
28660;4849;87;0;0;0;0;.00nan;0;0
28660;6579;87;81;30;2;28;.933;3600000;0
28660;8043;91;0;0;0;0;.00nan;0;0
28661;4754;96;0;0;0;0;.00nan;0;0
28661;4838;102;62;28;4;24;.857;3622000;0
28661;8881;102;0;0;0;0;.00nan;0;0
28661;9413;96;45;23;3;20;.870;3622000;0
28662;4705;91;74;44;5;39;.886;3600000;0
28662;4849;87;0;0;0;0;.00nan;0;0
28662;6579;87;56;16;2;14;.875;3600000;0
28662;8043;91;0;0;0;0;.00nan;0;0
28663;4754;96;0;0;0;0;.00nan;0;0
28663;4838;102;64;30;4;26;.867;3558000;0
28663;8881;102;0;0;0;0;.00nan;0;0
28663;9413;96;71;32;3;29;.906;3600000;0
28664;4705;91;62;39;4;35;.897;3600000;0
28664;4849;87;0;0;0;0;.00nan;0;0
28664;6579;87;73;27;2;25;.926;3600000;0
28664;8043;91;0;0;0;0;.00nan;0;0
28665;4754;96;0;0;0;0;.00nan;0;0
28665;4838;102;32;19;5;14;.737;2175000;0
28665;8881;102;72;21;1;20;.952;1425000;0
28665;9413;96;68;30;3;27;.900;3600000;0
28711;4754;96;0;0;0;0;.00nan;0;0
28711;4849;87;0;0;0;0;.00nan;0;0
28711;6579;87;67;26;2;24;.923;3600000;0
28711;9413;96;37;26;5;21;.808;3600000;0
28712;4754;96;0;0;0;0;.00nan;0;0
28712;4849;87;0;0;0;0;.00nan;0;0
28712;6579;87;66;27;2;25;.926;3598000;0
28712;9413;96;85;27;1;26;.963;3600000;0
28713;4754;96;0;0;0;0;.00nan;0;0
28713;4849;87;0;0;0;0;.00nan;0;0
28713;6579;87;86;34;3;31;.912;3629000;0
28713;9413;96;92;41;2;39;.951;3629000;0
28714;4754;96;0;0;0;0;.00nan;0;0
28714;4849;87;0;0;0;0;.00nan;0;0
28714;6579;87;100;40;0;40;1.000;3600000;0
28714;9413;96;61;26;3;23;.885;3600000;0
28727;4754;96;0;0;0;0;.00nan;0;0
28727;4849;87;0;0;0;0;.00nan;0;0
28727;6579;87;74;18;1;17;.944;3600000;0
28727;9413;96;94;38;2;36;.947;3600000;0
28728;4754;96;0;0;0;0;.00nan;0;0
28728;4849;87;0;0;0;0;.00nan;0;0
28728;6579;87;25;22;5;17;.773;3600000;0
28728;9413;96;52;16;2;14;.875;3600000;0
28735;4754;96;0;0;0;0;.00nan;0;0
28735;4849;87;0;0;0;0;.00nan;0;0
28735;6579;87;66;27;3;24;.889;3600000;0
28735;9413;96;44;30;4;26;.867;3568000;0
26706;6664;66;0;0;0;0;.00nan;0;0
26706;6825;72;0;0;0;0;.00nan;0;0
26706;9669;72;73;37;2;35;.946;3600000;0
26706;9850;65;83;47;3;44;.936;3582000;0
26707;6720;68;0;0;0;0;.00nan;0;0
26707;6751;67;83;52;4;48;.923;3554000;0
26707;8179;68;67;25;2;23;.920;3600000;0
26707;9579;67;0;0;0;0;.00nan;0;0
26708;4919;70;0;0;0;0;.00nan;0;0
26708;4940;62;0;0;0;0;.00nan;0;0
26708;5257;70;77;60;6;54;.900;3600000;0
26708;7501;62;61;18;2;16;.889;3600000;0
26709;4942;63;68;21;2;19;.905;3600000;0
26709;6077;65;0;0;0;0;.00nan;0;0
26709;8395;65;49;33;4;29;.879;3538000;0
26709;8927;63;0;0;0;0;.00nan;0;0
26710;3837;75;93;50;1;49;.980;3900000;0
26710;5348;75;0;0;0;0;.00nan;0;0
26710;6840;82;0;0;0;0;.00nan;0;0
26710;8403;73;87;37;1;36;.973;3900000;0
26711;5088;78;0;0;0;0;.00nan;0;0
26711;5107;77;63;39;4;35;.897;3575000;0
26711;6865;77;0;0;0;0;.00nan;0;0
26711;6916;78;59;28;3;25;.893;3600000;0
26712;6087;80;73;37;2;35;.946;3600000;0
26712;7575;81;54;22;3;19;.864;3567000;0
26712;8206;81;0;0;0;0;.00nan;0;0
26712;8300;80;0;0;0;0;.00nan;0;0
26713;6664;66;54;31;4;27;.871;3600000;0
26713;6825;72;59;43;5;38;.884;3600000;0
26713;9669;72;0;0;0;0;.00nan;0;0
26713;9850;65;0;0;0;0;.00nan;0;0
26714;4942;63;0;0;0;0;.00nan;0;0
26714;6077;65;79;44;5;39;.886;3600000;0
26714;8395;65;0;0;0;0;.00nan;0;0
26714;8927;63;79;26;1;25;.962;3600000;0
26715;5154;83;68;23;2;21;.913;3600000;0
26715;6087;80;39;1;1;0;.000;264000;0
26715;8300;80;36;41;6;35;.854;3336000;0
26715;8364;83;0;0;0;0;.00nan;0;0
26716;5183;69;0;0;0;0;.00nan;0;0
26716;5372;69;100;31;0;31;1.000;3600000;0
26716;6799;73;58;23;3;20;.870;3600000;0
26716;7484;73;0;0;0;0;.00nan;0;0
26717;4919;70;43;29;5;24;.828;3600000;0
26717;4940;62;72;23;2;21;.913;3600000;0
26717;5257;70;0;0;0;0;.00nan;0;0
26717;7501;62;0;0;0;0;.00nan;0;0
26718;5054;72;66;43;5;38;.884;3600000;0
26718;6945;71;0;0;0;0;.00nan;0;0
26718;8147;72;0;0;0;0;.00nan;0;0
26718;8361;71;99;38;1;37;.974;3600000;0
26719;3837;75;0;0;0;0;.00nan;0;0
26719;5348;75;55;30;4;26;.867;3600000;0
26719;6093;79;15;19;6;13;.684;2076000;0
26719;6735;79;52;4;0;4;1.000;1464000;0
26720;6720;68;70;22;1;21;.955;3600000;0
26720;6751;67;0;0;0;0;.00nan;0;0
26720;8179;68;0;0;0;0;.00nan;0;0
26720;9579;67;60;43;5;38;.884;3600000;0
26721;5088;78;56;23;3;20;.870;3600000;0
26721;5107;77;50;0;0;0;.00nan;22000;0
26721;6865;77;22;30;7;23;.767;3578000;0
26721;6916;78;0;0;0;0;.00nan;0;0
26722;6197;74;87;38;3;35;.921;3035000;0
26722;6840;82;25;36;7;29;.806;3317000;0
26722;7528;74;29;6;3;3;.500;565000;0
26722;8403;73;56;5;0;5;1.000;283000;0
26723;5090;74;0;0;0;0;.00nan;0;0
26723;6701;76;75;29;2;27;.931;3600000;0
26723;7575;81;0;0;0;0;.00nan;0;0
26723;8206;81;45;37;5;32;.865;3600000;0
26724;5183;69;53;43;6;37;.860;3314000;0
26724;5372;69;48;0;0;0;.00nan;286000;0
26724;6799;73;0;0;0;0;.00nan;0;0
26724;7484;73;80;33;2;31;.939;3600000;0
26725;3837;75;97;63;5;58;.921;3521000;0
26725;5154;83;0;0;0;0;.00nan;0;0
26725;5348;75;0;0;0;0;.00nan;0;0
26725;8364;83;56;23;3;20;.870;3600000;0
26726;6077;65;0;0;0;0;.00nan;0;0
26726;6825;72;82;37;2;35;.946;3600000;0
26726;8395;65;70;25;1;24;.960;3600000;0
26726;9850;65;0;0;0;0;.00nan;0;0
26727;5054;72;34;28;6;22;.786;3281000;0
26727;6799;73;19;22;6;16;.727;2198000;0
26727;7484;73;52;19;2;17;.895;1401000;0
26727;8147;72;43;2;1;1;.500;319000;0
26728;5183;69;0;0;0;0;.00nan;0;0
26728;5372;69;76;30;2;28;.933;3600000;0
26728;6751;67;31;30;6;24;.800;3600000;0
26728;9579;67;0;0;0;0;.00nan;0;0
26729;4940;62;0;0;0;0;.00nan;0;0
26729;4942;63;34;18;4;14;.778;702000;0
26729;7501;62;87;32;2;30;.938;3600000;0
26729;8927;63;40;20;4;16;.800;2898000;0
26730;4919;70;0;0;0;0;.00nan;0;0
26730;5257;70;62;34;4;30;.882;3600000;0
26730;6664;66;48;20;3;17;.850;3216000;0
26730;9669;72;23;4;3;1;.250;309000;0
26731;6720;68;0;0;0;0;.00nan;0;0
26731;6945;71;0;0;0;0;.00nan;0;0
26731;8179;68;41;36;6;30;.833;3527000;0
26731;8361;71;44;25;4;21;.840;3600000;0
26732;3837;75;99;44;1;43;.977;3600000;0
26732;5348;75;0;0;0;0;.00nan;0;0
26732;6197;74;0;0;0;0;.00nan;0;0
26732;7528;74;75;34;3;31;.912;3515000;0
26733;5088;78;0;0;0;0;.00nan;0;0
26733;5090;74;0;0;0;0;.00nan;0;0
26733;6701;76;69;27;2;25;.926;3600000;0
26733;6916;78;75;50;5;45;.900;3600000;0
26734;5107;77;63;50;6;44;.880;3600000;0
26734;5154;83;0;0;0;0;.00nan;0;0
26734;6865;77;0;0;0;0;.00nan;0;0
26734;8364;83;76;25;2;23;.920;3600000;0
26735;6087;80;56;26;3;23;.885;3532000;0
26735;6093;79;87;32;1;31;.969;3600000;0
26735;6735;79;0;0;0;0;.00nan;0;0
26735;8300;80;0;0;0;0;.00nan;0;0
26736;6077;65;68;32;3;29;.906;3513000;0
26736;6825;72;0;0;0;0;.00nan;0;0
26736;8395;65;0;0;0;0;.00nan;0;0
26736;9850;65;77;27;1;26;.963;3600000;0
26737;4940;62;94;37;1;36;.973;3600000;0
26737;6664;66;52;32;5;27;.844;3600000;0
26737;7501;62;0;0;0;0;.00nan;0;0
26737;9669;72;0;0;0;0;.00nan;0;0
26738;5054;72;0;0;0;0;.00nan;0;0
26738;5183;69;44;31;5;26;.839;3600000;0
26738;5372;69;0;0;0;0;.00nan;0;0
26738;8147;72;74;30;2;28;.933;3600000;0
26739;6720;68;36;28;5;23;.821;3600000;0
26739;6945;71;23;18;5;13;.722;2175000;0
26739;8179;68;0;0;0;0;.00nan;0;0
26739;8361;71;66;20;1;19;.950;1425000;0
26740;3837;75;0;0;0;0;.00nan;0;0
26740;5107;77;0;0;0;0;.00nan;0;0
26740;5348;75;78;34;2;32;.941;3600000;0
26740;6865;77;87;25;1;24;.960;3600000;0
26741;6197;74;87;52;3;49;.942;3900000;0
26741;7528;74;0;0;0;0;.00nan;0;0
26741;7575;81;0;0;0;0;.00nan;0;0
26741;8206;81;58;21;3;18;.857;3900000;0
26742;6087;80;0;0;0;0;.00nan;0;0
26742;6840;82;56;35;4;31;.886;3600000;0
26742;8300;80;61;42;5;37;.881;3600000;0
26742;8403;73;0;0;0;0;.00nan;0;0
26743;5088;78;41;30;5;25;.833;3537000;0
26743;5090;74;60;29;3;26;.897;3600000;0
26743;6701;76;0;0;0;0;.00nan;0;0
26743;6916;78;0;0;0;0;.00nan;0;0
26744;5054;72;50;35;6;29;.829;3084000;0
26744;6720;68;0;0;0;0;.00nan;0;0
26744;8147;72;40;2;1;1;.500;458000;0
26744;8179;68;37;35;6;29;.829;3600000;0
26745;4942;63;94;22;0;22;1.000;3600000;0
26745;6664;66;0;0;0;0;.00nan;0;0
26745;8927;63;0;0;0;0;.00nan;0;0
26745;9669;72;48;38;5;33;.868;3600000;0
26746;6751;67;64;9;0;9;1.000;561000;0
26746;6799;73;74;25;2;23;.920;3600000;0
26746;7484;73;0;0;0;0;.00nan;0;0
26746;9579;67;41;41;7;34;.829;3039000;0
26747;5107;77;99;39;1;38;.974;3600000;0
26747;6197;74;0;0;0;0;.00nan;0;0
26747;6865;77;0;0;0;0;.00nan;0;0
26747;7528;74;50;26;4;22;.846;3600000;0
26748;4919;70;47;7;1;6;.857;885000;0
26748;5183;69;0;0;0;0;.00nan;0;0
26748;5257;70;17;31;7;24;.774;2715000;0
26748;5372;69;57;35;4;31;.886;3600000;0
26749;4919;70;69;28;2;26;.929;3600000;0
26749;5257;70;0;0;0;0;.00nan;0;0
26749;6751;67;31;20;5;15;.750;2716000;0
26749;9579;67;16;8;4;4;.500;884000;0
26750;6799;73;0;0;0;0;.00nan;0;0
26750;6945;71;39;29;6;23;.793;3600000;0
26750;7484;73;80;31;2;29;.935;3600000;0
26750;8361;71;0;0;0;0;.00nan;0;0
26751;3837;75;93;45;2;43;.956;3600000;0
26751;5348;75;0;0;0;0;.00nan;0;0
26751;6093;79;0;0;0;0;.00nan;0;0
26751;6735;79;46;31;5;26;.839;3600000;0
26752;6087;80;89;37;2;35;.946;3842000;0
26752;6197;74;76;35;3;32;.914;3842000;0
26752;7528;74;0;0;0;0;.00nan;0;0
26752;8300;80;0;0;0;0;.00nan;0;0
26753;5107;77;58;5;0;5;1.000;509000;0
26753;6825;72;78;23;1;22;.957;3600000;0
26753;6865;77;42;46;7;39;.848;3091000;0
26753;9850;65;0;0;0;0;.00nan;0;0
26754;6664;66;0;0;0;0;.00nan;0;0
26754;6799;73;0;0;0;0;.00nan;0;0
26754;7484;73;41;30;5;25;.833;3542000;0
26754;9669;72;73;38;4;34;.895;3600000;0
26755;5154;83;23;26;6;20;.769;2861000;0
26755;6751;67;66;28;2;26;.929;3600000;0
26755;8364;83;41;8;2;6;.750;739000;0
26755;9579;67;0;0;0;0;.00nan;0;0
26756;4919;70;0;0;0;0;.00nan;0;0
26756;4940;62;73;42;4;38;.905;3513000;0
26756;5257;70;63;21;2;19;.905;3600000;0
26756;7501;62;0;0;0;0;.00nan;0;0
26757;4942;63;55;17;2;15;.882;3600000;0
26757;6720;68;0;0;0;0;.00nan;0;0
26757;8179;68;67;31;3;28;.903;3600000;0
26757;8927;63;0;0;0;0;.00nan;0;0
26758;5183;69;43;3;1;2;.667;561000;0
26758;5372;69;27;29;6;23;.793;3039000;0
26758;6945;71;0;0;0;0;.00nan;0;0
26758;8361;71;78;47;5;42;.894;3600000;0
26759;5088;78;85;47;3;44;.936;3900000;0
26759;6197;74;55;19;3;16;.842;3900000;0
26759;6916;78;0;0;0;0;.00nan;0;0
26759;7528;74;0;0;0;0;.00nan;0;0
26760;6093;79;67;26;2;24;.923;3569000;0
26760;6735;79;0;0;0;0;.00nan;0;0
26760;6840;82;0;0;0;0;.00nan;0;0
26760;8403;73;85;32;1;31;.969;3600000;0
26761;6799;73;6;19;7;12;.632;3600000;0
26761;6825;72;0;0;0;0;.00nan;0;0
26761;7484;73;0;0;0;0;.00nan;0;0
26761;9850;65;57;37;4;33;.892;3600000;0
26762;5107;77;53;34;4;30;.882;3538000;0
26762;6664;66;61;23;2;21;.913;3600000;0
26762;6865;77;0;0;0;0;.00nan;0;0
26762;9669;72;0;0;0;0;.00nan;0;0
26763;4940;62;0;0;0;0;.00nan;0;0
26763;4942;63;0;0;0;0;.00nan;0;0
26763;7501;62;73;24;2;22;.917;3600000;0
26763;8927;63;83;37;3;34;.919;3576000;0
26764;5090;74;0;0;0;0;.00nan;0;0
26764;6093;79;0;0;0;0;.00nan;0;0
26764;6701;76;46;30;5;25;.833;3527000;0
26764;6735;79;59;28;3;25;.893;3600000;0
26765;5183;69;75;31;3;28;.903;3600000;0
26765;5372;69;0;0;0;0;.00nan;0;0
26765;6720;68;44;29;5;24;.828;3567000;0
26765;8179;68;0;0;0;0;.00nan;0;0
26766;3837;75;94;45;3;42;.933;3552000;0
26766;5348;75;0;0;0;0;.00nan;0;0
26766;7575;81;63;22;2;20;.909;3600000;0
26766;8206;81;0;0;0;0;.00nan;0;0
26767;5088;78;49;1;0;1;1.000;142000;0
26767;6197;74;0;0;0;0;.00nan;0;0
26767;6916;78;56;30;4;26;.867;3428000;0
26767;7528;74;92;41;2;39;.951;3600000;0
26768;6087;80;0;0;0;0;.00nan;0;0
26768;6840;82;66;36;3;33;.917;3600000;0
26768;8300;80;61;38;4;34;.895;3543000;0
26768;8403;73;0;0;0;0;.00nan;0;0
26769;5054;72;69;44;4;40;.909;3551000;0
26769;5154;83;61;27;3;24;.889;3600000;0
26769;8147;72;0;0;0;0;.00nan;0;0
26769;8364;83;0;0;0;0;.00nan;0;0
26770;4942;63;46;29;5;24;.828;3600000;0
26770;6077;65;49;44;6;38;.864;3581000;0
26770;8395;65;0;0;0;0;.00nan;0;0
26770;8927;63;0;0;0;0;.00nan;0;0
26771;4919;70;0;0;0;0;.00nan;0;0
26771;5257;70;78;25;1;24;.960;3600000;0
26771;6825;72;81;30;2;28;.933;3559000;0
26771;9850;65;0;0;0;0;.00nan;0;0
26772;6840;82;0;0;0;0;.00nan;0;0
26772;7575;81;0;0;0;0;.00nan;0;0
26772;8206;81;48;30;4;26;.867;3591000;0
26772;8403;73;66;31;3;28;.903;3600000;0
26773;5154;83;92;48;3;45;.938;3585000;0
26773;6720;68;57;22;2;20;.909;3600000;0
26773;8179;68;0;0;0;0;.00nan;0;0
26773;8364;83;0;0;0;0;.00nan;0;0
26774;4940;62;64;20;2;18;.900;3600000;0
26774;5107;77;43;4;1;3;.750;353000;0
26774;6865;77;57;50;6;44;.880;3247000;0
26774;7501;62;0;0;0;0;.00nan;0;0
26775;4942;63;0;0;0;0;.00nan;0;0
26775;6799;73;45;23;4;19;.826;2206000;0
26775;7484;73;46;6;1;5;.833;1335000;0
26775;8927;63;60;25;3;22;.880;3600000;0
26776;6077;65;0;0;0;0;.00nan;0;0
26776;6799;73;0;0;0;0;.00nan;0;0
26776;7484;73;52;27;4;23;.852;3595000;0
26776;8395;65;79;43;3;40;.930;3600000;0
26777;4919;70;73;11;0;11;1.000;3600000;0
26777;5107;77;28;28;6;22;.786;2835000;0
26777;5257;70;0;0;0;0;.00nan;0;0
26777;6865;77;56;6;0;6;1.000;765000;0
26778;5154;83;76;36;3;33;.917;2661000;0
26778;6945;71;0;0;0;0;.00nan;0;0
26778;8361;71;88;29;1;28;.966;3600000;0
26778;8364;83;19;17;5;12;.706;939000;0
26779;5090;74;0;0;0;0;.00nan;0;0
26779;6701;76;78;34;2;32;.941;3900000;0
26779;7575;81;0;0;0;0;.00nan;0;0
26779;8206;81;78;29;2;27;.931;3900000;0
26780;4919;70;81;34;2;32;.941;3600000;0
26780;5257;70;0;0;0;0;.00nan;0;0
26780;6825;72;46;27;4;23;.852;3571000;0
26780;9850;65;0;0;0;0;.00nan;0;0
26781;5107;77;0;0;0;0;.00nan;0;0
26781;6077;65;96;27;0;27;1.000;3600000;0
26781;6865;77;65;52;6;46;.885;3600000;0
26781;8395;65;0;0;0;0;.00nan;0;0
26782;4940;62;43;25;4;21;.840;3884000;0
26782;6751;67;68;29;4;25;.862;3900000;0
26782;7501;62;0;0;0;0;.00nan;0;0
26782;9579;67;0;0;0;0;.00nan;0;0
26783;5154;83;100;29;0;29;1.000;3600000;0
26783;5183;69;0;0;0;0;.00nan;0;0
26783;5372;69;55;24;3;21;.875;3600000;0
26783;8364;83;0;0;0;0;.00nan;0;0
26784;6664;66;0;0;0;0;.00nan;0;0
26784;6720;68;0;0;0;0;.00nan;0;0
26784;8179;68;94;38;2;36;.947;3900000;0
26784;9669;72;88;38;2;36;.947;3900000;0
26785;5088;78;90;59;5;54;.915;3549000;0
26785;6840;82;45;25;4;21;.840;3600000;0
26785;6916;78;0;0;0;0;.00nan;0;0
26785;8403;73;0;0;0;0;.00nan;0;0
26786;5090;74;0;0;0;0;.00nan;0;0
26786;6087;80;64;26;2;24;.923;3600000;0
26786;6701;76;61;42;4;38;.905;3598000;0
26786;8300;80;0;0;0;0;.00nan;0;0
26787;6093;79;36;7;2;5;.714;432000;0
26787;6197;74;66;29;3;26;.897;3600000;0
26787;6735;79;31;28;6;22;.786;3168000;0
26787;7528;74;0;0;0;0;.00nan;0;0
26788;3837;75;19;22;6;16;.727;2203000;0
26788;5348;75;66;20;1;19;.950;1397000;0
26788;7575;81;75;28;2;26;.929;3600000;0
26788;8206;81;0;0;0;0;.00nan;0;0
26789;4940;62;0;0;0;0;.00nan;0;0
26789;6077;65;56;22;3;19;.864;3833000;0
26789;7501;62;74;30;2;28;.933;3833000;0
26789;8395;65;0;0;0;0;.00nan;0;0
26790;4942;63;60;21;2;19;.905;3600000;0
26790;5107;77;39;40;6;34;.850;3052000;0
26790;6865;77;53;12;1;11;.917;548000;0
26790;8927;63;0;0;0;0;.00nan;0;0
26791;4919;70;0;0;0;0;.00nan;0;0
26791;5257;70;57;28;3;25;.893;3600000;0
26791;6751;67;0;0;0;0;.00nan;0;0
26791;9579;67;100;41;1;40;.976;3600000;0
26792;6664;66;86;27;2;25;.926;3600000;0
26792;6945;71;40;35;6;29;.829;3208000;0
26792;8361;71;40;2;1;1;.500;392000;0
26792;9669;72;0;0;0;0;.00nan;0;0
26793;5054;72;61;51;6;45;.882;3600000;0
26793;6799;73;55;19;3;16;.842;3600000;0
26793;7484;73;0;0;0;0;.00nan;0;0
26793;8147;72;0;0;0;0;.00nan;0;0
26794;5183;69;80;31;2;29;.935;3785000;0
26794;5372;69;0;0;0;0;.00nan;0;0
26794;6720;68;44;17;3;14;.824;3785000;0
26794;8179;68;0;0;0;0;.00nan;0;0
26795;3837;75;55;29;4;25;.862;3566000;0
26795;5348;75;0;0;0;0;.00nan;0;0
26795;6197;74;0;0;0;0;.00nan;0;0
26795;7528;74;61;25;3;22;.880;3600000;0
26796;5090;74;62;33;3;30;.909;3600000;0
26796;6701;76;0;0;0;0;.00nan;0;0
26796;6840;82;0;0;0;0;.00nan;0;0
26796;8403;73;32;31;6;25;.806;3600000;0
26797;5088;78;0;0;0;0;.00nan;0;0
26797;6087;80;0;0;0;0;.00nan;0;0
26797;6916;78;44;27;4;23;.852;3600000;0
26797;8300;80;72;21;1;20;.952;3600000;0
26798;6093;79;19;26;7;19;.731;1684000;0
26798;6735;79;72;20;1;19;.950;1916000;0
26798;7575;81;0;0;0;0;.00nan;0;0
26798;8206;81;55;22;3;19;.864;3600000;0
26799;4942;63;0;0;0;0;.00nan;0;0
26799;6751;67;45;40;6;34;.850;2463000;0
26799;8927;63;54;20;2;18;.900;3600000;0
26799;9579;67;60;13;1;12;.923;1137000;0
26800;5154;83;16;22;6;16;.727;1942000;0
26800;6799;73;0;0;0;0;.00nan;0;0
26800;7484;73;46;24;4;20;.833;3600000;0
26800;8364;83;63;17;1;16;.941;1658000;0
26801;4919;70;66;32;4;28;.875;3600000;0
26801;5054;72;38;35;5;30;.857;3553000;0
26801;5257;70;0;0;0;0;.00nan;0;0
26801;8147;72;0;0;0;0;.00nan;0;0
26802;4919;70;50;13;2;11;.846;1141000;0
26802;5257;70;50;30;4;26;.867;2398000;0
26802;6720;68;0;0;0;0;.00nan;0;0
26802;8179;68;43;26;4;22;.846;3600000;0
26803;6077;65;28;42;8;34;.810;3600000;0
26803;6751;67;100;30;0;30;1.000;3600000;0
26803;8395;65;0;0;0;0;.00nan;0;0
26803;9579;67;0;0;0;0;.00nan;0;0
26804;3837;75;0;0;0;0;.00nan;0;0
26804;5348;75;75;38;3;35;.921;3600000;0
26804;6945;71;0;0;0;0;.00nan;0;0
26804;8361;71;100;32;0;32;1.000;3600000;0
26805;6197;74;64;27;2;25;.926;3600000;0
26805;6945;71;0;0;0;0;.00nan;0;0
26805;7528;74;0;0;0;0;.00nan;0;0
26805;8361;71;89;54;3;51;.944;3600000;0
26806;6825;72;0;0;0;0;.00nan;0;0
26806;7575;81;96;40;2;38;.950;3600000;0
26806;8206;81;0;0;0;0;.00nan;0;0
26806;9850;65;43;18;3;15;.833;3574000;0
26807;5054;72;0;0;0;0;.00nan;0;0
26807;6077;65;57;31;3;28;.903;3568000;0
26807;8147;72;68;27;2;25;.926;3600000;0
26807;8395;65;0;0;0;0;.00nan;0;0
26808;4942;63;48;26;4;22;.846;3600000;0
26808;6751;67;46;38;6;32;.842;2970000;0
26808;8927;63;0;0;0;0;.00nan;0;0
26808;9579;67;53;5;0;5;1.000;567000;0
26809;5183;69;0;0;0;0;.00nan;0;0
26809;5372;69;40;31;5;26;.839;3600000;0
26809;6799;73;54;15;2;13;.867;3600000;0
26809;7484;73;0;0;0;0;.00nan;0;0
26810;3837;75;75;23;1;22;.957;3600000;0
26810;5107;77;0;0;0;0;.00nan;0;0
26810;5348;75;0;0;0;0;.00nan;0;0
26810;6865;77;61;26;3;23;.885;3557000;0
26811;5088;78;74;31;3;28;.903;3573000;0
26811;6840;82;87;40;2;38;.950;3600000;0
26811;6916;78;0;0;0;0;.00nan;0;0
26811;8403;73;0;0;0;0;.00nan;0;0
26812;5090;74;0;0;0;0;.00nan;0;0
26812;6701;76;65;23;2;21;.913;3600000;0
26812;6945;71;77;52;5;47;.904;3600000;0
26812;8361;71;0;0;0;0;.00nan;0;0
26813;6093;79;68;31;3;28;.903;3600000;0
26813;6735;79;0;0;0;0;.00nan;0;0
26813;6825;72;56;36;5;31;.861;3528000;0
26813;9850;65;0;0;0;0;.00nan;0;0
26814;6087;80;0;0;0;0;.00nan;0;0
26814;7575;81;0;0;0;0;.00nan;0;0
26814;8206;81;100;37;0;37;1.000;3600000;0
26814;8300;80;65;31;3;28;.903;3600000;0
26815;4919;70;0;0;0;0;.00nan;0;0
26815;5257;70;65;34;4;30;.882;3548000;0
26815;6664;66;57;28;3;25;.893;3600000;0
26815;9669;72;0;0;0;0;.00nan;0;0
26816;6077;65;0;0;0;0;.00nan;0;0
26816;6751;67;0;0;0;0;.00nan;0;0
26816;8395;65;91;41;2;39;.951;3533000;0
26816;9579;67;85;21;0;21;1.000;3600000;0
26817;5154;83;77;38;3;35;.921;3867000;0
26817;6825;72;0;0;0;0;.00nan;0;0
26817;8364;83;0;0;0;0;.00nan;0;0
26817;9850;65;74;37;3;34;.919;3900000;0
26818;4942;63;0;0;0;0;.00nan;0;0
26818;5183;69;49;32;5;27;.844;3575000;0
26818;5372;69;0;0;0;0;.00nan;0;0
26818;8927;63;59;26;3;23;.885;3600000;0
26819;3837;75;0;0;0;0;.00nan;0;0
26819;5348;75;55;43;6;37;.860;3600000;0
26819;6197;74;61;19;2;17;.895;3600000;0
26819;7528;74;0;0;0;0;.00nan;0;0
26820;5088;78;32;5;2;3;.600;483000;0
26820;6840;82;0;0;0;0;.00nan;0;0
26820;6916;78;40;35;6;29;.829;3117000;0
26820;8403;73;44;27;4;23;.852;3600000;0
26821;5107;77;89;18;0;18;1.000;3600000;0
26821;6865;77;0;0;0;0;.00nan;0;0
26821;6945;71;0;0;0;0;.00nan;0;0
26821;8361;71;48;25;4;21;.840;3600000;0
26822;6087;80;56;37;6;31;.838;3600000;0
26822;6093;79;0;0;0;0;.00nan;0;0
26822;6735;79;82;28;1;27;.964;3600000;0
26822;8300;80;0;0;0;0;.00nan;0;0
26823;4940;62;90;55;2;53;.964;3600000;0
26823;7501;62;0;0;0;0;.00nan;0;0
26823;7575;81;0;0;0;0;.00nan;0;0
26823;8206;81;65;33;3;30;.909;3600000;0
26824;5054;72;80;43;3;40;.930;3600000;0
26824;6720;68;0;0;0;0;.00nan;0;0
26824;8147;72;0;0;0;0;.00nan;0;0
26824;8179;68;34;19;4;15;.789;3544000;0
26825;5090;74;67;9;0;9;1.000;1576000;0
26825;5107;77;50;31;5;26;.839;3600000;0
26825;6701;76;21;20;6;14;.700;2024000;0
26825;6865;77;0;0;0;0;.00nan;0;0
26826;4919;70;66;28;3;25;.893;3900000;0
26826;5257;70;0;0;0;0;.00nan;0;0
26826;6664;66;0;0;0;0;.00nan;0;0
26826;9669;72;65;31;3;28;.903;3900000;0
26827;5183;69;0;0;0;0;.00nan;0;0
26827;5372;69;49;35;5;30;.857;3600000;0
26827;6751;67;0;0;0;0;.00nan;0;0
26827;9579;67;77;31;2;29;.935;3600000;0
26828;5088;78;47;25;4;21;.840;3900000;0
26828;6916;78;0;0;0;0;.00nan;0;0
26828;6945;71;68;40;4;36;.900;3900000;0
26828;8361;71;0;0;0;0;.00nan;0;0
26829;4940;62;40;17;3;14;.824;3600000;0
26829;6093;79;0;0;0;0;.00nan;0;0
26829;6735;79;63;44;6;38;.864;3600000;0
26829;7501;62;0;0;0;0;.00nan;0;0
26830;6087;80;0;0;0;0;.00nan;0;0
26830;6825;72;80;43;3;40;.930;3563000;0
26830;8300;80;72;19;1;18;.947;3600000;0
26830;9850;65;0;0;0;0;.00nan;0;0
26831;4940;62;0;0;0;0;.00nan;0;0
26831;5154;83;59;8;0;8;1.000;883000;0
26831;7501;62;91;16;0;16;1.000;3600000;0
26831;8364;83;41;35;6;29;.829;2717000;0
26832;5088;78;53;3;0;3;1.000;432000;0
26832;6197;74;87;15;0;15;1.000;3600000;0
26832;6916;78;64;52;6;46;.885;3168000;0
26832;7528;74;0;0;0;0;.00nan;0;0
26833;6825;72;0;0;0;0;.00nan;0;0
26833;6840;82;68;28;2;26;.929;3900000;0
26833;8403;73;0;0;0;0;.00nan;0;0
26833;9850;65;85;42;2;40;.952;3870000;0
26834;6751;67;71;30;3;27;.900;3600000;0
26834;6825;72;98;38;0;38;1.000;2696000;0
26834;9579;67;0;0;0;0;.00nan;0;0
26834;9850;65;31;17;4;13;.765;870000;0
26835;5054;72;0;0;0;0;.00nan;0;0
26835;6077;65;59;25;3;22;.880;3673000;0
26835;8395;65;0;0;0;0;.00nan;0;0
26835;9669;72;75;36;4;32;.889;3673000;0
26836;5183;69;0;0;0;0;.00nan;0;0
26836;5372;69;80;27;1;26;.963;3600000;0
26836;6093;79;72;40;4;36;.900;3600000;0
26836;6735;79;0;0;0;0;.00nan;0;0
26837;4919;70;54;28;4;24;.857;3571000;0
26837;5257;70;0;0;0;0;.00nan;0;0
26837;6664;66;79;32;2;30;.938;3600000;0
26837;9775;64;0;0;0;0;.00nan;0;0
26838;6720;68;76;47;4;43;.915;3600000;0
26838;6799;73;100;19;0;19;1.000;3600000;0
26838;7484;73;0;0;0;0;.00nan;0;0
26838;8179;68;0;0;0;0;.00nan;0;0
26839;5154;83;50;15;2;13;.867;1401000;0
26839;6840;82;0;0;0;0;.00nan;0;0
26839;8364;83;21;25;6;19;.760;2199000;0
26839;8403;73;57;32;4;28;.875;3600000;0
26840;4940;62;0;0;0;0;.00nan;0;0
26840;6087;80;24;12;4;8;.667;917000;0
26840;7501;62;60;31;4;27;.871;3600000;0
26840;8300;80;76;37;2;35;.946;2683000;0
26841;3837;75;81;35;2;33;.943;3600000;0
26841;5090;74;0;0;0;0;.00nan;0;0
26841;5348;75;0;0;0;0;.00nan;0;0
26841;6701;76;37;35;6;29;.829;3600000;0
26842;5107;77;0;0;0;0;.00nan;0;0
26842;6865;77;59;33;4;29;.879;3900000;0
26842;7575;81;0;0;0;0;.00nan;0;0
26842;8206;81;53;30;4;26;.867;3900000;0
26843;6720;68;0;0;0;0;.00nan;0;0
26843;6751;67;0;0;0;0;.00nan;0;0
26843;8179;68;61;39;5;34;.872;3600000;0
26843;9579;67;99;25;0;25;1.000;3600000;0
26844;6825;72;0;0;0;0;.00nan;0;0
26844;6945;71;0;0;0;0;.00nan;0;0
26844;8361;71;70;22;1;21;.955;3600000;0
26844;9850;65;54;35;5;30;.857;3600000;0
26845;6093;79;21;45;9;36;.800;3352000;0
26845;6735;79;25;7;3;4;.571;248000;0
26845;6799;73;55;15;2;13;.867;3600000;0
26845;7484;73;0;0;0;0;.00nan;0;0
26846;4940;62;60;34;4;30;.882;3600000;0
26846;6840;82;64;45;5;40;.889;3566000;0
26846;7501;62;0;0;0;0;.00nan;0;0
26846;8403;73;0;0;0;0;.00nan;0;0
26847;5088;78;59;35;4;31;.886;3600000;0
26847;6087;80;17;23;6;17;.739;2754000;0
26847;6916;78;0;0;0;0;.00nan;0;0
26847;8300;80;47;7;1;6;.857;846000;0
26848;3837;75;0;0;0;0;.00nan;0;0
26848;5090;74;24;19;5;14;.737;2304000;0
26848;5348;75;84;34;2;32;.941;3600000;0
26848;6701;76;59;10;0;10;1.000;1296000;0
26849;4942;63;46;14;2;12;.857;3600000;0
26849;5054;72;47;43;6;37;.860;3600000;0
26849;8927;63;0;0;0;0;.00nan;0;0
26849;9669;72;0;0;0;0;.00nan;0;0
26850;4919;70;0;0;0;0;.00nan;0;0
26850;5257;70;77;34;2;32;.941;3541000;0
26850;6077;65;86;26;1;25;.962;3600000;0
26850;8395;65;0;0;0;0;.00nan;0;0
26851;5088;78;0;0;0;0;.00nan;0;0
26851;5107;77;56;19;2;17;.895;3600000;0
26851;6865;77;0;0;0;0;.00nan;0;0
26851;6916;78;79;39;3;36;.923;3569000;0
26852;5054;72;0;0;0;0;.00nan;0;0
26852;6093;79;28;26;5;21;.808;3023000;0
26852;6735;79;43;5;1;4;.800;555000;0
26852;9669;72;68;33;4;29;.879;3600000;0
26853;5090;74;60;10;0;10;1.000;780000;0
26853;6197;74;40;18;4;14;.778;3600000;0
26853;6701;76;41;39;6;33;.846;2820000;0
26853;7528;74;0;0;0;0;.00nan;0;0
26854;6664;66;38;29;5;24;.828;3569000;0
26854;6751;67;0;0;0;0;.00nan;0;0
26854;9579;67;81;44;3;41;.932;3600000;0
26854;9775;64;0;0;0;0;.00nan;0;0
26855;6197;74;0;0;0;0;.00nan;0;0
26855;6701;76;0;0;0;0;.00nan;0;0
26855;7528;74;49;21;3;18;.857;3583000;0
26855;9564;76;79;32;2;30;.938;3600000;0
26856;6825;72;37;25;5;20;.800;3545000;0
26856;6945;71;0;0;0;0;.00nan;0;0
26856;8361;71;70;40;4;36;.900;3600000;0
26856;9850;65;0;0;0;0;.00nan;0;0
26857;6664;66;0;0;0;0;.00nan;0;0
26857;6751;67;43;28;5;23;.821;3583000;0
26857;9579;67;0;0;0;0;.00nan;0;0
26857;9775;64;66;36;3;33;.917;3600000;0
26858;5183;69;32;33;6;27;.818;2970000;0
26858;5372;69;55;5;0;5;1.000;597000;0
26858;6077;65;58;39;4;35;.897;3600000;0
26858;8395;65;0;0;0;0;.00nan;0;0
26859;4940;62;83;48;3;45;.938;3600000;0
26859;4942;63;41;9;2;7;.778;1328000;0
26859;7501;62;0;0;0;0;.00nan;0;0
26859;8927;63;44;18;3;15;.833;2231000;0
26860;4919;70;0;0;0;0;.00nan;0;0
26860;5257;70;78;52;5;47;.904;3600000;0
26860;6799;73;71;22;2;20;.909;3600000;0
26860;7484;73;0;0;0;0;.00nan;0;0
26861;5088;78;78;38;2;36;.947;3600000;0
26861;6197;74;73;19;1;18;.947;3600000;0
26861;6916;78;0;0;0;0;.00nan;0;0
26861;7528;74;0;0;0;0;.00nan;0;0
26862;6087;80;62;16;1;15;.938;3600000;0
26862;6093;79;44;34;5;29;.853;3600000;0
26862;6735;79;0;0;0;0;.00nan;0;0
26862;8300;80;0;0;0;0;.00nan;0;0
26863;5154;83;50;32;5;27;.844;2303000;0
26863;7575;81;71;33;2;31;.939;3600000;0
26863;8206;81;0;0;0;0;.00nan;0;0
26863;8364;83;61;18;1;17;.944;1297000;0
26864;6751;67;0;0;0;0;.00nan;0;0
26864;6825;72;0;0;0;0;.00nan;0;0
26864;9579;67;72;30;2;28;.933;3513000;0
26864;9850;65;100;35;0;35;1.000;3600000;0
26865;6664;66;45;26;4;22;.846;3600000;0
26865;6945;71;36;32;6;26;.813;3566000;0
26865;8361;71;0;0;0;0;.00nan;0;0
26865;9775;64;0;0;0;0;.00nan;0;0
26866;4919;70;55;28;4;24;.857;3600000;0
26866;5054;72;69;26;2;24;.923;3042000;0
26866;5257;70;0;0;0;0;.00nan;0;0
26866;9669;72;25;7;3;4;.571;502000;0
26867;4940;62;0;0;0;0;.00nan;0;0
26867;6077;65;0;0;0;0;.00nan;0;0
26867;7501;62;63;35;4;31;.886;3521000;0
26867;8395;65;59;22;2;20;.909;3600000;0
26868;5154;83;11;39;8;31;.795;3600000;0
26868;6093;79;78;30;2;28;.933;3087000;0
26868;6735;79;27;7;3;4;.571;513000;0
26868;8364;83;0;0;0;0;.00nan;0;0
26869;5088;78;0;0;0;0;.00nan;0;0
26869;6840;82;85;30;1;29;.967;3900000;0
26869;6916;78;75;27;1;26;.963;3900000;0
26869;8403;73;0;0;0;0;.00nan;0;0
26870;5107;77;83;28;1;27;.964;3900000;0
26870;6087;80;0;0;0;0;.00nan;0;0
26870;6865;77;0;0;0;0;.00nan;0;0
26870;8300;80;78;31;1;30;.968;3900000;0
26871;3837;75;28;8;3;5;.625;471000;0
26871;5348;75;59;24;2;22;.917;3129000;0
26871;7575;81;0;0;0;0;.00nan;0;0
26871;8206;81;72;29;3;26;.897;3600000;0
26872;6701;76;66;40;4;36;.900;3600000;0
26872;6720;68;79;20;1;19;.950;3600000;0
26872;8179;68;0;0;0;0;.00nan;0;0
26872;9564;76;0;0;0;0;.00nan;0;0
26873;5054;72;53;3;0;3;1.000;692000;0
26873;6799;73;0;0;0;0;.00nan;0;0
26873;7484;73;72;21;1;20;.952;3600000;0
26873;9669;72;52;45;6;39;.867;2908000;0
26874;5183;69;0;0;0;0;.00nan;0;0
26874;5372;69;100;35;0;35;1.000;3600000;0
26874;8927;63;48;0;0;0;.00nan;181000;0
26874;9673;63;21;29;6;23;.793;3419000;0
26875;5107;77;72;41;4;37;.902;3120000;0
26875;6720;68;0;0;0;0;.00nan;0;0
26875;6865;77;31;9;3;6;.667;480000;0
26875;8179;68;53;22;2;20;.909;3600000;0
26876;3837;75;77;34;3;31;.912;3600000;0
26876;5154;83;57;14;1;13;.929;1729000;0
26876;5348;75;0;0;0;0;.00nan;0;0
26876;8364;83;20;18;6;12;.667;1871000;0
26877;6840;82;18;15;5;10;.667;1605000;0
26877;7575;81;47;31;4;27;.871;3600000;0
26877;8206;81;0;0;0;0;.00nan;0;0
26877;8403;73;35;28;5;23;.821;1995000;0
26878;5183;69;0;0;0;0;.00nan;0;0
26878;5372;69;84;39;2;37;.949;3552000;0
26878;6825;72;0;0;0;0;.00nan;0;0
26878;9850;65;68;22;1;21;.955;3600000;0
26879;4940;62;73;43;4;39;.907;3600000;0
26879;6799;73;30;24;5;19;.792;3558000;0
26879;7484;73;0;0;0;0;.00nan;0;0
26879;7501;62;0;0;0;0;.00nan;0;0
26880;5183;69;47;29;4;25;.862;3324000;0
26880;5372;69;57;6;0;6;1.000;576000;0
26880;6664;66;52;36;4;32;.889;3900000;0
26880;9775;64;0;0;0;0;.00nan;0;0
26881;4940;62;0;0;0;0;.00nan;0;0
26881;5054;72;97;54;2;52;.963;3543000;0
26881;7501;62;100;20;0;20;1.000;3600000;0
26881;9669;72;0;0;0;0;.00nan;0;0
26882;6751;67;49;12;2;10;.833;3600000;0
26882;6945;71;0;0;0;0;.00nan;0;0
26882;8361;71;60;42;5;37;.881;3600000;0
26882;9579;67;0;0;0;0;.00nan;0;0
26883;5088;78;83;27;2;25;.926;3900000;0
26883;6720;68;73;30;2;28;.933;3900000;0
26883;6916;78;0;0;0;0;.00nan;0;0
26883;8179;68;0;0;0;0;.00nan;0;0
26884;5090;74;18;20;6;14;.700;1218000;0
26884;6197;74;0;0;0;0;.00nan;0;0
26884;6701;76;35;29;6;23;.793;2382000;0
26884;7528;74;63;22;2;20;.909;3600000;0
26885;6077;65;29;16;4;12;.750;1959000;0
26885;6664;66;0;0;0;0;.00nan;0;0
26885;8395;65;18;22;6;16;.727;1641000;0
26885;9775;64;84;27;3;24;.889;3600000;0
26886;4940;62;53;16;2;14;.875;1567000;0
26886;6825;72;56;47;6;41;.872;3028000;0
26886;7501;62;9;18;6;12;.667;1986000;0
26886;9850;65;52;2;0;2;1.000;572000;0
26887;6945;71;0;0;0;0;.00nan;0;0
26887;8361;71;49;41;5;36;.878;3600000;0
26887;8927;63;0;0;0;0;.00nan;0;0
26887;9673;63;61;16;1;15;.938;3600000;0
26888;4919;70;0;0;0;0;.00nan;0;0
26888;5183;69;85;38;3;35;.921;3600000;0
26888;5257;70;28;19;4;15;.789;3544000;0
26888;5372;69;0;0;0;0;.00nan;0;0
26889;5054;72;0;0;0;0;.00nan;0;0
26889;6087;80;65;33;3;30;.909;3600000;0
26889;8300;80;0;0;0;0;.00nan;0;0
26889;9669;72;100;36;0;36;1.000;3600000;0
26890;6751;67;47;28;4;24;.857;3541000;0
26890;6799;73;0;0;0;0;.00nan;0;0
26890;7484;73;85;35;2;33;.943;3600000;0
26890;9579;67;0;0;0;0;.00nan;0;0
26891;5088;78;45;47;7;40;.851;3702000;0
26891;5090;74;0;0;0;0;.00nan;0;0
26891;6701;76;35;30;6;24;.800;3712000;0
26891;6916;78;0;0;0;0;.00nan;0;0
26892;6197;74;0;0;0;0;.00nan;0;0
26892;6720;68;0;0;0;0;.00nan;0;0
26892;7528;74;68;32;3;29;.906;3600000;0
26892;8179;68;89;25;0;25;1.000;3600000;0
26893;6840;82;0;0;0;0;.00nan;0;0
26893;7575;81;0;0;0;0;.00nan;0;0
26893;8206;81;68;42;4;38;.905;3600000;0
26893;8403;73;84;31;1;30;.968;3600000;0
26894;5107;77;72;30;3;27;.900;3600000;0
26894;5154;83;25;22;5;17;.773;3561000;0
26894;6865;77;0;0;0;0;.00nan;0;0
26894;8364;83;0;0;0;0;.00nan;0;0
26895;3837;75;53;3;0;3;1.000;223000;0
26895;5348;75;41;39;6;33;.846;3377000;0
26895;6093;79;0;0;0;0;.00nan;0;0
26895;6735;79;53;13;2;11;.846;3600000;0
26896;6077;65;0;0;0;0;.00nan;0;0
26896;6945;71;35;29;6;23;.793;3281000;0
26896;8361;71;58;8;0;8;1.000;319000;0
26896;8395;65;69;28;2;26;.929;3600000;0
26897;4940;62;78;12;0;12;1.000;3600000;0
26897;5183;69;0;0;0;0;.00nan;0;0
26897;5372;69;70;47;5;42;.894;3600000;0
26897;7501;62;0;0;0;0;.00nan;0;0
26898;4919;70;61;29;3;26;.897;3600000;0
26898;5257;70;0;0;0;0;.00nan;0;0
26898;6825;72;50;27;4;23;.852;3544000;0
26898;9850;65;0;0;0;0;.00nan;0;0
26899;6664;66;45;41;6;35;.854;3368000;0
26899;8927;63;82;42;4;38;.905;3600000;0
26899;9673;63;0;0;0;0;.00nan;0;0
26899;9775;64;49;2;0;2;1.000;149000;0
26900;6087;80;0;0;0;0;.00nan;0;0
26900;6751;67;0;0;0;0;.00nan;0;0
26900;8300;80;38;17;3;14;.824;3585000;0
26900;9579;67;76;35;2;33;.943;3600000;0
26901;5107;77;41;13;2;11;.846;1346000;0
26901;5154;83;0;0;0;0;.00nan;0;0
26901;6865;77;16;23;6;17;.739;2254000;0
26901;8364;83;69;34;3;31;.912;3600000;0
26902;5054;72;65;17;1;16;.941;1346000;0
26902;6799;73;46;21;3;18;.857;3600000;0
26902;7484;73;0;0;0;0;.00nan;0;0
26902;9669;72;35;38;6;32;.842;2254000;0
26903;6093;79;72;49;5;44;.898;3600000;0
26903;6735;79;0;0;0;0;.00nan;0;0
26903;7575;81;33;38;7;31;.816;3517000;0
26903;8206;81;50;0;0;0;.00nan;8000;0
26904;3837;75;83;43;3;40;.930;3900000;0
26904;5348;75;0;0;0;0;.00nan;0;0
26904;6720;68;0;0;0;0;.00nan;0;0
26904;8179;68;77;44;3;41;.932;3900000;0
26905;5088;78;50;1;0;1;1.000;627000;0
26905;5090;74;0;0;0;0;.00nan;0;0
26905;6701;76;77;28;2;26;.929;3600000;0
26905;6916;78;23;23;6;17;.739;2973000;0
26906;6197;74;84;32;2;30;.938;3900000;0
26906;6840;82;86;34;2;32;.941;3900000;0
26906;7528;74;0;0;0;0;.00nan;0;0
26906;8403;73;0;0;0;0;.00nan;0;0
26907;6664;66;60;35;4;31;.886;3900000;0
26907;6825;72;60;33;4;29;.879;3900000;0
26907;9775;64;0;0;0;0;.00nan;0;0
26907;9850;65;0;0;0;0;.00nan;0;0
26908;6087;80;67;33;3;30;.909;3600000;0
26908;6799;73;0;0;0;0;.00nan;0;0
26908;7484;73;97;26;0;26;1.000;3600000;0
26908;8300;80;0;0;0;0;.00nan;0;0
26909;3837;75;92;43;3;40;.930;3014000;0
26909;5348;75;36;16;3;13;.813;586000;0
26909;6197;74;0;0;0;0;.00nan;0;0
26909;7528;74;49;13;2;11;.846;3600000;0
26910;5183;69;0;0;0;0;.00nan;0;0
26910;5372;69;58;23;3;20;.870;3540000;0
26910;6720;68;85;32;2;30;.938;3600000;0
26910;8179;68;0;0;0;0;.00nan;0;0
26911;3837;75;56;39;5;34;.872;3571000;0
26911;5088;78;63;27;3;24;.889;3600000;0
26911;5348;75;0;0;0;0;.00nan;0;0
26911;6916;78;0;0;0;0;.00nan;0;0
26912;5154;83;24;26;6;20;.769;2816000;0
26912;6840;82;0;0;0;0;.00nan;0;0
26912;8364;83;40;2;1;1;.500;784000;0
26912;8403;73;63;27;2;25;.926;3600000;0
26913;5090;74;0;0;0;0;.00nan;0;0
26913;6701;76;58;32;3;29;.906;3552000;0
26913;6751;67;88;34;2;32;.941;3600000;0
26913;9579;67;0;0;0;0;.00nan;0;0
26914;4940;62;55;36;5;31;.861;3600000;0
26914;7501;62;0;0;0;0;.00nan;0;0
26914;8927;63;0;0;0;0;.00nan;0;0
26914;9673;63;91;29;1;28;.966;3600000;0
26915;4919;70;0;0;0;0;.00nan;0;0
26915;5054;72;87;42;3;39;.929;3600000;0
26915;5257;70;53;32;4;28;.875;3598000;0
26915;9669;72;0;0;0;0;.00nan;0;0
26916;6077;65;74;30;3;27;.900;3600000;0
26916;6945;71;53;12;1;11;.917;1041000;0
26916;8361;71;26;24;6;18;.750;2559000;0
26916;8395;65;0;0;0;0;.00nan;0;0
26917;5183;69;65;28;3;25;.893;3678000;0
26917;5372;69;0;0;0;0;.00nan;0;0
26917;6825;72;0;0;0;0;.00nan;0;0
26917;9850;65;62;39;4;35;.897;3678000;0
26918;5154;83;0;0;0;0;.00nan;0;0
26918;6093;79;0;0;0;0;.00nan;0;0
26918;6735;79;87;49;4;45;.918;3546000;0
26918;8364;83;50;20;3;17;.850;3600000;0
26919;6720;68;56;7;0;7;1.000;641000;0
26919;6799;73;0;0;0;0;.00nan;0;0
26919;7484;73;70;32;3;29;.906;3600000;0
26919;8179;68;47;42;6;36;.857;2959000;0
26920;5088;78;0;0;0;0;.00nan;0;0
26920;5107;77;76;36;3;33;.917;3600000;0
26920;6865;77;0;0;0;0;.00nan;0;0
26920;6916;78;51;30;5;25;.833;3542000;0
26921;3837;75;47;29;4;25;.862;1975000;0
26921;5348;75;22;24;6;18;.750;1625000;0
26921;6197;74;0;0;0;0;.00nan;0;0
26921;7528;74;60;16;2;14;.875;3600000;0
26922;6087;80;71;45;4;41;.911;3600000;0
26922;6840;82;73;21;1;20;.952;3600000;0
26922;8300;80;0;0;0;0;.00nan;0;0
26922;8403;73;0;0;0;0;.00nan;0;0
26923;6664;66;0;0;0;0;.00nan;0;0
26923;7575;81;0;0;0;0;.00nan;0;0
26923;8206;81;86;36;2;34;.944;3600000;0
26923;9775;64;42;27;4;23;.852;3540000;0
26924;4919;70;48;19;3;16;.842;3600000;0
26924;5257;70;0;0;0;0;.00nan;0;0
26924;6077;65;0;0;0;0;.00nan;0;0
26924;8395;65;100;30;0;30;1.000;3600000;0
26925;6799;73;87;40;3;37;.925;3600000;0
26925;6825;72;60;21;2;19;.905;3600000;0
26925;7484;73;0;0;0;0;.00nan;0;0
26925;9850;65;0;0;0;0;.00nan;0;0
26926;4940;62;0;0;0;0;.00nan;0;0
26926;5054;72;0;0;0;0;.00nan;0;0
26926;7501;62;50;15;2;13;.867;3600000;0
26926;9669;72;84;43;3;40;.930;3600000;0
26927;5107;77;0;0;0;0;.00nan;0;0
26927;6751;67;0;0;0;0;.00nan;0;0
26927;6865;77;57;33;4;29;.879;3544000;0
26927;9579;67;49;21;3;18;.857;3600000;0
26928;6840;82;0;0;0;0;.00nan;0;0
26928;7575;81;60;21;2;19;.905;3566000;0
26928;8206;81;0;0;0;0;.00nan;0;0
26928;8403;73;100;34;0;34;1.000;3600000;0
26929;5154;83;71;29;2;27;.931;3600000;0
26929;6664;66;60;29;3;26;.897;3563000;0
26929;8364;83;0;0;0;0;.00nan;0;0
26929;9775;64;0;0;0;0;.00nan;0;0
26930;6720;68;0;0;0;0;.00nan;0;0
26930;6825;72;36;22;4;18;.818;3547000;0
26930;8179;68;69;29;3;26;.897;3600000;0
26930;9850;65;0;0;0;0;.00nan;0;0
26931;5088;78;88;39;2;37;.949;3900000;0
26931;6799;73;0;0;0;0;.00nan;0;0
26931;6916;78;0;0;0;0;.00nan;0;0
26931;7484;73;50;16;2;14;.875;3900000;0
26932;6093;79;0;0;0;0;.00nan;0;0
26932;6664;66;0;0;0;0;.00nan;0;0
26932;6735;79;48;33;5;28;.848;3798000;0
26932;9775;64;42;37;6;31;.838;3798000;0
26933;5054;72;45;42;6;36;.857;3600000;0
26933;8927;63;71;20;1;19;.950;3600000;0
26933;9669;72;0;0;0;0;.00nan;0;0
26933;9673;63;0;0;0;0;.00nan;0;0
26934;6751;67;59;22;3;19;.864;3590000;0
26934;6945;71;0;0;0;0;.00nan;0;0
26934;8361;71;98;42;2;40;.952;3600000;0
26934;9579;67;0;0;0;0;.00nan;0;0
26935;4940;62;57;41;5;36;.878;3885000;0
26935;5183;69;0;0;0;0;.00nan;0;0
26935;5372;69;46;27;4;23;.852;3885000;0
26935;7501;62;0;0;0;0;.00nan;0;0
26936;3837;75;99;42;1;41;.976;3634000;0
26936;5348;75;0;0;0;0;.00nan;0;0
26936;6093;79;57;15;2;13;.867;3634000;0
26936;6735;79;0;0;0;0;.00nan;0;0
26937;5107;77;70;31;3;28;.903;3724000;0
26937;5154;83;0;0;0;0;.00nan;0;0
26937;6865;77;0;0;0;0;.00nan;0;0
26937;8364;83;66;36;4;32;.889;3724000;0
26938;5090;74;0;0;0;0;.00nan;0;0
26938;6197;74;0;0;0;0;.00nan;0;0
26938;6701;76;57;39;4;35;.897;3600000;0
26938;7528;74;100;34;0;34;1.000;3600000;0
26939;4919;70;0;0;0;0;.00nan;0;0
26939;5257;70;71;30;2;28;.933;3600000;0
26939;6840;82;0;0;0;0;.00nan;0;0
26939;8403;73;42;31;5;26;.839;3600000;0
26940;6945;71;0;0;0;0;.00nan;0;0
26940;8361;71;74;35;2;33;.943;3600000;0
26940;8927;63;0;0;0;0;.00nan;0;0
26940;9673;63;40;20;4;16;.800;3540000;0
26941;5054;72;51;30;5;25;.833;3590000;0
26941;6825;72;0;0;0;0;.00nan;0;0
26941;9669;72;0;0;0;0;.00nan;0;0
26941;9850;65;67;32;3;29;.906;3600000;0
26942;4940;62;0;0;0;0;.00nan;0;0
26942;6751;67;0;0;0;0;.00nan;0;0
26942;7501;62;68;26;2;24;.923;3600000;0
26942;9579;67;65;31;3;28;.903;3600000;0
26943;6077;65;50;0;0;0;.00nan;1000;0
26943;6720;68;30;38;7;31;.816;3600000;0
26943;8179;68;0;0;0;0;.00nan;0;0
26943;8395;65;52;36;5;31;.861;3599000;0
26944;3837;75;0;0;0;0;.00nan;0;0
26944;5088;78;49;22;3;19;.864;3600000;0
26944;5348;75;59;23;2;21;.913;3600000;0
26944;6916;78;0;0;0;0;.00nan;0;0
26945;6087;80;61;28;3;25;.893;3600000;0
26945;6664;66;59;39;5;34;.872;3600000;0
26945;8300;80;0;0;0;0;.00nan;0;0
26945;9775;64;0;0;0;0;.00nan;0;0
26946;5090;74;0;0;0;0;.00nan;0;0
26946;6701;76;76;49;4;45;.918;3900000;0
26946;6799;73;29;12;4;8;.667;3900000;0
26946;7484;73;0;0;0;0;.00nan;0;0
26947;6093;79;48;0;0;0;.00nan;218000;0
26947;6197;74;0;0;0;0;.00nan;0;0
26947;6735;79;69;54;6;48;.889;3382000;0
26947;7528;74;79;16;1;15;.938;3600000;0
26948;4919;70;0;0;0;0;.00nan;0;0
26948;5257;70;55;18;2;16;.889;3600000;0
26948;7575;81;49;40;6;34;.850;2734000;0
26948;8206;81;41;14;3;11;.786;866000;0
26949;5054;72;0;0;0;0;.00nan;0;0
26949;6077;65;71;20;1;19;.950;3600000;0
26949;8395;65;0;0;0;0;.00nan;0;0
26949;9669;72;65;46;6;40;.870;3600000;0
26950;6825;72;89;57;6;51;.895;3409000;0
26950;8927;63;36;24;5;19;.792;3600000;0
26950;9673;63;0;0;0;0;.00nan;0;0
26950;9850;65;44;4;1;3;.750;173000;0
26951;5154;83;48;46;6;40;.870;3524000;0
26951;7575;81;0;0;0;0;.00nan;0;0
26951;8206;81;69;30;4;26;.867;3600000;0
26951;8364;83;0;0;0;0;.00nan;0;0
26952;5183;69;0;0;0;0;.00nan;0;0
26952;5372;69;76;31;2;29;.935;3600000;0
26952;6751;67;50;20;3;17;.850;3567000;0
26952;9579;67;0;0;0;0;.00nan;0;0
26953;4919;70;42;28;5;23;.821;3797000;0
26953;5257;70;0;0;0;0;.00nan;0;0
26953;6093;79;79;49;4;45;.918;3797000;0
26953;6735;79;0;0;0;0;.00nan;0;0
26954;4940;62;55;20;2;18;.900;3600000;0
26954;6720;68;0;0;0;0;.00nan;0;0
26954;7501;62;0;0;0;0;.00nan;0;0
26954;8179;68;72;36;3;33;.917;3580000;0
26955;3837;75;67;38;4;34;.895;3600000;0
26955;5088;78;0;0;0;0;.00nan;0;0
26955;5348;75;0;0;0;0;.00nan;0;0
26955;6916;78;59;23;3;20;.870;3600000;0
26956;5107;77;53;3;0;3;1.000;117000;0
26956;6799;73;0;0;0;0;.00nan;0;0
26956;6865;77;57;41;6;35;.854;3446000;0
26956;7484;73;45;21;4;17;.810;3600000;0
26957;6664;66;0;0;0;0;.00nan;0;0
26957;6840;82;36;23;5;18;.783;3600000;0
26957;8403;73;0;0;0;0;.00nan;0;0
26957;9775;64;99;37;1;36;.973;3600000;0
26958;6087;80;0;0;0;0;.00nan;0;0
26958;6197;74;58;26;3;23;.885;3661000;0
26958;7528;74;0;0;0;0;.00nan;0;0
26958;8300;80;73;37;4;33;.892;3661000;0
26959;6087;80;26;27;6;21;.778;2708000;0
26959;7575;81;54;32;4;28;.875;3600000;0
26959;8206;81;0;0;0;0;.00nan;0;0
26959;8300;80;50;3;0;3;1.000;892000;0
26960;4919;70;0;0;0;0;.00nan;0;0
26960;5154;83;0;0;0;0;.00nan;0;0
26960;5257;70;83;38;4;34;.895;3900000;0
26960;8364;83;38;24;4;20;.833;3862000;0
26961;5183;69;100;40;0;40;1.000;3600000;0
26961;5372;69;0;0;0;0;.00nan;0;0
26961;6945;71;0;0;0;0;.00nan;0;0
26961;8361;71;64;31;3;28;.903;3600000;0
26962;6197;74;56;7;0;7;1.000;708000;0
26962;6799;73;70;27;2;25;.926;3600000;0
26962;7484;73;0;0;0;0;.00nan;0;0
26962;7528;74;39;32;6;26;.813;2892000;0
26963;6751;67;83;39;3;36;.923;3600000;0
26963;8927;63;0;0;0;0;.00nan;0;0
26963;9579;67;0;0;0;0;.00nan;0;0
26963;9673;63;29;16;4;12;.750;3556000;0
26964;3837;75;0;0;0;0;.00nan;0;0
26964;5348;75;51;40;5;35;.875;3600000;0
26964;6799;73;0;0;0;0;.00nan;0;0
26964;7484;73;62;14;1;13;.929;3600000;0
26965;5090;74;0;0;0;0;.00nan;0;0
26965;6093;79;61;8;0;8;1.000;743000;0
26965;6701;76;63;37;4;33;.892;3600000;0
26965;6735;79;1;24;8;16;.667;2857000;0
26966;4919;70;64;34;3;31;.912;3900000;0
26966;5257;70;0;0;0;0;.00nan;0;0
26966;6087;80;0;0;0;0;.00nan;0;0
26966;8300;80;60;26;3;23;.885;3900000;0
26967;6840;82;0;0;0;0;.00nan;0;0
26967;7575;81;0;0;0;0;.00nan;0;0
26967;8206;81;53;28;3;25;.893;3900000;0
26967;8403;73;83;38;3;35;.921;3900000;0
26968;6077;65;0;0;0;0;.00nan;0;0
26968;6720;68;61;33;4;29;.879;3600000;0
26968;8179;68;0;0;0;0;.00nan;0;0
26968;8395;65;51;37;5;32;.865;3550000;0
26969;4940;62;0;0;0;0;.00nan;0;0
26969;6945;71;0;0;0;0;.00nan;0;0
26969;7501;62;95;22;0;22;1.000;3600000;0
26969;8361;71;45;44;6;38;.864;3600000;0
26970;6664;66;68;26;2;24;.923;3600000;0
26970;6825;72;62;40;5;35;.875;3600000;0
26970;9775;64;0;0;0;0;.00nan;0;0
26970;9850;65;0;0;0;0;.00nan;0;0
26971;5054;72;76;25;1;24;.960;3600000;0
26971;8927;63;0;0;0;0;.00nan;0;0
26971;9669;72;0;0;0;0;.00nan;0;0
26971;9673;63;48;27;4;23;.852;3600000;0
26972;4919;70;100;43;2;41;.953;3600000;0
26972;5257;70;0;0;0;0;.00nan;0;0
26972;6751;67;0;0;0;0;.00nan;0;0
26972;9579;67;57;30;4;26;.867;3558000;0
26973;3837;75;79;34;2;32;.941;3600000;0
26973;5154;83;99;38;1;37;.974;3600000;0
26973;5348;75;0;0;0;0;.00nan;0;0
26973;8364;83;0;0;0;0;.00nan;0;0
26974;5107;77;93;48;3;45;.938;3900000;0
26974;6840;82;34;15;3;12;.800;3900000;0
26974;6865;77;0;0;0;0;.00nan;0;0
26974;8403;73;0;0;0;0;.00nan;0;0
26975;5090;74;0;0;0;0;.00nan;0;0
26975;6087;80;80;31;1;30;.968;3600000;0
26975;6701;76;85;37;2;35;.946;3553000;0
26975;8300;80;0;0;0;0;.00nan;0;0
26976;5054;72;50;20;3;17;.850;1337000;0
26976;6799;73;72;29;3;26;.897;3600000;0
26976;7484;73;0;0;0;0;.00nan;0;0
26976;9669;72;21;24;6;18;.750;2263000;0
26977;4940;62;63;18;1;17;.944;3600000;0
26977;6945;71;49;42;6;36;.857;2287000;0
26977;7501;62;0;0;0;0;.00nan;0;0
26977;8361;71;57;20;1;19;.950;1313000;0
26978;6664;66;0;0;0;0;.00nan;0;0
26978;6825;72;35;5;2;3;.600;224000;0
26978;9775;64;63;22;2;20;.909;3600000;0
26978;9850;65;40;35;5;30;.857;3376000;0
26979;5183;69;49;28;4;24;.857;3598000;0
26979;5372;69;0;0;0;0;.00nan;0;0
26979;8927;63;51;21;3;18;.857;3600000;0
26979;9673;63;0;0;0;0;.00nan;0;0
26980;4919;70;0;0;0;0;.00nan;0;0
26980;5257;70;82;41;3;38;.927;3562000;0
26980;6720;68;0;0;0;0;.00nan;0;0
26980;8179;68;78;25;2;23;.920;3600000;0
26981;3837;75;0;0;0;0;.00nan;0;0
26981;5154;83;0;0;0;0;.00nan;0;0
26981;5348;75;88;50;4;46;.920;3900000;0
26981;8364;83;38;31;4;27;.871;3900000;0
26982;5088;78;80;31;2;29;.935;3674000;0
26982;6197;74;0;0;0;0;.00nan;0;0
26982;6916;78;0;0;0;0;.00nan;0;0
26982;7528;74;80;24;1;23;.958;3674000;0
26983;5090;74;0;0;0;0;.00nan;0;0
26983;6701;76;68;42;4;38;.905;3593000;0
26983;6840;82;0;0;0;0;.00nan;0;0
26983;8403;73;68;22;2;20;.909;3600000;0
26984;5107;77;0;0;0;0;.00nan;0;0
26984;6087;80;40;16;3;13;.813;1211000;0
26984;6865;77;57;31;4;27;.871;3600000;0
26984;8300;80;26;16;5;11;.688;2389000;0
26985;6093;79;49;1;0;1;1.000;314000;0
26985;6735;79;44;36;6;30;.833;3286000;0
26985;7575;81;0;0;0;0;.00nan;0;0
26985;8206;81;59;20;3;17;.850;3600000;0
26986;5054;72;63;34;4;30;.882;3600000;0
26986;5183;69;0;0;0;0;.00nan;0;0
26986;5372;69;94;35;1;34;.971;3600000;0
26986;9669;72;0;0;0;0;.00nan;0;0
26987;6799;73;48;6;1;5;.833;510000;0
26987;7484;73;19;27;6;21;.778;3090000;0
26987;8927;63;0;0;0;0;.00nan;0;0
26987;9673;63;69;37;3;34;.919;3600000;0
26988;6825;72;0;0;0;0;.00nan;0;0
26988;6945;71;62;33;4;29;.879;3600000;0
26988;8361;71;0;0;0;0;.00nan;0;0
26988;9850;65;95;34;1;33;.971;3600000;0
26989;6720;68;84;28;2;26;.929;3600000;0
26989;6751;67;46;32;5;27;.844;3600000;0
26989;8179;68;0;0;0;0;.00nan;0;0
26989;9579;67;0;0;0;0;.00nan;0;0
26990;6077;65;75;42;3;39;.929;3530000;0
26990;6799;73;0;0;0;0;.00nan;0;0
26990;7484;73;83;25;1;24;.960;3600000;0
26990;8395;65;0;0;0;0;.00nan;0;0
26991;5088;78;54;25;3;22;.880;3600000;0
26991;5154;83;41;29;5;24;.828;1943000;0
26991;6916;78;0;0;0;0;.00nan;0;0
26991;8364;83;59;14;1;13;.929;1632000;0
26992;6093;79;0;0;0;0;.00nan;0;0
26992;6735;79;80;29;1;28;.966;3600000;0
26992;6840;82;19;29;7;22;.759;3382000;0
26992;8403;73;48;0;0;0;.00nan;218000;0
26993;6664;66;47;29;4;25;.862;3548000;0
26993;6945;71;0;0;0;0;.00nan;0;0
26993;8361;71;75;41;3;38;.927;3600000;0
26993;9775;64;0;0;0;0;.00nan;0;0
26994;6751;67;0;0;0;0;.00nan;0;0
26994;7575;81;0;0;0;0;.00nan;0;0
26994;8206;81;85;32;2;30;.938;3600000;0
26994;9579;67;63;39;4;35;.897;3523000;0
26995;5183;69;54;22;3;19;.864;3587000;0
26995;5372;69;0;0;0;0;.00nan;0;0
26995;6077;65;0;0;0;0;.00nan;0;0
26995;8395;65;91;28;1;27;.964;3600000;0
26996;5088;78;50;5;1;4;.800;587000;0
26996;5154;83;0;0;0;0;.00nan;0;0
26996;6916;78;47;35;6;29;.829;3013000;0
26996;8364;83;57;30;4;26;.867;3600000;0
26997;5090;74;41;30;5;25;.833;3900000;0
26997;5107;77;55;34;5;29;.853;3900000;0
26997;6701;76;0;0;0;0;.00nan;0;0
26997;6905;77;0;0;0;0;.00nan;0;0
26998;5183;69;46;17;3;14;.824;3600000;0
26998;5372;69;0;0;0;0;.00nan;0;0
26998;6077;65;0;0;0;0;.00nan;0;0
26998;8395;65;44;34;5;29;.853;3549000;0
26999;4940;62;56;35;4;31;.886;3600000;0
26999;6197;74;0;0;0;0;.00nan;0;0
26999;7501;62;0;0;0;0;.00nan;0;0
26999;7528;74;90;38;3;35;.921;3600000;0
27000;6945;71;63;40;4;36;.900;3600000;0
27000;7575;81;0;0;0;0;.00nan;0;0
27000;8206;81;24;29;6;23;.793;3585000;0
27000;8361;71;0;0;0;0;.00nan;0;0
27001;3837;75;0;0;0;0;.00nan;0;0
27001;5348;75;83;49;4;45;.918;3600000;0
27001;6825;72;87;27;1;26;.963;3600000;0
27001;9850;65;0;0;0;0;.00nan;0;0
27002;6664;66;0;0;0;0;.00nan;0;0
27002;8927;63;62;24;3;21;.875;3600000;0
27002;9673;63;0;0;0;0;.00nan;0;0
27002;9775;64;58;34;4;30;.882;3581000;0
27003;5054;72;50;0;0;0;.00nan;17000;0
27003;6799;73;66;27;3;24;.889;3600000;0
27003;7484;73;0;0;0;0;.00nan;0;0
27003;9669;72;26;46;9;37;.804;3583000;0
27004;6720;68;79;37;2;35;.946;3600000;0
27004;6751;67;50;30;4;26;.867;3516000;0
27004;8179;68;0;0;0;0;.00nan;0;0
27004;9579;67;0;0;0;0;.00nan;0;0
27005;5090;74;0;0;0;0;.00nan;0;0
27005;6093;79;57;44;5;39;.886;3600000;0
27005;6701;76;50;30;4;26;.867;3600000;0
27005;6735;79;0;0;0;0;.00nan;0;0
27006;5107;77;0;0;0;0;.00nan;0;0
27006;6840;82;0;0;0;0;.00nan;0;0
27006;6905;77;54;28;4;24;.857;3584000;0
27006;8403;73;42;21;4;17;.810;3600000;0
27007;4940;62;0;0;0;0;.00nan;0;0
27007;6077;65;92;50;3;47;.940;3600000;0
27007;7501;62;67;21;2;19;.905;3600000;0
27007;8395;65;0;0;0;0;.00nan;0;0
27008;5183;69;0;0;0;0;.00nan;0;0
27008;5372;69;81;36;2;34;.944;3900000;0
27008;8927;63;0;0;0;0;.00nan;0;0
27008;9673;63;65;22;2;20;.909;3900000;0
27009;4919;70;0;0;0;0;.00nan;0;0
27009;5257;70;100;47;3;44;.936;3600000;0
27009;6197;74;0;0;0;0;.00nan;0;0
27009;7528;74;54;32;4;28;.875;3554000;0
27010;6751;67;0;0;0;0;.00nan;0;0
27010;6945;71;59;8;0;8;1.000;449000;0
27010;8361;71;30;31;7;24;.774;3151000;0
27010;9579;67;37;16;3;13;.813;3600000;0
27011;3837;75;79;39;4;35;.897;3600000;0
27011;5348;75;0;0;0;0;.00nan;0;0
27011;6664;66;53;12;1;11;.917;3600000;0
27011;9775;64;0;0;0;0;.00nan;0;0
27012;5088;78;54;35;4;31;.886;3600000;0
27012;5154;83;66;32;3;29;.906;3600000;0
27012;6916;78;0;0;0;0;.00nan;0;0
27012;8364;83;0;0;0;0;.00nan;0;0
27013;5054;72;55;37;5;32;.865;3600000;0
27013;6799;73;0;0;0;0;.00nan;0;0
27013;7484;73;90;21;0;21;1.000;3600000;0
27013;9669;72;0;0;0;0;.00nan;0;0
27014;6720;68;45;4;1;3;.750;245000;0
27014;7575;81;48;27;4;23;.852;3600000;0
27014;8179;68;46;39;6;33;.846;3355000;0
27014;8206;81;0;0;0;0;.00nan;0;0
27015;6087;80;0;0;0;0;.00nan;0;0
27015;6840;82;70;35;3;32;.914;3600000;0
27015;8300;80;47;27;4;23;.852;3570000;0
27015;8403;73;0;0;0;0;.00nan;0;0
27016;5090;74;79;24;1;23;.958;3600000;0
27016;6093;79;0;0;0;0;.00nan;0;0
27016;6701;76;0;0;0;0;.00nan;0;0
27016;6735;79;55;31;4;27;.871;3600000;0
27017;5054;72;54;2;0;2;1.000;414000;0
27017;7575;81;49;17;2;15;.882;1835000;0
27017;8206;81;15;19;6;13;.684;1686000;0
27017;9669;72;49;38;6;32;.842;3186000;0
27018;5107;77;32;46;8;38;.826;3600000;0
27018;6087;80;61;16;1;15;.938;3600000;0
27018;6905;77;0;0;0;0;.00nan;0;0
27018;8300;80;0;0;0;0;.00nan;0;0
27019;5088;78;0;0;0;0;.00nan;0;0
27019;5154;83;0;0;0;0;.00nan;0;0
27019;6916;78;57;32;4;28;.875;3600000;0
27019;8364;83;80;26;1;25;.962;3600000;0
27020;6197;74;0;0;0;0;.00nan;0;0
27020;6825;72;45;28;4;24;.857;2444000;0
27020;7528;74;46;27;5;22;.815;3600000;0
27020;9850;65;31;17;4;13;.765;1156000;0
27021;3837;75;0;0;0;0;.00nan;0;0
27021;5348;75;71;48;4;44;.917;3600000;0
27021;6077;65;0;0;0;0;.00nan;0;0
27021;8395;65;79;29;1;28;.966;3600000;0
27022;4919;70;48;26;4;22;.846;3577000;0
27022;5257;70;0;0;0;0;.00nan;0;0
27022;6720;68;0;0;0;0;.00nan;0;0
27022;8179;68;82;30;3;27;.900;3600000;0
27023;6093;79;0;0;0;0;.00nan;0;0
27023;6735;79;19;35;7;28;.800;3600000;0
27023;6840;82;0;0;0;0;.00nan;0;0
27023;8403;73;63;36;4;32;.889;3600000;0
27024;4940;62;99;41;1;40;.976;3600000;0
27024;6720;68;64;29;3;26;.897;3565000;0
27024;7501;62;0;0;0;0;.00nan;0;0
27024;8179;68;0;0;0;0;.00nan;0;0
27025;3837;75;45;40;6;34;.850;2579000;0
27025;5348;75;43;22;3;19;.864;1021000;0
27025;8927;63;50;14;3;11;.786;3600000;0
27025;9673;63;0;0;0;0;.00nan;0;0
27026;6197;74;33;28;5;23;.821;3580000;0
27026;6664;66;50;0;0;0;.00nan;7000;0
27026;7528;74;0;0;0;0;.00nan;0;0
27026;9775;64;48;27;4;23;.852;3593000;0
27027;5183;69;0;0;0;0;.00nan;0;0
27027;5372;69;73;22;2;20;.909;3600000;0
27027;6751;67;47;44;6;38;.864;3488000;0
27027;9579;67;30;2;2;0;.000;112000;0
27028;6799;73;0;0;0;0;.00nan;0;0
27028;6945;71;0;0;0;0;.00nan;0;0
27028;7484;73;56;22;3;19;.864;3600000;0
27028;8361;71;49;44;7;37;.841;3600000;0
27029;4940;62;0;0;0;0;.00nan;0;0
27029;7501;62;73;31;3;28;.903;3600000;0
27029;8390;66;55;33;5;28;.848;3554000;0
27029;9775;64;0;0;0;0;.00nan;0;0
27030;6197;74;57;7;0;7;1.000;668000;0
27030;7528;74;57;36;6;30;.833;2932000;0
27030;8927;63;0;0;0;0;.00nan;0;0
27030;9673;63;60;21;2;19;.905;3600000;0
27031;3837;75;63;42;5;37;.881;3600000;0
27031;4919;70;0;0;0;0;.00nan;0;0
27031;5257;70;80;14;0;14;1.000;3600000;0
27031;5348;75;0;0;0;0;.00nan;0;0
27032;6077;65;75;30;3;27;.900;3600000;0
27032;6825;72;53;30;4;26;.867;3551000;0
27032;8395;65;0;0;0;0;.00nan;0;0
27032;9850;65;0;0;0;0;.00nan;0;0
27033;5183;69;37;26;5;21;.808;3600000;0
27033;5372;69;0;0;0;0;.00nan;0;0
27033;6720;68;42;8;2;6;.750;490000;0
27033;8179;68;18;34;7;27;.794;3110000;0
27034;6799;73;43;13;3;10;.769;3600000;0
27034;6945;71;26;26;6;20;.769;1377000;0
27034;7484;73;0;0;0;0;.00nan;0;0
27034;8361;71;44;43;7;36;.837;2223000;0
27035;5154;83;0;0;0;0;.00nan;0;0
27035;7575;81;54;24;3;21;.875;3600000;0
27035;8206;81;0;0;0;0;.00nan;0;0
27035;8364;83;41;26;5;21;.808;3600000;0
27036;5088;78;62;24;3;21;.875;3569000;0
27036;5090;74;0;0;0;0;.00nan;0;0
27036;6701;76;100;41;2;39;.951;3600000;0
27036;6916;78;0;0;0;0;.00nan;0;0
27037;6087;80;0;0;0;0;.00nan;0;0
27037;6093;79;87;48;4;44;.917;3600000;0
27037;6735;79;0;0;0;0;.00nan;0;0
27037;8300;80;35;24;5;19;.792;3565000;0
27038;6077;65;0;0;0;0;.00nan;0;0
27038;6197;74;0;0;0;0;.00nan;0;0
27038;7528;74;60;32;4;28;.875;3515000;0
27038;8395;65;100;40;2;38;.950;3600000;0
27039;3837;75;0;0;0;0;.00nan;0;0
27039;4940;62;64;23;2;21;.913;3600000;0
27039;5348;75;66;42;5;37;.881;3600000;0
27039;7501;62;0;0;0;0;.00nan;0;0
27040;5054;72;82;32;2;30;.938;3600000;0
27040;6751;67;53;26;4;22;.846;3577000;0
27040;9579;67;0;0;0;0;.00nan;0;0
27040;9669;72;0;0;0;0;.00nan;0;0
27041;5183;69;0;0;0;0;.00nan;0;0
27041;5372;69;48;6;1;5;.833;3600000;0
27041;6945;71;36;34;6;28;.824;2911000;0
27041;8361;71;24;5;3;2;.400;689000;0
27042;6093;79;0;0;0;0;.00nan;0;0
27042;6735;79;77;25;1;24;.960;3600000;0
27042;6840;82;44;35;6;29;.829;3600000;0
27042;8403;73;0;0;0;0;.00nan;0;0
27043;6720;68;0;0;0;0;.00nan;0;0
27043;6799;73;0;0;0;0;.00nan;0;0
27043;7484;73;56;18;2;16;.889;3600000;0
27043;8179;68;64;33;4;29;.879;3549000;0
27044;5088;78;60;33;3;30;.909;3610000;0
27044;5090;74;43;22;4;18;.818;3610000;0
27044;6701;76;0;0;0;0;.00nan;0;0
27044;6916;78;0;0;0;0;.00nan;0;0
27045;5154;83;71;32;3;29;.906;3682000;0
27045;6087;80;94;37;2;35;.946;3682000;0
27045;8300;80;0;0;0;0;.00nan;0;0
27045;8364;83;0;0;0;0;.00nan;0;0
27046;5107;77;64;46;5;41;.891;3600000;0
27046;6905;77;0;0;0;0;.00nan;0;0
27046;7575;81;0;0;0;0;.00nan;0;0
27046;8206;81;69;26;3;23;.885;3600000;0
27047;5054;72;0;0;0;0;.00nan;0;0
27047;6751;67;0;0;0;0;.00nan;0;0
27047;9579;67;69;38;3;35;.921;3848000;0
27047;9669;72;58;34;4;30;.882;3870000;0
27048;8390;66;63;39;4;35;.897;3581000;0
27048;8927;63;67;22;2;20;.909;3600000;0
27048;9673;63;0;0;0;0;.00nan;0;0
27048;9775;64;0;0;0;0;.00nan;0;0
27049;4919;70;0;0;0;0;.00nan;0;0
27049;4940;62;0;0;0;0;.00nan;0;0
27049;5257;70;83;24;1;23;.958;3600000;0
27049;7501;62;86;35;2;33;.943;3597000;0
27050;6840;82;0;0;0;0;.00nan;0;0
27050;7575;81;38;26;5;21;.808;3535000;0
27050;8206;81;0;0;0;0;.00nan;0;0
27050;8403;73;64;24;3;21;.875;3600000;0
27051;5154;83;0;0;0;0;.00nan;0;0
27051;6093;79;57;43;5;38;.884;3600000;0
27051;6735;79;0;0;0;0;.00nan;0;0
27051;8364;83;86;41;3;38;.927;3600000;0
27052;6825;72;55;4;0;4;1.000;966000;0
27052;8390;66;0;0;0;0;.00nan;0;0
27052;9775;64;49;35;5;30;.857;3600000;0
27052;9850;65;30;34;7;27;.794;2549000;0
27053;5088;78;46;31;5;26;.839;3600000;0
27053;5107;77;70;33;3;30;.909;3600000;0
27053;6905;77;0;0;0;0;.00nan;0;0
27053;6916;78;0;0;0;0;.00nan;0;0
27054;6087;80;0;0;0;0;.00nan;0;0
27054;6093;79;0;0;0;0;.00nan;0;0
27054;6735;79;67;50;5;45;.900;3600000;0
27054;8300;80;91;20;0;20;1.000;3600000;0
27055;5090;74;0;0;0;0;.00nan;0;0
27055;6701;76;79;43;4;39;.907;3900000;0
27055;6840;82;73;44;4;40;.909;3900000;0
27055;8403;73;0;0;0;0;.00nan;0;0
27056;5107;77;66;40;4;36;.900;3075000;0
27056;6197;74;0;0;0;0;.00nan;0;0
27056;6905;77;34;13;3;10;.769;525000;0
27056;7528;74;71;30;3;27;.900;3600000;0
27057;6087;80;0;0;0;0;.00nan;0;0
27057;7575;81;0;0;0;0;.00nan;0;0
27057;8206;81;69;44;4;40;.909;3525000;0
27057;8300;80;69;23;2;21;.913;3600000;0
27058;5090;74;66;28;3;25;.893;3600000;0
27058;6701;76;0;0;0;0;.00nan;0;0
27058;6840;82;45;5;1;4;.800;621000;0
27058;8403;73;31;27;6;21;.778;2979000;0
27059;6077;65;61;45;6;39;.867;3600000;0
27059;8395;65;0;0;0;0;.00nan;0;0
27059;8927;63;27;12;4;8;.667;3600000;0
27059;9673;63;0;0;0;0;.00nan;0;0
27060;4919;70;0;0;0;0;.00nan;0;0
27060;4940;62;83;36;3;33;.917;3600000;0
27060;5257;70;52;31;4;27;.871;3588000;0
27060;7501;62;0;0;0;0;.00nan;0;0
27061;6720;68;43;28;4;24;.857;3600000;0
27061;6945;71;58;6;0;6;1.000;528000;0
27061;8179;68;0;0;0;0;.00nan;0;0
27061;8361;71;22;30;6;24;.800;3029000;0
27062;6664;66;50;31;5;26;.839;3600000;0
27062;6825;72;32;12;3;9;.750;1061000;0
27062;8390;66;0;0;0;0;.00nan;0;0
27062;9850;65;22;26;6;20;.769;2539000;0
27063;5054;72;55;37;4;33;.892;3595000;0
27063;6751;67;0;0;0;0;.00nan;0;0
27063;9579;67;60;24;3;21;.875;3600000;0
27063;9669;72;0;0;0;0;.00nan;0;0
27064;5183;69;50;44;6;38;.864;3600000;0
27064;5372;69;0;0;0;0;.00nan;0;0
27064;6799;73;99;29;0;29;1.000;3600000;0
27064;7484;73;0;0;0;0;.00nan;0;0
27065;3837;75;0;0;0;0;.00nan;0;0
27065;5348;75;56;34;4;30;.882;3572000;0
27065;6197;74;0;0;0;0;.00nan;0;0
27065;7528;74;49;21;3;18;.857;3600000;0
27066;5154;83;49;49;7;42;.857;3600000;0
27066;6087;80;0;0;0;0;.00nan;0;0
27066;8300;80;46;26;4;22;.846;3600000;0
27066;8364;83;0;0;0;0;.00nan;0;0
27067;5090;74;0;0;0;0;.00nan;0;0
27067;5107;77;55;28;4;24;.857;1803000;0
27067;6701;76;63;18;2;16;.889;3600000;0
27067;6905;77;29;28;6;22;.786;1797000;0
27068;6093;79;68;38;4;34;.895;3600000;0
27068;6735;79;0;0;0;0;.00nan;0;0
27068;6840;82;0;0;0;0;.00nan;0;0
27068;8403;73;54;17;2;15;.882;3600000;0
27069;5088;78;72;17;1;16;.941;1486000;0
27069;6916;78;26;21;5;16;.762;2114000;0
27069;7575;81;0;0;0;0;.00nan;0;0
27069;8206;81;50;26;3;23;.885;3600000;0
27070;6077;65;0;0;0;0;.00nan;0;0
27070;8395;65;83;37;2;35;.946;3583000;0
27070;8927;63;0;0;0;0;.00nan;0;0
27070;9673;63;58;15;1;14;.933;3600000;0
27071;4919;70;17;21;6;15;.714;2180000;0
27071;4940;62;0;0;0;0;.00nan;0;0
27071;5257;70;73;17;0;17;1.000;1420000;0
27071;7501;62;69;28;2;26;.929;3600000;0
27072;6664;66;0;0;0;0;.00nan;0;0
27072;6825;72;48;39;6;33;.846;3519000;0
27072;8390;66;31;18;4;14;.778;3600000;0
27072;9850;65;0;0;0;0;.00nan;0;0
27073;6751;67;43;25;4;21;.840;3600000;0
27073;6945;71;71;43;5;38;.884;3557000;0
27073;8361;71;0;0;0;0;.00nan;0;0
27073;9579;67;0;0;0;0;.00nan;0;0
27074;5183;69;0;0;0;0;.00nan;0;0
27074;5372;69;92;39;1;38;.974;3824000;0
27074;6799;73;66;24;2;22;.917;3824000;0
27074;7484;73;0;0;0;0;.00nan;0;0
27075;5154;83;0;0;0;0;.00nan;0;0
27075;6093;79;0;0;0;0;.00nan;0;0
27075;6735;79;60;25;3;22;.880;3600000;0
27075;8364;83;59;33;4;29;.879;3574000;0
27076;5054;72;0;0;0;0;.00nan;0;0
27076;6720;68;0;0;0;0;.00nan;0;0
27076;8179;68;60;28;3;25;.893;3671000;0
27076;9669;72;61;33;4;29;.879;3671000;0
27077;3837;75;67;48;6;42;.875;3572000;0
27077;5348;75;0;0;0;0;.00nan;0;0
27077;7575;81;52;23;4;19;.826;3600000;0
27077;8206;81;0;0;0;0;.00nan;0;0
27078;5107;77;87;39;2;37;.949;3584000;0
27078;6197;74;64;17;1;16;.941;3600000;0
27078;6905;77;0;0;0;0;.00nan;0;0
27078;7528;74;0;0;0;0;.00nan;0;0
27079;6087;80;73;39;4;35;.897;3600000;0
27079;6840;82;100;25;0;25;1.000;3600000;0
27079;8300;80;0;0;0;0;.00nan;0;0
27079;8403;73;0;0;0;0;.00nan;0;0
27080;5088;78;51;26;4;22;.846;2326000;0
27080;5090;74;72;26;1;25;.962;3600000;0
27080;6701;76;0;0;0;0;.00nan;0;0
27080;6916;78;59;7;0;7;1.000;1274000;0
27081;6825;72;0;0;0;0;.00nan;0;0
27081;8927;63;72;19;1;18;.947;3600000;0
27081;9673;63;0;0;0;0;.00nan;0;0
27081;9850;65;68;40;3;37;.925;3577000;0
27082;4940;62;84;42;3;39;.929;3900000;0
27082;6664;66;69;29;3;26;.897;3900000;0
27082;7501;62;0;0;0;0;.00nan;0;0
27082;8390;66;0;0;0;0;.00nan;0;0
27083;6751;67;0;0;0;0;.00nan;0;0
27083;6945;71;0;0;0;0;.00nan;0;0
27083;8361;71;100;37;0;37;1.000;3600000;0
27083;9579;67;39;22;4;18;.818;3600000;0
27084;5054;72;100;74;4;70;.946;3900000;0
27084;6799;73;0;0;0;0;.00nan;0;0
27084;7484;73;24;15;4;11;.733;3900000;0
27084;9669;72;0;0;0;0;.00nan;0;0
27085;5183;69;68;37;4;33;.892;3600000;0
27085;5372;69;0;0;0;0;.00nan;0;0
27085;7575;81;0;0;0;0;.00nan;0;0
27085;8206;81;38;28;5;23;.821;3573000;0
27086;3837;75;43;10;2;8;.800;732000;0
27086;5090;74;0;0;0;0;.00nan;0;0
27086;5348;75;35;31;6;25;.806;2868000;0
27086;6701;76;74;26;2;24;.923;3600000;0
27087;5088;78;61;43;5;38;.884;3600000;0
27087;6197;74;0;0;0;0;.00nan;0;0
27087;6916;78;0;0;0;0;.00nan;0;0
27087;7528;74;67;19;2;17;.895;3600000;0
27088;6077;65;62;31;3;28;.903;3566000;0
27088;6825;72;69;28;2;26;.929;3600000;0
27088;8395;65;0;0;0;0;.00nan;0;0
27088;9850;65;0;0;0;0;.00nan;0;0
27089;5154;83;0;0;0;0;.00nan;0;0
27089;6093;79;57;31;4;27;.871;3600000;0
27089;6735;79;0;0;0;0;.00nan;0;0
27089;8364;83;80;27;1;26;.963;3600000;0
27090;6087;80;0;0;0;0;.00nan;0;0
27090;6840;82;28;15;4;11;.733;1018000;0
27090;8300;80;62;31;4;27;.871;3600000;0
27090;8403;73;65;20;2;18;.900;2498000;0
27091;5054;72;0;0;0;0;.00nan;0;0
27091;6720;68;52;21;3;18;.857;3900000;0
27091;8179;68;0;0;0;0;.00nan;0;0
27091;9669;72;50;32;3;29;.906;3900000;0
27092;4919;70;89;43;3;40;.930;3594000;0
27092;5257;70;0;0;0;0;.00nan;0;0
27092;6664;66;0;0;0;0;.00nan;0;0
27092;8390;66;78;28;2;26;.929;3600000;0
27093;6799;73;90;19;0;19;1.000;3600000;0
27093;7484;73;0;0;0;0;.00nan;0;0
27093;7575;81;0;0;0;0;.00nan;0;0
27093;8206;81;88;54;4;50;.926;3600000;0
27094;4940;62;100;27;0;27;1.000;3600000;0
27094;7501;62;0;0;0;0;.00nan;0;0
27094;8927;63;48;12;2;10;.833;1516000;0
27094;9673;63;31;14;4;10;.714;2084000;0
27095;5090;74;0;0;0;0;.00nan;0;0
27095;5107;77;0;0;0;0;.00nan;0;0
27095;6701;76;94;24;0;24;1.000;3600000;0
27095;6905;77;79;41;3;38;.927;3600000;0
27096;6945;71;0;0;0;0;.00nan;0;0
27096;8361;71;74;29;2;27;.931;3600000;0
27096;8927;63;0;0;0;0;.00nan;0;0
27096;9673;63;67;21;1;20;.952;3600000;0
27097;4940;62;55;31;5;26;.839;3600000;0
27097;6825;72;0;0;0;0;.00nan;0;0
27097;7501;62;0;0;0;0;.00nan;0;0
27097;9850;65;40;39;7;32;.821;3537000;0
27098;6093;79;98;35;1;34;.971;3600000;0
27098;6735;79;0;0;0;0;.00nan;0;0
27098;6751;67;0;0;0;0;.00nan;0;0
27098;9579;67;36;14;3;11;.786;3541000;0
27099;4919;70;0;0;0;0;.00nan;0;0
27099;5183;69;0;0;0;0;.00nan;0;0
27099;5257;70;82;29;1;28;.966;3600000;0
27099;5372;69;69;25;2;23;.920;3598000;0
27100;6077;65;0;0;0;0;.00nan;0;0
27100;6799;73;72;16;1;15;.938;3600000;0
27100;7484;73;0;0;0;0;.00nan;0;0
27100;8395;65;82;51;4;47;.922;3600000;0
27101;5054;72;64;44;5;39;.886;3528000;0
27101;6720;68;47;25;3;22;.880;3600000;0
27101;8179;68;0;0;0;0;.00nan;0;0
27101;9669;72;0;0;0;0;.00nan;0;0
27102;3837;75;0;0;0;0;.00nan;0;0
27102;5107;77;55;25;2;23;.920;3600000;0
27102;5348;75;57;22;3;19;.864;3577000;0
27102;6905;77;0;0;0;0;.00nan;0;0
27103;5088;78;58;25;3;22;.880;3581000;0
27103;6916;78;0;0;0;0;.00nan;0;0
27103;7575;81;74;18;1;17;.944;3600000;0
27103;8206;81;0;0;0;0;.00nan;0;0
27104;5090;74;33;5;2;3;.600;140000;0
27104;6197;74;0;0;0;0;.00nan;0;0
27104;6701;76;30;32;6;26;.813;3460000;0
27104;7528;74;91;42;1;41;.976;3600000;0
27105;5154;83;98;44;1;43;.977;3600000;0
27105;6840;82;0;0;0;0;.00nan;0;0
27105;8364;83;0;0;0;0;.00nan;0;0
27105;8403;73;60;29;4;25;.862;3600000;0
27106;6945;71;68;33;3;30;.909;3585000;0
27106;8361;71;0;0;0;0;.00nan;0;0
27106;8927;63;85;27;1;26;.963;3600000;0
27106;9673;63;0;0;0;0;.00nan;0;0
27107;4940;62;67;11;0;11;1.000;1598000;0
27107;6664;66;52;35;4;31;.886;3600000;0
27107;7501;62;39;28;6;22;.786;1954000;0
27107;8390;66;0;0;0;0;.00nan;0;0
27108;5054;72;0;0;0;0;.00nan;0;0
27108;6751;67;81;30;1;29;.967;3600000;0
27108;9579;67;0;0;0;0;.00nan;0;0
27108;9669;72;53;24;3;21;.875;3569000;0
27109;5154;83;0;0;0;0;.00nan;0;0
27109;6087;80;0;0;0;0;.00nan;0;0
27109;8300;80;84;31;1;30;.968;3549000;0
27109;8364;83;100;35;0;35;1.000;3600000;0
27110;5183;69;98;17;0;17;1.000;3600000;0
27110;5372;69;0;0;0;0;.00nan;0;0
27110;6077;65;76;31;2;29;.935;3515000;0
27110;8395;65;0;0;0;0;.00nan;0;0
27111;6093;79;70;22;1;21;.955;3600000;0
27111;6720;68;0;0;0;0;.00nan;0;0
27111;6735;79;0;0;0;0;.00nan;0;0
27111;8179;68;76;38;3;35;.921;3600000;0
27112;3837;75;85;41;3;38;.927;3600000;0
27112;5090;74;39;32;5;27;.844;3581000;0
27112;5348;75;0;0;0;0;.00nan;0;0
27112;6701;76;0;0;0;0;.00nan;0;0
27113;5088;78;0;0;0;0;.00nan;0;0
27113;6916;78;75;45;4;41;.911;3583000;0
27113;7575;81;0;0;0;0;.00nan;0;0
27113;8206;81;79;33;2;31;.939;3600000;0
27114;5107;77;0;0;0;0;.00nan;0;0
27114;6197;74;0;0;0;0;.00nan;0;0
27114;6905;77;76;31;2;29;.935;3567000;0
27114;7528;74;63;13;1;12;.923;3600000;0
27115;4919;70;71;29;3;26;.897;3600000;0
27115;5257;70;0;0;0;0;.00nan;0;0
27115;6799;73;0;0;0;0;.00nan;0;0
27115;7484;73;47;38;5;33;.868;3536000;0
27116;6825;72;100;41;1;40;.976;3600000;0
27116;8927;63;0;0;0;0;.00nan;0;0
27116;9673;63;61;19;2;17;.895;3561000;0
27116;9850;65;0;0;0;0;.00nan;0;0
27117;6093;79;59;20;2;18;.900;3557000;0
27117;6735;79;0;0;0;0;.00nan;0;0
27117;6945;71;0;0;0;0;.00nan;0;0
27117;8361;71;74;24;1;23;.958;3600000;0
27118;5054;72;96;48;3;45;.938;3600000;0
27118;6077;65;52;3;0;3;1.000;327000;0
27118;8395;65;20;24;6;18;.750;3273000;0
27118;9669;72;0;0;0;0;.00nan;0;0
27119;6087;80;100;47;2;45;.957;3600000;0
27119;6197;74;64;33;4;29;.879;3585000;0
27119;7528;74;0;0;0;0;.00nan;0;0
27119;8111;80;0;0;0;0;.00nan;0;0
27120;4940;62;0;0;0;0;.00nan;0;0
27120;6664;66;0;0;0;0;.00nan;0;0
27120;7501;62;91;43;2;41;.953;3600000;0
27120;8390;66;70;34;3;31;.912;3549000;0
27121;6720;68;91;44;2;42;.955;3900000;0
27121;6825;72;78;27;2;25;.926;3900000;0
27121;8179;68;0;0;0;0;.00nan;0;0
27121;9850;65;0;0;0;0;.00nan;0;0
27122;4940;62;0;0;0;0;.00nan;0;0
27122;5183;69;56;27;3;24;.889;3600000;0
27122;5372;69;0;0;0;0;.00nan;0;0
27122;7501;62;77;27;2;25;.926;3600000;0
27123;5154;83;17;28;7;21;.750;2854000;0
27123;6840;82;63;31;3;28;.903;3600000;0
27123;8364;83;36;7;2;5;.714;746000;0
27123;8403;73;0;0;0;0;.00nan;0;0
27124;6077;65;96;45;2;43;.956;3900000;0
27124;6799;73;51;17;2;15;.882;3900000;0
27124;7484;73;0;0;0;0;.00nan;0;0
27124;8395;65;0;0;0;0;.00nan;0;0
27125;5088;78;76;34;3;31;.912;3600000;0
27125;6916;78;0;0;0;0;.00nan;0;0
27125;8927;63;85;16;0;16;1.000;3600000;0
27125;9673;63;0;0;0;0;.00nan;0;0
27126;4919;70;0;0;0;0;.00nan;0;0
27126;5183;69;0;0;0;0;.00nan;0;0
27126;5257;70;92;33;2;31;.939;3850000;0
27126;5372;69;78;25;1;24;.960;3850000;0
27127;6664;66;63;26;2;24;.923;3600000;0
27127;6720;68;44;3;1;2;.667;288000;0
27127;8179;68;44;46;6;40;.870;3312000;0
27127;8390;66;0;0;0;0;.00nan;0;0
27128;5090;74;0;0;0;0;.00nan;0;0
27128;6197;74;64;21;2;19;.905;2501000;0
27128;6701;76;81;30;2;28;.933;3600000;0
27128;7528;74;24;11;4;7;.636;1099000;0
27129;4940;62;94;20;0;20;1.000;3600000;0
27129;5088;78;82;41;3;38;.927;3600000;0
27129;6916;78;0;0;0;0;.00nan;0;0
27129;7501;62;0;0;0;0;.00nan;0;0
27130;4919;70;38;32;6;26;.813;2071000;0
27130;5257;70;62;14;1;13;.929;1620000;0
27130;6799;73;51;14;2;12;.857;2589000;0
27130;8403;73;21;10;4;6;.600;1102000;0
27131;5183;69;0;0;0;0;.00nan;0;0
27131;5372;69;76;36;2;34;.944;3600000;0
27131;6825;72;0;0;0;0;.00nan;0;0
27131;9850;65;49;29;4;25;.862;3572000;0
27132;5054;72;52;25;3;22;.880;3540000;0
27132;6751;67;0;0;0;0;.00nan;0;0
27132;9579;67;88;30;1;29;.967;3600000;0
27132;9669;72;0;0;0;0;.00nan;0;0
27133;6077;65;57;32;5;27;.844;3548000;0
27133;6720;68;0;0;0;0;.00nan;0;0
27133;8179;68;48;28;4;24;.857;3600000;0
27133;8395;65;0;0;0;0;.00nan;0;0
27134;3837;75;0;0;0;0;.00nan;0;0
27134;5348;75;99;36;1;35;.972;3600000;0
27134;6197;74;0;0;0;0;.00nan;0;0
27134;7528;74;55;29;3;26;.897;3568000;0
27135;5107;77;36;40;8;32;.800;3080000;0
27135;6840;82;42;16;3;13;.813;3600000;0
27135;6905;77;50;7;1;6;.857;520000;0
27135;6921;82;0;0;0;0;.00nan;0;0
27136;6087;80;91;32;1;31;.969;3600000;0
27136;6093;79;81;41;3;38;.927;3551000;0
27136;6735;79;0;0;0;0;.00nan;0;0
27136;8111;80;0;0;0;0;.00nan;0;0
27137;5090;74;53;4;0;4;1.000;149000;0
27137;5154;83;52;36;5;31;.861;2395000;0
27137;6701;76;33;40;7;33;.825;3420000;0
27137;8364;83;48;6;1;5;.833;1205000;0
27138;6077;65;0;0;0;0;.00nan;0;0
27138;6720;68;33;24;5;19;.792;3652000;0
27138;8179;68;0;0;0;0;.00nan;0;0
27138;8395;65;56;38;6;32;.842;3652000;0
27139;4940;62;58;31;4;27;.871;3900000;0
27139;6799;73;0;0;0;0;.00nan;0;0
27139;7501;62;0;0;0;0;.00nan;0;0
27139;8403;73;44;24;4;20;.833;3891000;0
27140;4919;70;71;19;1;18;.947;3600000;0
27140;5088;78;0;0;0;0;.00nan;0;0
27140;5257;70;0;0;0;0;.00nan;0;0
27140;6916;78;57;35;5;30;.857;3600000;0
27141;5183;69;61;34;4;30;.882;3600000;0
27141;5372;69;0;0;0;0;.00nan;0;0
27141;6664;66;0;0;0;0;.00nan;0;0
27141;8390;66;40;31;5;26;.839;3595000;0
27142;6751;67;87;28;1;27;.964;3600000;0
27142;6945;71;0;0;0;0;.00nan;0;0
27142;8361;71;61;23;3;20;.870;3516000;0
27142;9579;67;0;0;0;0;.00nan;0;0
27143;6093;79;42;10;2;8;.800;635000;0
27143;6735;79;14;25;6;19;.760;2965000;0
27143;7575;81;46;5;1;4;.800;1097000;0
27143;8206;81;24;24;6;18;.750;2503000;0
27144;5107;77;0;0;0;0;.00nan;0;0
27144;6840;82;0;0;0;0;.00nan;0;0
27144;6905;77;61;26;2;24;.923;3552000;0
27144;6921;82;98;34;1;33;.971;3600000;0
27145;3837;75;82;45;3;42;.933;3600000;0
27145;5090;74;0;0;0;0;.00nan;0;0
27145;5348;75;0;0;0;0;.00nan;0;0
27145;7528;74;53;17;2;15;.882;3600000;0
27146;6087;80;0;0;0;0;.00nan;0;0
27146;8111;80;46;28;4;24;.857;3600000;0
27146;8927;63;0;0;0;0;.00nan;0;0
27146;9673;63;75;26;1;25;.962;3600000;0
27147;5154;83;37;28;5;23;.821;3600000;0
27147;6701;76;81;25;1;24;.960;3600000;0
27147;8364;83;0;0;0;0;.00nan;0;0
27147;9564;76;0;0;0;0;.00nan;0;0
27148;5054;72;0;0;0;0;.00nan;0;0
27148;6825;72;69;35;3;32;.914;3600000;0
27148;6945;71;41;32;5;27;.844;3594000;0
27148;8361;71;0;0;0;0;.00nan;0;0
27149;7575;81;67;42;4;38;.905;3900000;0
27149;8206;81;0;0;0;0;.00nan;0;0
27149;8927;63;90;48;4;44;.917;3900000;0
27149;9673;63;0;0;0;0;.00nan;0;0
27150;5088;78;95;39;2;37;.949;3600000;0
27150;6664;66;46;23;4;19;.826;3592000;0
27150;6916;78;0;0;0;0;.00nan;0;0
27150;8390;66;0;0;0;0;.00nan;0;0
27151;5154;83;0;0;0;0;.00nan;0;0
27151;8364;83;66;46;5;41;.891;3559000;0
27151;8927;63;0;0;0;0;.00nan;0;0
27151;9673;63;56;23;3;20;.870;3600000;0
27152;3837;75;0;0;0;0;.00nan;0;0
27152;5348;75;83;25;1;24;.960;3600000;0
27152;6840;82;37;32;6;26;.813;2515000;0
27152;6921;82;66;11;0;11;1.000;1085000;0
27153;6087;80;50;24;4;20;.833;3900000;0
27153;6701;76;40;25;4;21;.840;3900000;0
27153;8111;80;0;0;0;0;.00nan;0;0
27153;9564;76;0;0;0;0;.00nan;0;0
27154;5088;78;0;0;0;0;.00nan;0;0
27154;5377;64;0;0;0;0;.00nan;0;0
27154;6916;78;95;34;1;33;.971;3600000;0
27154;9850;65;64;22;2;20;.909;3570000;0
27155;5054;72;0;0;0;0;.00nan;0;0
27155;6825;72;90;39;3;36;.923;3600000;0
27155;6945;71;0;0;0;0;.00nan;0;0
27155;8361;71;53;25;4;21;.840;3543000;0
27156;6087;80;0;0;0;0;.00nan;0;0
27156;6701;76;0;0;0;0;.00nan;0;0
27156;8111;80;60;19;2;17;.895;3600000;0
27156;9564;76;64;37;3;34;.919;3590000;0
27157;5088;78;68;42;4;38;.905;3600000;0
27157;6077;65;62;19;1;18;.947;3600000;0
27157;6916;78;0;0;0;0;.00nan;0;0
27157;8395;65;0;0;0;0;.00nan;0;0
27158;4919;70;0;0;0;0;.00nan;0;0
27158;5257;70;77;38;3;35;.921;3600000;0
27158;6945;71;45;11;2;9;.818;1383000;0
27158;8361;71;21;23;6;17;.739;2217000;0
27159;5054;72;80;29;1;28;.966;3600000;0
27159;5377;64;47;22;3;19;.864;3536000;0
27159;6825;72;0;0;0;0;.00nan;0;0
27159;9850;65;0;0;0;0;.00nan;0;0
27160;5183;69;0;0;0;0;.00nan;0;0
27160;5372;69;99;32;1;31;.969;3600000;0
27160;6751;67;63;30;2;28;.933;3600000;0
27160;9579;67;0;0;0;0;.00nan;0;0
27161;4940;62;0;0;0;0;.00nan;0;0
27161;6799;73;46;16;4;12;.750;3600000;0
27161;7501;62;26;29;6;23;.793;3558000;0
27161;8403;73;0;0;0;0;.00nan;0;0
27162;3837;75;0;0;0;0;.00nan;0;0
27162;5348;75;73;40;4;36;.900;3675000;0
27162;6087;80;63;26;3;23;.885;3675000;0
27162;8111;80;0;0;0;0;.00nan;0;0
27163;5154;83;26;6;3;3;.500;389000;0
27163;6840;82;0;0;0;0;.00nan;0;0
27163;6921;82;70;20;1;19;.950;3600000;0
27163;8364;83;69;40;4;36;.900;3211000;0
27164;5107;77;53;32;5;27;.844;3566000;0
27164;6701;76;56;33;4;29;.879;3600000;0
27164;6905;77;0;0;0;0;.00nan;0;0
27164;9564;76;0;0;0;0;.00nan;0;0
27165;6093;79;85;31;1;30;.968;3600000;0
27165;6735;79;0;0;0;0;.00nan;0;0
27165;8927;63;0;0;0;0;.00nan;0;0
27165;9673;63;48;34;5;29;.853;3600000;0
27166;5090;74;0;0;0;0;.00nan;0;0
27166;7528;74;38;33;6;27;.818;3600000;0
27166;7575;81;0;0;0;0;.00nan;0;0
27166;8206;81;82;30;2;28;.933;3600000;0
27167;5377;64;46;5;1;4;.800;1127000;0
27167;6077;65;0;0;0;0;.00nan;0;0
27167;8395;65;54;38;7;31;.816;3900000;0
27167;9850;65;20;26;6;20;.769;2762000;0
27168;4919;70;48;15;2;13;.867;3600000;0
27168;5257;70;0;0;0;0;.00nan;0;0
27168;6945;71;66;38;3;35;.921;3600000;0
27168;8361;71;0;0;0;0;.00nan;0;0
27169;5054;72;0;0;0;0;.00nan;0;0
27169;6664;66;81;41;4;37;.902;3600000;0
27169;6825;72;34;31;6;25;.806;3577000;0
27169;8390;66;0;0;0;0;.00nan;0;0
27170;5090;74;20;14;5;9;.643;3600000;0
27170;5154;83;59;45;6;39;.867;3600000;0
27170;7528;74;0;0;0;0;.00nan;0;0
27170;8364;83;0;0;0;0;.00nan;0;0
27171;4940;62;50;30;5;25;.833;3558000;0
27171;5183;69;98;39;3;36;.923;3600000;0
27171;5372;69;0;0;0;0;.00nan;0;0
27171;7501;62;0;0;0;0;.00nan;0;0
27172;6720;68;74;27;3;24;.889;3648000;0
27172;6751;67;0;0;0;0;.00nan;0;0
27172;8179;68;0;0;0;0;.00nan;0;0
27172;9579;67;56;19;2;17;.895;3648000;0
27173;3837;75;76;26;2;24;.923;3600000;0
27173;5348;75;0;0;0;0;.00nan;0;0
27173;6087;80;0;0;0;0;.00nan;0;0
27173;8300;80;80;39;3;36;.923;3600000;0
27174;6840;82;65;38;4;34;.895;3600000;0
27174;6921;82;0;0;0;0;.00nan;0;0
27174;8927;63;28;27;6;21;.778;3503000;0
27174;9673;63;50;0;0;0;.00nan;16000;0
27175;6093;79;73;31;2;29;.935;3600000;0
27175;6735;79;0;0;0;0;.00nan;0;0
27175;7575;81;0;0;0;0;.00nan;0;0
27175;8206;81;41;24;5;19;.792;3600000;0
27176;5107;77;38;15;3;12;.800;1787000;0
27176;6701;76;0;0;0;0;.00nan;0;0
27176;6905;77;60;15;2;13;.867;1813000;0
27176;9564;76;67;26;2;24;.923;3600000;0
27177;6720;68;0;0;0;0;.00nan;0;0
27177;6799;73;0;0;0;0;.00nan;0;0
27177;8179;68;54;27;4;23;.852;3600000;0
27177;8403;73;66;21;1;20;.952;3600000;0
27178;3837;75;0;0;0;0;.00nan;0;0
27178;5107;77;0;0;0;0;.00nan;0;0
27178;5348;75;69;31;3;28;.903;3568000;0
27178;6865;77;80;27;1;26;.963;3600000;0
27179;5090;74;0;0;0;0;.00nan;0;0
27179;5154;83;39;1;1;0;.000;515000;0
27179;7528;74;51;20;3;17;.850;3600000;0
27179;8364;83;41;41;6;35;.854;3085000;0
27180;6093;79;0;0;0;0;.00nan;0;0
27180;6735;79;88;29;1;28;.966;3600000;0
27180;7575;81;49;26;3;23;.885;3538000;0
27180;8206;81;0;0;0;0;.00nan;0;0
27181;5054;72;19;14;5;9;.643;2235000;0
27181;6664;66;0;0;0;0;.00nan;0;0
27181;6825;72;48;13;2;11;.846;1365000;0
27181;8390;66;86;25;1;24;.960;3600000;0
27182;6077;65;50;21;3;18;.857;3556000;0
27182;6751;67;80;35;1;34;.971;3600000;0
27182;8395;65;0;0;0;0;.00nan;0;0
27182;9579;67;0;0;0;0;.00nan;0;0
27183;6799;73;63;21;2;19;.905;3600000;0
27183;6945;71;0;0;0;0;.00nan;0;0
27183;8361;71;81;47;4;43;.915;3514000;0
27183;8403;73;0;0;0;0;.00nan;0;0
27184;6840;82;0;0;0;0;.00nan;0;0
27184;6921;82;81;29;1;28;.966;3600000;0
27184;7575;81;0;0;0;0;.00nan;0;0
27184;8206;81;50;31;5;26;.839;3600000;0
27185;5107;77;0;0;0;0;.00nan;0;0
27185;6865;77;82;43;3;40;.930;3600000;0
27185;7575;81;74;25;2;23;.920;3600000;0
27185;8206;81;0;0;0;0;.00nan;0;0
27186;4940;62;83;31;2;29;.935;3600000;0
27186;6799;73;0;0;0;0;.00nan;0;0
27186;7501;62;0;0;0;0;.00nan;0;0
27186;8403;73;50;26;3;23;.885;3567000;0
27187;6751;67;0;0;0;0;.00nan;0;0
27187;8927;63;0;0;0;0;.00nan;0;0
27187;9579;67;70;49;5;44;.898;3600000;0
27187;9673;63;76;29;2;27;.931;3600000;0
27188;4919;70;0;0;0;0;.00nan;0;0
27188;5257;70;54;29;4;25;.862;3900000;0
27188;6720;68;57;25;4;21;.840;3900000;0
27188;8179;68;0;0;0;0;.00nan;0;0
27189;6077;65;86;26;1;25;.962;3600000;0
27189;6945;71;0;0;0;0;.00nan;0;0
27189;8361;71;64;36;4;32;.889;3600000;0
27189;8395;65;0;0;0;0;.00nan;0;0
27190;5377;64;63;25;3;22;.880;3385000;0
27190;6701;76;44;25;5;20;.800;3600000;0
27190;9564;76;0;0;0;0;.00nan;0;0
27190;9850;65;26;5;3;2;.400;159000;0
27191;5154;83;0;0;0;0;.00nan;0;0
27191;6087;80;77;28;2;26;.929;3600000;0
27191;8300;80;0;0;0;0;.00nan;0;0
27191;8364;83;63;35;4;31;.886;3518000;0
27192;3837;75;0;0;0;0;.00nan;0;0
27192;5088;78;59;29;3;26;.897;3600000;0
27192;5348;75;68;39;4;35;.897;3600000;0
27192;6916;78;0;0;0;0;.00nan;0;0
27193;5090;74;0;0;0;0;.00nan;0;0
27193;6093;79;50;39;7;32;.821;3378000;0
27193;6735;79;44;4;1;3;.750;222000;0
27193;7528;74;61;20;2;18;.900;3600000;0
27194;6077;65;0;0;0;0;.00nan;0;0
27194;6945;71;88;42;2;40;.952;3600000;0
27194;8361;71;0;0;0;0;.00nan;0;0
27194;8395;65;17;22;6;16;.727;3600000;0
27195;4940;62;0;0;0;0;.00nan;0;0
27195;6720;68;0;0;0;0;.00nan;0;0
27195;7501;62;73;24;1;23;.958;3600000;0
27195;8179;68;48;34;5;29;.853;3600000;0
27196;4919;70;90;43;2;41;.953;3600000;0
27196;5257;70;0;0;0;0;.00nan;0;0
27196;6799;73;35;27;5;22;.815;3600000;0
27196;8403;73;0;0;0;0;.00nan;0;0
27197;5377;64;54;3;0;3;1.000;241000;0
27197;6751;67;47;28;4;24;.857;3600000;0
27197;9579;67;0;0;0;0;.00nan;0;0
27197;9850;65;29;37;7;30;.811;3359000;0
27198;6664;66;0;0;0;0;.00nan;0;0
27198;6701;76;0;0;0;0;.00nan;0;0
27198;8390;66;85;30;1;29;.967;3600000;0
27198;9564;76;59;18;2;16;.889;3560000;0
27199;5054;72;52;2;0;2;1.000;344000;0
27199;5183;69;0;0;0;0;.00nan;0;0
27199;5372;69;75;40;4;36;.900;3895000;0
27199;6825;72;52;37;4;33;.892;3556000;0
27200;5154;83;81;30;1;29;.967;3600000;0
27200;6093;79;71;41;4;37;.902;3600000;0
27200;6735;79;0;0;0;0;.00nan;0;0
27200;8364;83;0;0;0;0;.00nan;0;0
27201;3837;75;66;26;2;24;.923;3600000;0
27201;5088;78;0;0;0;0;.00nan;0;0
27201;5348;75;0;0;0;0;.00nan;0;0
27201;6916;78;69;27;3;24;.889;3566000;0
27202;5090;74;59;15;1;14;.933;3600000;0
27202;5107;77;78;49;4;45;.918;3600000;0
27202;6865;77;0;0;0;0;.00nan;0;0
27202;7528;74;0;0;0;0;.00nan;0;0
27203;6087;80;45;21;4;17;.810;2719000;0
27203;6840;82;0;0;0;0;.00nan;0;0
27203;6921;82;59;28;3;25;.893;3600000;0
27203;8300;80;14;6;4;2;.333;881000;0
27204;5054;72;99;44;2;42;.955;3829000;0
27204;5183;69;66;30;3;27;.900;3829000;0
27204;5372;69;0;0;0;0;.00nan;0;0
27204;6825;72;0;0;0;0;.00nan;0;0
27205;4919;70;44;25;4;21;.840;1692000;0
27205;5257;70;25;32;6;26;.813;1908000;0
27205;8927;63;27;14;4;10;.714;1092000;0
27205;9673;63;55;15;2;13;.867;2508000;0
27206;6840;82;72;40;4;36;.900;3662000;0
27206;6921;82;0;0;0;0;.00nan;0;0
27206;7575;81;0;0;0;0;.00nan;0;0
27206;8206;81;72;32;3;29;.906;3662000;0
27207;5090;74;0;0;0;0;.00nan;0;0
27207;5107;77;0;0;0;0;.00nan;0;0
27207;6865;77;88;48;3;45;.938;3600000;0
27207;7528;74;65;15;1;14;.933;3600000;0
27208;6077;65;89;44;4;40;.909;3800000;0
27208;6664;66;47;18;3;15;.833;3800000;0
27208;8390;66;0;0;0;0;.00nan;0;0
27208;8395;65;0;0;0;0;.00nan;0;0
27209;4919;70;0;0;0;0;.00nan;0;0
27209;5257;70;66;19;1;18;.947;3600000;0
27209;6701;76;59;39;6;33;.846;3528000;0
27209;9564;76;48;0;0;0;.00nan;72000;0
27210;6720;68;36;26;5;21;.808;3572000;0
27210;6945;71;47;26;4;22;.846;3600000;0
27210;8179;68;0;0;0;0;.00nan;0;0
27210;8361;71;0;0;0;0;.00nan;0;0
27211;5377;64;0;0;0;0;.00nan;0;0
27211;6799;73;82;27;1;26;.963;3600000;0
27211;8403;73;0;0;0;0;.00nan;0;0
27211;9850;65;66;33;3;30;.909;3578000;0
27212;6087;80;0;0;0;0;.00nan;0;0
27212;6093;79;90;30;1;29;.967;3600000;0
27212;6735;79;0;0;0;0;.00nan;0;0
27212;8300;80;64;31;3;28;.903;3513000;0
27213;4940;62;0;0;0;0;.00nan;0;0
27213;6701;76;22;24;6;18;.750;1662000;0
27213;7501;62;58;18;2;16;.889;3600000;0
27213;9564;76;47;35;5;30;.857;1938000;0
27214;5054;72;0;0;0;0;.00nan;0;0
27214;6664;66;58;22;2;20;.909;3600000;0
27214;6825;72;68;35;3;32;.914;3600000;0
27214;8390;66;0;0;0;0;.00nan;0;0
27215;5183;69;0;0;0;0;.00nan;0;0
27215;5372;69;60;31;4;27;.871;3547000;0
27215;5377;64;64;32;3;29;.906;3600000;0
27215;9850;65;0;0;0;0;.00nan;0;0
27216;3837;75;0;0;0;0;.00nan;0;0
27216;5348;75;61;35;4;31;.886;3514000;0
27216;6840;82;0;0;0;0;.00nan;0;0
27216;6921;82;90;40;2;38;.950;3600000;0
27217;4919;70;36;12;3;9;.750;3900000;0
27217;5257;70;0;0;0;0;.00nan;0;0
27217;6077;65;62;31;3;28;.903;3900000;0
27217;8395;65;0;0;0;0;.00nan;0;0
27218;4940;62;64;22;2;20;.909;3900000;0
27218;6751;67;0;0;0;0;.00nan;0;0
27218;7501;62;0;0;0;0;.00nan;0;0
27218;9579;67;95;49;2;47;.959;3900000;0
27219;6701;76;76;23;1;22;.957;3600000;0
27219;8927;63;0;0;0;0;.00nan;0;0
27219;9564;76;0;0;0;0;.00nan;0;0
27219;9673;63;59;23;2;21;.913;3548000;0
27220;6720;68;52;25;3;22;.880;3600000;0
27220;6945;71;0;0;0;0;.00nan;0;0
27220;8179;68;0;0;0;0;.00nan;0;0
27220;8361;71;82;28;2;26;.929;3600000;0
27221;5054;72;72;32;3;29;.906;3600000;0
27221;5377;64;0;0;0;0;.00nan;0;0
27221;6825;72;0;0;0;0;.00nan;0;0
27221;9850;65;37;29;5;24;.828;3573000;0
27222;5183;69;69;27;2;25;.926;3600000;0
27222;5372;69;0;0;0;0;.00nan;0;0
27222;6664;66;0;0;0;0;.00nan;0;0
27222;8390;66;58;40;5;35;.875;3600000;0
27223;5088;78;36;27;6;21;.778;3246000;0
27223;6087;80;99;38;1;37;.974;3600000;0
27223;6916;78;48;0;0;0;.00nan;354000;0
27223;8300;80;0;0;0;0;.00nan;0;0
27224;5090;74;0;0;0;0;.00nan;0;0
27224;6840;82;60;26;3;23;.885;3846000;0
27224;6921;82;0;0;0;0;.00nan;0;0
27224;7528;74;47;24;4;20;.833;3820000;0
27225;3837;75;0;0;0;0;.00nan;0;0
27225;5107;77;100;42;2;40;.952;3600000;0
27225;5348;75;58;29;3;26;.897;3582000;0
27225;6865;77;0;0;0;0;.00nan;0;0
27226;5154;83;0;0;0;0;.00nan;0;0
27226;7575;81;0;0;0;0;.00nan;0;0
27226;8206;81;53;24;3;21;.875;3600000;0
27226;8364;83;61;32;4;28;.875;3593000;0
27227;5054;72;0;0;0;0;.00nan;0;0
27227;5183;69;0;0;0;0;.00nan;0;0
27227;5372;69;94;41;2;39;.951;3628000;0
27227;6825;72;69;30;3;27;.900;3628000;0
27228;6077;65;0;0;0;0;.00nan;0;0
27228;6701;76;69;18;1;17;.944;1360000;0
27228;8395;65;100;27;0;27;1.000;3600000;0
27228;9564;76;30;25;5;20;.800;2240000;0
27229;4919;70;0;0;0;0;.00nan;0;0
27229;5257;70;64;14;1;13;.929;3600000;0
27229;6751;67;41;32;5;27;.844;3600000;0
27229;9579;67;0;0;0;0;.00nan;0;0
27230;4940;62;0;0;0;0;.00nan;0;0
27230;6945;71;80;38;3;35;.921;3545000;0
27230;7501;62;84;33;1;32;.970;3600000;0
27230;8361;71;0;0;0;0;.00nan;0;0
27231;5154;83;66;29;3;26;.897;3600000;0
27231;6093;79;66;34;4;30;.882;3577000;0
27231;6735;79;0;0;0;0;.00nan;0;0
27231;8364;83;0;0;0;0;.00nan;0;0
27232;6664;66;62;33;3;30;.909;3549000;0
27232;6799;73;0;0;0;0;.00nan;0;0
27232;8390;66;0;0;0;0;.00nan;0;0
27232;8403;73;74;23;1;22;.957;3600000;0
27233;5377;64;40;16;3;13;.813;3600000;0
27233;6720;68;0;0;0;0;.00nan;0;0
27233;8179;68;100;34;0;34;1.000;3600000;0
27233;9850;65;0;0;0;0;.00nan;0;0
27234;3837;75;45;26;4;22;.846;3900000;0
27234;5107;77;0;0;0;0;.00nan;0;0
27234;5348;75;0;0;0;0;.00nan;0;0
27234;6865;77;65;44;4;40;.909;3900000;0
27235;5088;78;62;24;2;22;.917;3600000;0
27235;6087;80;0;0;0;0;.00nan;0;0
27235;6916;78;0;0;0;0;.00nan;0;0
27235;8300;80;41;21;3;18;.857;3596000;0
27236;5090;74;64;33;3;30;.909;3600000;0
27236;6840;82;63;23;2;21;.913;3031000;0
27236;6921;82;23;5;3;2;.400;509000;0
27236;7528;74;0;0;0;0;.00nan;0;0
27237;5154;83;0;0;0;0;.00nan;0;0
27237;6840;82;75;28;1;27;.964;3600000;0
27237;6921;82;0;0;0;0;.00nan;0;0
27237;8364;83;67;27;2;25;.926;3543000;0
27238;5088;78;65;32;3;29;.906;3885000;0
27238;6093;79;0;0;0;0;.00nan;0;0
27238;6735;79;69;42;4;38;.905;3885000;0
27238;6916;78;0;0;0;0;.00nan;0;0
27239;5107;77;67;38;4;34;.895;3591000;0
27239;6087;80;65;28;3;25;.893;3600000;0
27239;6865;77;0;0;0;0;.00nan;0;0
27239;8300;80;0;0;0;0;.00nan;0;0
27240;4919;70;66;30;2;28;.933;1684000;0
27240;5257;70;46;24;4;20;.833;1916000;0
27240;8927;63;91;20;0;20;1.000;3600000;0
27240;9673;63;0;0;0;0;.00nan;0;0
27241;6077;65;0;0;0;0;.00nan;0;0
27241;6664;66;0;0;0;0;.00nan;0;0
27241;8390;66;48;28;4;24;.857;3520000;0
27241;8395;65;100;47;2;45;.957;3600000;0
27242;4940;62;76;27;2;25;.926;3600000;0
27242;6720;68;0;0;0;0;.00nan;0;0
27242;7501;62;0;0;0;0;.00nan;0;0
27242;8179;68;65;42;4;38;.905;3583000;0
27243;5183;69;44;3;1;2;.667;510000;0
27243;5372;69;49;49;8;41;.837;3090000;0
27243;6751;67;56;26;3;23;.885;3600000;0
27243;9579;67;0;0;0;0;.00nan;0;0
27244;5088;78;0;0;0;0;.00nan;0;0
27244;6093;79;56;31;4;27;.871;3600000;0
27244;6735;79;0;0;0;0;.00nan;0;0
27244;6916;78;96;23;0;23;1.000;3600000;0
27245;6945;71;64;41;4;37;.902;3600000;0
27245;8361;71;0;0;0;0;.00nan;0;0
27245;8927;63;90;31;1;30;.968;3600000;0
27245;9673;63;0;0;0;0;.00nan;0;0
27246;5377;64;0;0;0;0;.00nan;0;0
27246;6720;68;73;42;4;38;.905;3547000;0
27246;8179;68;0;0;0;0;.00nan;0;0
27246;9850;65;69;24;2;22;.917;3600000;0
27247;4940;62;52;17;3;14;.824;3600000;0
27247;5054;72;81;52;4;48;.923;3571000;0
27247;6825;72;0;0;0;0;.00nan;0;0
27247;7501;62;0;0;0;0;.00nan;0;0
27248;5183;69;0;0;0;0;.00nan;0;0
27248;5372;69;91;41;3;38;.927;3551000;0
27248;6799;73;59;9;1;8;.889;3600000;0
27248;8403;73;0;0;0;0;.00nan;0;0
27249;5090;74;0;0;0;0;.00nan;0;0
27249;5154;83;59;45;5;40;.889;3600000;0
27249;7528;74;68;23;2;21;.913;3600000;0
27249;8364;83;0;0;0;0;.00nan;0;0
27250;6087;80;69;36;4;32;.889;3600000;0
27250;7575;81;1;26;8;18;.692;3185000;0
27250;8206;81;50;1;0;1;1.000;415000;0
27250;8300;80;0;0;0;0;.00nan;0;0
27251;3837;75;0;0;0;0;.00nan;0;0
27251;5348;75;70;37;3;34;.919;3600000;0
27251;6701;76;82;30;2;28;.933;3600000;0
27251;9564;76;0;0;0;0;.00nan;0;0
27252;4919;70;80;26;1;25;.962;3600000;0
27252;5257;70;0;0;0;0;.00nan;0;0
27252;6077;65;54;27;4;23;.852;3600000;0
27252;8395;65;0;0;0;0;.00nan;0;0
27253;6945;71;0;0;0;0;.00nan;0;0
27253;8361;71;85;54;4;50;.926;3600000;0
27253;8927;63;0;0;0;0;.00nan;0;0
27253;9673;63;73;10;0;10;1.000;3600000;0
27254;6664;66;0;0;0;0;.00nan;0;0
27254;6720;68;25;31;7;24;.774;2389000;0
27254;8179;68;49;17;2;15;.882;1211000;0
27254;8390;66;58;17;2;15;.882;3600000;0
27255;4940;62;0;0;0;0;.00nan;0;0
27255;6751;67;0;0;0;0;.00nan;0;0
27255;7501;62;37;13;3;10;.769;3600000;0
27255;9579;67;35;30;5;25;.833;3563000;0
27256;5054;72;0;0;0;0;.00nan;0;0
27256;5183;69;18;8;4;4;.500;1064000;0
27256;5372;69;45;12;2;10;.833;2536000;0
27256;6825;72;99;40;1;39;.975;3600000;0
27257;6093;79;48;0;0;0;.00nan;377000;0
27257;6735;79;47;41;6;35;.854;3223000;0
27257;7575;81;0;0;0;0;.00nan;0;0
27257;8206;81;39;8;2;6;.750;3600000;0
27258;5088;78;0;0;0;0;.00nan;0;0
27258;5107;77;100;48;0;48;1.000;3600000;0
27258;6865;77;0;0;0;0;.00nan;0;0
27258;6916;78;42;19;3;16;.842;3600000;0
27259;5090;74;55;28;3;25;.893;3555000;0
27259;5154;83;0;0;0;0;.00nan;0;0
27259;7528;74;0;0;0;0;.00nan;0;0
27259;8364;83;77;26;1;25;.962;3600000;0
27260;6087;80;0;0;0;0;.00nan;0;0
27260;6840;82;43;11;2;9;.818;1590000;0
27260;6921;82;15;20;6;14;.700;2010000;0
27260;8300;80;99;27;0;27;1.000;3600000;0
27261;3837;75;83;42;3;39;.929;3900000;0
27261;5348;75;0;0;0;0;.00nan;0;0
27261;6701;76;0;0;0;0;.00nan;0;0
27261;9564;76;54;30;3;27;.900;3900000;0
27262;4919;70;0;0;0;0;.00nan;0;0
27262;5257;70;72;29;2;27;.931;3600000;0
27262;6077;65;67;13;1;12;.923;1269000;0
27262;8395;65;58;32;4;28;.875;2331000;0
27263;5054;72;78;25;1;24;.960;3551000;0
27263;6751;67;100;35;0;35;1.000;3600000;0
27263;6825;72;0;0;0;0;.00nan;0;0
27263;9579;67;0;0;0;0;.00nan;0;0
27264;3837;75;0;0;0;0;.00nan;0;0
27264;5107;77;59;25;3;22;.880;3580000;0
27264;5348;75;100;45;2;43;.956;3600000;0
27264;6865;77;0;0;0;0;.00nan;0;0
27265;5088;78;60;27;3;24;.889;3841000;0
27265;6093;79;61;33;4;29;.879;3841000;0
27265;6735;79;0;0;0;0;.00nan;0;0
27265;6916;78;0;0;0;0;.00nan;0;0
27266;6840;82;70;44;4;40;.909;3600000;0
27266;6921;82;0;0;0;0;.00nan;0;0
27266;7575;81;28;24;5;19;.792;3542000;0
27266;8206;81;0;0;0;0;.00nan;0;0
27267;6720;68;53;33;4;29;.879;3557000;0
27267;8179;68;0;0;0;0;.00nan;0;0
27267;8927;63;0;0;0;0;.00nan;0;0
27267;9673;63;51;14;2;12;.857;3600000;0
27268;5183;69;0;0;0;0;.00nan;0;0
27268;5372;69;53;30;4;26;.867;3570000;0
27268;6701;76;90;38;2;36;.947;3600000;0
27268;9564;76;0;0;0;0;.00nan;0;0
27269;4919;70;71;34;3;31;.912;3900000;0
27269;5257;70;0;0;0;0;.00nan;0;0
27269;5377;64;66;29;3;26;.897;3900000;0
27269;9850;65;0;0;0;0;.00nan;0;0
27270;6664;66;59;16;1;15;.938;3600000;0
27270;6945;71;0;0;0;0;.00nan;0;0
27270;8361;71;73;35;3;32;.914;3553000;0
27270;8390;66;0;0;0;0;.00nan;0;0
27271;5054;72;100;49;2;47;.959;3600000;0
27271;6825;72;0;0;0;0;.00nan;0;0
27271;8927;63;56;23;3;20;.870;3600000;0
27271;9673;63;0;0;0;0;.00nan;0;0
27272;5107;77;0;0;0;0;.00nan;0;0
27272;5183;69;100;23;0;23;1.000;3600000;0
27272;5372;69;0;0;0;0;.00nan;0;0
27272;6865;77;56;22;2;20;.909;3567000;0
27273;5090;74;0;0;0;0;.00nan;0;0
27273;6087;80;0;0;0;0;.00nan;0;0
27273;7528;74;51;35;5;30;.857;3600000;0
27273;8300;80;63;23;2;21;.913;3600000;0
27274;6077;65;0;0;0;0;.00nan;0;0
27274;6840;82;0;0;0;0;.00nan;0;0
27274;6921;82;37;18;4;14;.778;3600000;0
27274;8395;65;43;34;5;29;.853;3565000;0
27275;4940;62;55;17;2;15;.882;3900000;0
27275;6945;71;100;54;2;52;.963;3900000;0
27275;7501;62;0;0;0;0;.00nan;0;0
27275;8361;71;0;0;0;0;.00nan;0;0
27276;4919;70;0;0;0;0;.00nan;0;0
27276;5257;70;55;15;2;13;.867;3600000;0
27276;5377;64;55;4;0;4;1.000;774000;0
27276;9850;65;36;33;6;27;.818;2826000;0
27277;6664;66;0;0;0;0;.00nan;0;0
27277;6751;67;95;34;1;33;.971;3600000;0
27277;8390;66;37;19;4;15;.789;3600000;0
27277;9579;67;0;0;0;0;.00nan;0;0
27278;6799;73;69;32;3;29;.906;3600000;0
27278;8403;73;0;0;0;0;.00nan;0;0
27278;8927;63;0;0;0;0;.00nan;0;0
27278;9673;63;66;31;4;27;.871;3561000;0
27279;3837;75;0;0;0;0;.00nan;0;0
27279;5183;69;48;15;2;13;.867;3545000;0
27279;5348;75;85;29;1;28;.966;3600000;0
27279;5372;69;0;0;0;0;.00nan;0;0
27280;5154;83;0;0;0;0;.00nan;0;0
27280;6840;82;61;36;4;32;.889;3831000;0
27280;6921;82;0;0;0;0;.00nan;0;0
27280;8364;83;78;31;3;28;.903;3831000;0
27281;6077;65;48;34;5;29;.853;3900000;0
27281;6087;80;47;38;5;33;.868;3900000;0
27281;8300;80;0;0;0;0;.00nan;0;0
27281;8395;65;0;0;0;0;.00nan;0;0
27282;5107;77;100;29;0;29;1.000;3600000;0
27282;6701;76;81;43;4;39;.907;3600000;0
27282;6865;77;0;0;0;0;.00nan;0;0
27282;9564;76;0;0;0;0;.00nan;0;0
27283;6093;79;0;0;0;0;.00nan;0;0
27283;6735;79;82;39;3;36;.923;3900000;0
27283;7575;81;0;0;0;0;.00nan;0;0
27283;8206;81;69;28;3;25;.893;3900000;0
27284;4940;62;0;0;0;0;.00nan;0;0
27284;5377;64;0;0;0;0;.00nan;0;0
27284;7501;62;49;15;3;12;.800;3600000;0
27284;9850;65;60;45;6;39;.867;3600000;0
27285;4919;70;73;22;1;21;.955;3600000;0
27285;5257;70;0;0;0;0;.00nan;0;0
27285;6945;71;0;0;0;0;.00nan;0;0
27285;8361;71;86;46;3;43;.935;3565000;0
27286;6664;66;86;30;1;29;.967;3600000;0
27286;6751;67;46;19;3;16;.842;2453000;0
27286;8390;66;0;0;0;0;.00nan;0;0
27286;9579;67;30;14;4;10;.714;1147000;0
27287;6720;68;74;51;6;45;.882;3600000;0
27287;6799;73;0;0;0;0;.00nan;0;0
27287;8179;68;0;0;0;0;.00nan;0;0
27287;8403;73;46;20;3;17;.850;3600000;0
27288;5107;77;72;47;5;42;.894;3600000;0
27288;6093;79;97;23;0;23;1.000;3600000;0
27288;6735;79;0;0;0;0;.00nan;0;0
27288;6905;77;0;0;0;0;.00nan;0;0
27289;3837;75;100;42;0;42;1.000;3600000;0
27289;5348;75;0;0;0;0;.00nan;0;0
27289;6701;76;0;0;0;0;.00nan;0;0
27289;9564;76;84;23;1;22;.957;3600000;0
27290;5054;72;0;0;0;0;.00nan;0;0
27290;5088;78;99;29;1;28;.966;3600000;0
27290;6825;72;77;38;4;34;.895;3600000;0
27290;6916;78;0;0;0;0;.00nan;0;0
27291;5090;74;0;0;0;0;.00nan;0;0
27291;5183;69;41;17;3;14;.824;1177000;0
27291;5372;69;27;28;6;22;.786;2423000;0
27291;7528;74;82;28;2;26;.929;3600000;0
27292;6087;80;0;0;0;0;.00nan;0;0
27292;6840;82;0;0;0;0;.00nan;0;0
27292;6921;82;67;27;3;24;.889;3900000;0
27292;8300;80;57;27;3;24;.889;3900000;0
27293;5154;83;100;35;0;35;1.000;3600000;0
27293;7575;81;67;19;1;18;.947;3588000;0
27293;8206;81;0;0;0;0;.00nan;0;0
27293;8364;83;0;0;0;0;.00nan;0;0
27294;5154;83;63;16;1;15;.938;3600000;0
27294;6077;65;0;0;0;0;.00nan;0;0
27294;8364;83;0;0;0;0;.00nan;0;0
27294;8395;65;57;42;6;36;.857;3600000;0
27295;5377;64;57;16;1;15;.938;1646000;0
27295;8927;63;0;0;0;0;.00nan;0;0
27295;9673;63;45;20;3;17;.850;3600000;0
27295;9850;65;24;23;6;17;.739;1954000;0
27296;6664;66;53;28;3;25;.893;3900000;0
27296;6720;68;66;32;3;29;.906;3900000;0
27296;8179;68;0;0;0;0;.00nan;0;0
27296;8390;66;0;0;0;0;.00nan;0;0
27297;6751;67;0;0;0;0;.00nan;0;0
27297;6799;73;92;22;0;22;1.000;3600000;0
27297;8403;73;0;0;0;0;.00nan;0;0
27297;9579;67;70;44;4;40;.909;3600000;0
27298;3837;75;24;12;4;8;.667;670000;0
27298;5348;75;69;27;2;25;.926;2930000;0
27298;6701;76;58;21;2;19;.905;3600000;0
27298;9564;76;0;0;0;0;.00nan;0;0
27299;5088;78;71;36;3;33;.917;3600000;0
27299;5183;69;0;0;0;0;.00nan;0;0
27299;5372;69;67;37;4;33;.892;3548000;0
27299;6916;78;0;0;0;0;.00nan;0;0
27300;5107;77;71;20;1;19;.950;2094000;0
27300;6093;79;58;48;6;42;.875;3566000;0
27300;6735;79;0;0;0;0;.00nan;0;0
27300;6905;77;31;13;4;9;.692;1506000;0
27301;5054;72;52;36;5;31;.861;3600000;0
27301;5090;74;0;0;0;0;.00nan;0;0
27301;6825;72;0;0;0;0;.00nan;0;0
27301;7528;74;59;18;2;16;.889;3600000;0
27302;4940;62;74;23;1;22;.957;3600000;0
27302;7501;62;0;0;0;0;.00nan;0;0
27302;8927;63;72;28;2;26;.929;3551000;0
27302;9673;63;0;0;0;0;.00nan;0;0
27303;6077;65;0;0;0;0;.00nan;0;0
27303;6093;79;0;0;0;0;.00nan;0;0
27303;6735;79;81;36;2;34;.944;3591000;0
27303;8395;65;71;19;1;18;.947;3600000;0
27304;6087;80;47;40;6;34;.850;2387000;0
27304;6945;71;74;27;2;25;.926;3600000;0
27304;8300;80;47;7;1;6;.857;1213000;0
27304;8361;71;0;0;0;0;.00nan;0;0
27305;6664;66;99;45;1;44;.978;3600000;0
27305;6799;73;62;22;2;20;.909;3557000;0
27305;8390;66;0;0;0;0;.00nan;0;0
27305;8403;73;0;0;0;0;.00nan;0;0
27306;6751;67;49;28;4;24;.857;3600000;0
27306;6840;82;50;0;0;0;.00nan;55000;0
27306;6921;82;42;40;6;34;.850;3459000;0
27306;9579;67;0;0;0;0;.00nan;0;0
27307;6077;65;73;31;3;28;.903;3600000;0
27307;7575;81;47;6;1;5;.833;827000;0
27307;8206;81;26;27;6;21;.778;2773000;0
27307;8395;65;0;0;0;0;.00nan;0;0
27308;5054;72;0;0;0;0;.00nan;0;0
27308;6701;76;0;0;0;0;.00nan;0;0
27308;6825;72;100;27;0;27;1.000;3600000;0
27308;9564;76;49;32;4;28;.875;3600000;0
27309;4919;70;0;0;0;0;.00nan;0;0
27309;5257;70;78;31;2;29;.935;3600000;0
27309;8927;63;0;0;0;0;.00nan;0;0
27309;9673;63;39;32;6;26;.813;3600000;0
27310;6840;82;37;16;3;13;.813;3600000;0
27310;6921;82;0;0;0;0;.00nan;0;0
27310;6945;71;0;0;0;0;.00nan;0;0
27310;8361;71;76;47;4;43;.915;3597000;0
27311;5377;64;0;0;0;0;.00nan;0;0
27311;6799;73;0;0;0;0;.00nan;0;0
27311;8403;73;49;20;4;16;.800;3600000;0
27311;9850;65;69;39;5;34;.872;3544000;0
27312;6077;65;0;0;0;0;.00nan;0;0
27312;6751;67;0;0;0;0;.00nan;0;0
27312;8395;65;55;33;5;28;.848;3525000;0
27312;9579;67;67;30;3;27;.900;3600000;0
27313;6087;80;0;0;0;0;.00nan;0;0
27313;6720;68;77;27;2;25;.926;3600000;0
27313;8179;68;0;0;0;0;.00nan;0;0
27313;8300;80;52;25;4;21;.840;3546000;0
27314;5154;83;0;0;0;0;.00nan;0;0
27314;6093;79;60;29;3;26;.897;3600000;0
27314;6735;79;0;0;0;0;.00nan;0;0
27314;8364;83;98;28;0;28;1.000;3600000;0
27315;5090;74;0;0;0;0;.00nan;0;0
27315;6701;76;23;4;3;1;.250;244000;0
27315;7528;74;73;18;1;17;.944;3600000;0
27315;9564;76;37;29;5;24;.828;3356000;0
27316;5054;72;56;21;2;19;.905;3562000;0
27316;5107;77;100;36;1;35;.972;3600000;0
27316;6825;72;0;0;0;0;.00nan;0;0
27316;6905;77;0;0;0;0;.00nan;0;0
27317;5088;78;86;35;2;33;.943;3600000;0
27317;6916;78;0;0;0;0;.00nan;0;0
27317;7575;81;39;9;2;7;.778;1847000;0
27317;8206;81;13;18;6;12;.667;1753000;0
27318;6799;73;88;38;3;35;.921;3600000;0
27318;8403;73;0;0;0;0;.00nan;0;0
27318;8927;63;64;23;2;21;.913;3600000;0
27318;9673;63;0;0;0;0;.00nan;0;0
27319;4919;70;100;22;0;22;1.000;3600000;0
27319;5257;70;0;0;0;0;.00nan;0;0
27319;6945;71;63;31;4;27;.871;3600000;0
27319;8361;71;0;0;0;0;.00nan;0;0
27320;4940;62;65;25;2;23;.920;3560000;0
27320;5377;64;99;35;1;34;.971;3600000;0
27320;7501;62;0;0;0;0;.00nan;0;0
27320;9850;65;0;0;0;0;.00nan;0;0
27321;5183;69;0;0;0;0;.00nan;0;0
27321;5372;69;84;32;1;31;.969;3719000;0
27321;6087;80;83;34;2;32;.941;3719000;0
27321;8300;80;0;0;0;0;.00nan;0;0
27322;5154;83;0;0;0;0;.00nan;0;0
27322;6093;79;0;0;0;0;.00nan;0;0
27322;6735;79;91;36;3;33;.917;3600000;0
27322;8364;83;33;27;6;21;.778;3600000;0
27323;6720;68;60;25;2;23;.920;3600000;0
27323;6840;82;48;0;0;0;.00nan;209000;0
27323;6921;82;50;42;6;36;.857;3391000;0
27323;8179;68;0;0;0;0;.00nan;0;0
27324;3837;75;0;0;0;0;.00nan;0;0
27324;5054;72;0;0;0;0;.00nan;0;0
27324;5348;75;66;26;2;24;.923;3600000;0
27324;6825;72;41;31;5;26;.839;3600000;0
27325;5107;77;51;10;1;9;.900;1265000;0
27325;6905;77;44;35;5;30;.857;2335000;0
27325;7575;81;0;0;0;0;.00nan;0;0
27325;8206;81;64;14;1;13;.929;3600000;0
27326;5090;74;42;22;4;18;.818;3900000;0
27326;6701;76;86;57;4;53;.930;3900000;0
27326;7528;74;0;0;0;0;.00nan;0;0
27326;9564;76;0;0;0;0;.00nan;0;0
27327;5377;64;77;29;2;27;.931;2882000;0
27327;8927;63;0;0;0;0;.00nan;0;0
27327;9673;63;20;17;5;12;.706;3600000;0
27327;9850;65;18;10;4;6;.600;700000;0
27328;5154;83;50;33;5;28;.848;3900000;0
27328;7575;81;60;37;5;32;.865;3900000;0
27328;8206;81;0;0;0;0;.00nan;0;0
27328;8364;83;0;0;0;0;.00nan;0;0
27329;5088;78;0;0;0;0;.00nan;0;0
27329;6093;79;77;48;4;44;.917;3600000;0
27329;6735;79;0;0;0;0;.00nan;0;0
27329;6916;78;53;19;3;16;.842;3600000;0
27330;6664;66;65;39;5;34;.872;3587000;0
27330;6799;73;0;0;0;0;.00nan;0;0
27330;8390;66;0;0;0;0;.00nan;0;0
27330;8403;73;58;25;3;22;.880;3600000;0
27331;5088;78;88;40;2;38;.950;3600000;0
27331;5090;74;0;0;0;0;.00nan;0;0
27331;6916;78;0;0;0;0;.00nan;0;0
27331;7528;74;58;27;3;24;.889;3543000;0
27332;5377;64;0;0;0;0;.00nan;0;0
27332;6945;71;23;23;6;17;.739;2208000;0
27332;8361;71;65;9;0;9;1.000;1392000;0
27332;9850;65;35;38;7;31;.816;3548000;0
27333;5088;78;0;0;0;0;.00nan;0;0
27333;5090;74;90;19;0;19;1.000;3600000;0
27333;6916;78;98;57;4;53;.930;3600000;0
27333;7528;74;0;0;0;0;.00nan;0;0
27334;6087;80;48;43;6;37;.860;3600000;0
27334;7575;81;0;0;0;0;.00nan;0;0
27334;8206;81;80;25;1;24;.960;3600000;0
27334;8300;80;0;0;0;0;.00nan;0;0
27335;5054;72;0;0;0;0;.00nan;0;0
27335;6664;66;0;0;0;0;.00nan;0;0
27335;6825;72;67;44;5;39;.886;3600000;0
27335;8390;66;56;22;2;20;.909;3600000;0
27336;6077;65;51;34;4;30;.882;3600000;0
27336;6945;71;0;0;0;0;.00nan;0;0
27336;8361;71;46;30;5;25;.833;3591000;0
27336;8395;65;0;0;0;0;.00nan;0;0
27337;6720;68;62;29;3;26;.897;3600000;0
27337;8179;68;0;0;0;0;.00nan;0;0
27337;8927;63;0;0;0;0;.00nan;0;0
27337;9673;63;58;39;5;34;.872;3600000;0
27338;4919;70;75;32;2;30;.938;3600000;0
27338;4940;62;51;34;5;29;.853;2204000;0
27338;5257;70;0;0;0;0;.00nan;0;0
27338;7501;62;37;15;3;12;.800;1396000;0
27339;5054;72;90;39;2;37;.949;3600000;0
27339;5377;64;47;27;4;23;.852;3517000;0
27339;6825;72;0;0;0;0;.00nan;0;0
27339;9850;65;0;0;0;0;.00nan;0;0
27340;6751;67;64;41;4;37;.902;3900000;0
27340;6799;73;50;27;4;23;.852;3900000;0
27340;8403;73;0;0;0;0;.00nan;0;0
27340;9579;67;0;0;0;0;.00nan;0;0
27341;5183;69;73;28;2;26;.929;3600000;0
27341;5372;69;0;0;0;0;.00nan;0;0
27341;6664;66;66;36;3;33;.917;3546000;0
27341;8390;66;0;0;0;0;.00nan;0;0
27342;3837;75;0;0;0;0;.00nan;0;0
27342;5088;78;100;23;0;23;1.000;3600000;0
27342;5348;75;49;26;4;22;.846;3600000;0
27342;6916;78;0;0;0;0;.00nan;0;0
27343;5090;74;39;37;6;31;.838;3755000;0
27343;7528;74;0;0;0;0;.00nan;0;0
27343;7575;81;44;46;7;39;.848;3732000;0
27343;8206;81;0;0;0;0;.00nan;0;0
27344;6093;79;0;0;0;0;.00nan;0;0
27344;6735;79;60;28;3;25;.893;3591000;0
27344;6840;82;66;19;2;17;.895;3600000;0
27344;6921;82;0;0;0;0;.00nan;0;0
27345;5154;83;63;26;2;24;.923;3600000;0
27345;6087;80;45;30;5;25;.833;3600000;0
27345;8300;80;0;0;0;0;.00nan;0;0
27345;8364;83;0;0;0;0;.00nan;0;0
27346;5107;77;86;34;2;32;.941;3600000;0
27346;6701;76;64;37;4;33;.892;3584000;0
27346;6905;77;0;0;0;0;.00nan;0;0
27346;9564;76;0;0;0;0;.00nan;0;0
27347;4919;70;0;0;0;0;.00nan;0;0
27347;4940;62;0;0;0;0;.00nan;0;0
27347;5257;70;70;25;2;23;.920;3600000;0
27347;7501;62;55;33;5;28;.848;3600000;0
27348;6077;65;0;0;0;0;.00nan;0;0
27348;6945;71;66;33;4;29;.879;3600000;0
27348;8361;71;0;0;0;0;.00nan;0;0
27348;8395;65;33;24;5;19;.792;3600000;0
27349;5377;64;0;0;0;0;.00nan;0;0
27349;6751;67;64;14;0;14;1.000;3042000;0
27349;9579;67;21;9;4;5;.556;558000;0
27349;9850;65;71;37;3;34;.919;3600000;0
27350;5183;69;0;0;0;0;.00nan;0;0
27350;5372;69;47;27;4;23;.852;3600000;0
27350;6799;73;0;0;0;0;.00nan;0;0
27350;8403;73;35;37;7;30;.811;3600000;0
27351;5154;83;0;0;0;0;.00nan;0;0
27351;6093;79;64;32;4;28;.875;3600000;0
27351;6735;79;0;0;0;0;.00nan;0;0
27351;8364;83;90;36;1;35;.972;3600000;0
27352;6720;68;73;35;3;32;.914;2430000;0
27352;8179;68;31;12;4;8;.667;1170000;0
27352;8927;63;57;26;3;23;.885;3600000;0
27352;9673;63;0;0;0;0;.00nan;0;0
27353;3837;75;69;30;2;28;.933;3600000;0
27353;5088;78;54;26;3;23;.885;3594000;0
27353;5348;75;0;0;0;0;.00nan;0;0
27353;6916;78;0;0;0;0;.00nan;0;0
27354;6087;80;49;14;2;12;.857;1508000;0
27354;6840;82;0;0;0;0;.00nan;0;0
27354;6921;82;88;33;1;32;.970;3600000;0
27354;8300;80;27;21;5;16;.762;2092000;0
27355;5090;74;0;0;0;0;.00nan;0;0
27355;7528;74;56;26;3;23;.885;3638000;0
27355;7575;81;0;0;0;0;.00nan;0;0
27355;8206;81;53;19;2;17;.895;3638000;0
27356;5107;77;53;23;3;20;.870;3021000;0
27356;6701;76;0;0;0;0;.00nan;0;0
27356;6905;77;23;6;3;3;.500;579000;0
27356;9564;76;65;24;2;22;.917;3600000;0
27357;5054;72;0;0;0;0;.00nan;0;0
27357;6751;67;0;0;0;0;.00nan;0;0
27357;6825;72;52;39;5;34;.872;3600000;0
27357;9579;67;63;33;4;29;.879;3600000;0
27358;5107;77;46;6;1;5;.833;421000;0
27358;6701;76;67;18;1;17;.944;3600000;0
27358;6905;77;62;43;6;37;.860;3179000;0
27358;9564;76;0;0;0;0;.00nan;0;0
27359;4940;62;100;38;2;36;.947;3600000;0
27359;6077;65;84;39;3;36;.923;3544000;0
27359;7501;62;0;0;0;0;.00nan;0;0
27359;8395;65;0;0;0;0;.00nan;0;0
27360;5154;83;43;40;6;34;.850;2775000;0
27360;7575;81;45;27;4;23;.852;3600000;0
27360;8206;81;0;0;0;0;.00nan;0;0
27360;8364;83;51;9;1;8;.889;825000;0
27361;4940;62;78;26;1;25;.962;3600000;0
27361;5054;72;64;34;3;31;.912;3531000;0
27361;6825;72;0;0;0;0;.00nan;0;0
27361;7501;62;0;0;0;0;.00nan;0;0
27362;6077;65;0;0;0;0;.00nan;0;0
27362;8395;65;82;43;3;40;.930;3582000;0
27362;8927;63;0;0;0;0;.00nan;0;0
27362;9673;63;50;7;1;6;.857;3600000;0
27363;6720;68;0;0;0;0;.00nan;0;0
27363;6945;71;0;0;0;0;.00nan;0;0
27363;8179;68;74;26;1;25;.962;3600000;0
27363;8361;71;90;38;2;36;.947;3600000;0
27364;4919;70;0;0;0;0;.00nan;0;0
27364;5054;72;0;0;0;0;.00nan;0;0
27364;5257;70;81;26;1;25;.962;3600000;0
27364;6825;72;97;39;2;37;.949;3544000;0
27365;6799;73;65;25;2;23;.920;3900000;0
27365;6840;82;0;0;0;0;.00nan;0;0
27365;6921;82;91;41;2;39;.951;3900000;0
27365;8403;73;0;0;0;0;.00nan;0;0
27366;3837;75;50;17;2;15;.882;1445000;0
27366;5107;77;40;25;5;20;.800;3600000;0
27366;5348;75;40;17;4;13;.765;2131000;0
27366;6905;77;0;0;0;0;.00nan;0;0
27367;5154;83;0;0;0;0;.00nan;0;0
27367;6087;80;41;11;2;9;.818;1048000;0
27367;8300;80;8;14;6;8;.571;2552000;0
27367;8364;83;76;31;2;29;.935;3600000;0
27368;5088;78;86;33;1;32;.970;3600000;0
27368;6751;67;50;35;4;31;.886;3600000;0
27368;6916;78;0;0;0;0;.00nan;0;0
27368;9579;67;0;0;0;0;.00nan;0;0
27369;6077;65;0;0;0;0;.00nan;0;0
27369;6664;66;68;26;3;23;.885;3552000;0
27369;8390;66;0;0;0;0;.00nan;0;0
27369;8395;65;60;23;2;21;.913;3600000;0
27370;4940;62;76;37;2;35;.946;3563000;0
27370;5377;64;0;0;0;0;.00nan;0;0
27370;7501;62;0;0;0;0;.00nan;0;0
27370;9850;65;67;15;1;14;.933;3600000;0
27371;4919;70;59;43;5;38;.884;3600000;0
27371;5257;70;0;0;0;0;.00nan;0;0
27371;8927;63;75;24;2;22;.917;3600000;0
27371;9673;63;0;0;0;0;.00nan;0;0
27372;5183;69;0;0;0;0;.00nan;0;0
27372;5372;69;75;34;3;31;.912;3600000;0
27372;6840;82;26;25;6;19;.760;3514000;0
27372;6921;82;50;1;0;1;1.000;86000;0
27373;6799;73;0;0;0;0;.00nan;0;0
27373;6945;71;87;41;3;38;.927;3900000;0
27373;8361;71;0;0;0;0;.00nan;0;0
27373;8403;73;59;27;3;24;.889;3900000;0
27374;5054;72;82;39;3;36;.923;3600000;0
27374;6720;68;84;30;2;28;.933;3600000;0
27374;6825;72;0;0;0;0;.00nan;0;0
27374;8179;68;0;0;0;0;.00nan;0;0
27375;3837;75;0;0;0;0;.00nan;0;0
27375;5348;75;47;26;4;22;.846;3554000;0
27375;6751;67;0;0;0;0;.00nan;0;0
27375;9579;67;59;21;2;19;.905;3600000;0
27376;5088;78;75;22;1;21;.955;3600000;0
27376;5107;77;0;0;0;0;.00nan;0;0
27376;6905;77;79;38;3;35;.921;3511000;0
27376;6916;78;0;0;0;0;.00nan;0;0
27377;5090;74;0;0;0;0;.00nan;0;0
27377;6093;79;0;0;0;0;.00nan;0;0
27377;6735;79;80;45;4;41;.911;3562000;0
27377;7528;74;60;16;2;14;.875;3600000;0
27378;6087;80;0;0;0;0;.00nan;0;0
27378;7575;81;0;0;0;0;.00nan;0;0
27378;8206;81;57;29;3;26;.897;3519000;0
27378;8300;80;68;17;1;16;.941;3600000;0
27379;4919;70;0;0;0;0;.00nan;0;0
27379;5257;70;67;27;2;25;.926;3600000;0
27379;8927;63;0;0;0;0;.00nan;0;0
27379;9673;63;49;30;4;26;.867;3515000;0
27380;4940;62;48;0;0;0;.00nan;140000;0
27380;5377;64;62;31;4;27;.871;3600000;0
27380;7501;62;58;42;6;36;.857;3413000;0
27380;9850;65;0;0;0;0;.00nan;0;0
27381;6077;65;50;29;5;24;.828;3600000;0
27381;6664;66;81;34;2;32;.941;3600000;0
27381;8390;66;0;0;0;0;.00nan;0;0
27381;8395;65;0;0;0;0;.00nan;0;0
27382;5054;72;0;0;0;0;.00nan;0;0
27382;6825;72;65;43;7;36;.837;3600000;0
27382;6840;82;0;0;0;0;.00nan;0;0
27382;6921;82;49;24;4;20;.833;3600000;0
27383;5154;83;95;44;3;41;.932;3600000;0
27383;6701;76;0;0;0;0;.00nan;0;0
27383;8364;83;0;0;0;0;.00nan;0;0
27383;9564;76;40;27;5;22;.815;3522000;0
27384;5183;69;69;22;1;21;.955;3600000;0
27384;5372;69;0;0;0;0;.00nan;0;0
27384;6945;71;0;0;0;0;.00nan;0;0
27384;8361;71;69;31;3;28;.903;3571000;0
27385;6720;68;0;0;0;0;.00nan;0;0
27385;6799;73;89;32;1;31;.969;3600000;0
27385;8179;68;61;37;4;33;.892;3600000;0
27385;8403;73;0;0;0;0;.00nan;0;0
27386;5088;78;0;0;0;0;.00nan;0;0
27386;5107;77;64;29;3;26;.897;3600000;0
27386;6905;77;0;0;0;0;.00nan;0;0
27386;6916;78;41;21;4;17;.810;3572000;0
27387;5090;74;64;25;2;23;.920;3600000;0
27387;6751;67;51;46;6;40;.870;3575000;0
27387;7528;74;0;0;0;0;.00nan;0;0
27387;9579;67;50;0;0;0;.00nan;25000;0
27388;3837;75;47;28;4;24;.857;2118000;0
27388;5348;75;47;11;2;9;.818;1482000;0
27388;6087;80;54;21;3;18;.857;3600000;0
27388;8300;80;0;0;0;0;.00nan;0;0
27389;6093;79;59;20;2;18;.900;3600000;0
27389;6735;79;0;0;0;0;.00nan;0;0
27389;7575;81;68;30;3;27;.900;3545000;0
27389;8206;81;0;0;0;0;.00nan;0;0
27390;3837;75;0;0;0;0;.00nan;0;0
27390;5348;75;57;37;5;32;.865;3587000;0
27390;6087;80;0;0;0;0;.00nan;0;0
27390;8300;80;58;26;3;23;.885;3600000;0
27391;5154;83;0;0;0;0;.00nan;0;0
27391;6701;76;74;32;3;29;.906;3900000;0
27391;8364;83;70;34;3;31;.912;3900000;0
27391;9564;76;0;0;0;0;.00nan;0;0
27392;6093;79;0;0;0;0;.00nan;0;0
27392;6735;79;98;35;2;33;.943;3900000;0
27392;7575;81;0;0;0;0;.00nan;0;0
27392;8206;81;91;35;2;33;.943;3900000;0
27393;4940;62;73;42;4;38;.905;3600000;0
27393;6664;66;0;0;0;0;.00nan;0;0
27393;7501;62;0;0;0;0;.00nan;0;0
27393;8390;66;70;22;1;21;.955;3600000;0
27394;5183;69;0;0;0;0;.00nan;0;0
27394;5372;69;79;31;2;29;.935;3544000;0
27394;6720;68;93;33;1;32;.970;3600000;0
27394;8179;68;0;0;0;0;.00nan;0;0
27395;4919;70;71;33;3;30;.909;3585000;0
27395;5257;70;0;0;0;0;.00nan;0;0
27395;6077;65;0;0;0;0;.00nan;0;0
27395;8395;65;69;27;2;25;.926;3600000;0
27396;3837;75;72;38;4;34;.895;3600000;0
27396;5348;75;0;0;0;0;.00nan;0;0
27396;6840;82;30;21;5;16;.762;3543000;0
27396;6921;82;0;0;0;0;.00nan;0;0
27397;6664;66;94;45;3;42;.933;3556000;0
27397;8390;66;0;0;0;0;.00nan;0;0
27397;8927;63;70;21;2;19;.905;3600000;0
27397;9673;63;0;0;0;0;.00nan;0;0
27398;5183;69;92;41;4;37;.902;3872000;0
27398;5372;69;0;0;0;0;.00nan;0;0
27398;6945;71;50;25;4;21;.840;3900000;0
27398;8361;71;0;0;0;0;.00nan;0;0
27399;5090;74;0;0;0;0;.00nan;0;0
27399;6701;76;79;33;2;31;.939;3600000;0
27399;7528;74;48;27;4;23;.852;3600000;0
27399;9564;76;0;0;0;0;.00nan;0;0
27400;4942;63;46;26;4;22;.846;3600000;0
27400;5377;64;0;0;0;0;.00nan;0;0
27400;8927;63;0;0;0;0;.00nan;0;0
27400;9850;65;87;53;2;51;.962;3600000;0
27401;4919;70;0;0;0;0;.00nan;0;0
27401;5257;70;24;30;6;24;.800;3600000;0
27401;6664;66;78;36;2;34;.944;3600000;0
27401;8390;66;0;0;0;0;.00nan;0;0
27402;6751;67;82;39;4;35;.897;3600000;0
27402;6799;73;54;10;1;9;.900;3600000;0
27402;8403;73;0;0;0;0;.00nan;0;0
27402;9579;67;0;0;0;0;.00nan;0;0
27403;4940;62;40;39;6;33;.846;3561000;0
27403;6077;65;0;0;0;0;.00nan;0;0
27403;7501;62;0;0;0;0;.00nan;0;0
27403;8395;65;45;29;5;24;.828;3600000;0
27404;6720;68;69;37;4;33;.892;3600000;0
27404;6945;71;0;0;0;0;.00nan;0;0
27404;8179;68;0;0;0;0;.00nan;0;0
27404;8361;71;70;24;1;23;.958;3600000;0
27405;3837;75;0;0;0;0;.00nan;0;0
27405;5090;74;0;0;0;0;.00nan;0;0
27405;5348;75;63;33;4;29;.879;3900000;0
27405;7528;74;55;20;4;16;.800;3900000;0
27406;5154;83;92;36;1;35;.972;3600000;0
27406;6840;82;0;0;0;0;.00nan;0;0
27406;6921;82;30;19;4;15;.789;3600000;0
27406;8364;83;0;0;0;0;.00nan;0;0
27407;6087;80;61;21;2;19;.905;3600000;0
27407;7575;81;0;0;0;0;.00nan;0;0
27407;8206;81;58;33;4;29;.879;3525000;0
27407;8300;80;0;0;0;0;.00nan;0;0
27408;5088;78;46;35;5;30;.857;3600000;0
27408;6701;76;0;0;0;0;.00nan;0;0
27408;6916;78;0;0;0;0;.00nan;0;0
27408;9564;76;67;25;3;22;.880;3600000;0
27409;5107;77;0;0;0;0;.00nan;0;0
27409;6093;79;0;0;0;0;.00nan;0;0
27409;6735;79;49;17;3;14;.824;3900000;0
27409;6905;77;87;42;3;39;.929;3900000;0
27410;4919;70;61;38;4;34;.895;3582000;0
27410;5257;70;0;0;0;0;.00nan;0;0
27410;5377;64;66;20;2;18;.900;3600000;0
27410;9850;65;0;0;0;0;.00nan;0;0
27411;4942;63;0;0;0;0;.00nan;0;0
27411;6664;66;45;29;5;24;.828;3546000;0
27411;8390;66;0;0;0;0;.00nan;0;0
27411;8927;63;69;37;4;33;.892;3600000;0
27412;4940;62;0;0;0;0;.00nan;0;0
27412;6077;65;86;33;3;30;.909;3900000;0
27412;7501;62;71;37;3;34;.919;3900000;0
27412;8395;65;0;0;0;0;.00nan;0;0
27413;5154;83;0;0;0;0;.00nan;0;0
27413;7575;81;72;27;2;25;.926;3516000;0
27413;8206;81;0;0;0;0;.00nan;0;0
27413;8364;83;90;35;1;34;.971;3600000;0
27414;5054;72;0;0;0;0;.00nan;0;0
27414;5183;69;0;0;0;0;.00nan;0;0
27414;5372;69;72;33;2;31;.939;3547000;0
27414;6825;72;79;25;1;24;.960;3600000;0
27415;5107;77;89;29;1;28;.966;3900000;0
27415;6093;79;74;20;1;19;.950;3900000;0
27415;6735;79;0;0;0;0;.00nan;0;0
27415;6905;77;0;0;0;0;.00nan;0;0
27416;6720;68;0;0;0;0;.00nan;0;0
27416;6945;71;55;36;5;31;.861;3900000;0
27416;8179;68;54;35;5;30;.857;3900000;0
27416;8361;71;0;0;0;0;.00nan;0;0
27417;3837;75;95;43;3;40;.930;3557000;0
27417;5090;74;65;16;1;15;.938;3600000;0
27417;5348;75;0;0;0;0;.00nan;0;0
27417;7528;74;0;0;0;0;.00nan;0;0
27418;6087;80;0;0;0;0;.00nan;0;0
27418;6840;82;91;32;1;31;.969;3600000;0
27418;6921;82;0;0;0;0;.00nan;0;0
27418;8300;80;32;26;5;21;.808;3600000;0
27419;5088;78;91;36;2;34;.944;3163000;0
27419;6701;76;61;27;4;23;.852;3600000;0
27419;6916;78;28;10;3;7;.700;432000;0
27419;9564;76;0;0;0;0;.00nan;0;0
27420;5054;72;100;34;0;34;1.000;3600000;0
27420;5183;69;81;26;1;25;.962;3578000;0
27420;5372;69;0;0;0;0;.00nan;0;0
27420;6825;72;0;0;0;0;.00nan;0;0
27421;6751;67;0;0;0;0;.00nan;0;0
27421;6799;73;0;0;0;0;.00nan;0;0
27421;8403;73;65;27;3;24;.889;3600000;0
27421;9579;67;53;32;4;28;.875;3596000;0
27422;5088;78;0;0;0;0;.00nan;0;0
27422;5107;77;0;0;0;0;.00nan;0;0
27422;6905;77;59;37;5;32;.865;3645000;0
27422;6916;78;58;31;4;27;.871;3627000;0
27423;6087;80;56;45;6;39;.867;3486000;0
27423;7575;81;0;0;0;0;.00nan;0;0
27423;8206;81;49;24;4;20;.833;3600000;0
27423;8300;80;49;1;0;1;1.000;85000;0
27424;6077;65;0;0;0;0;.00nan;0;0
27424;6664;66;55;35;5;30;.857;3589000;0
27424;8390;66;0;0;0;0;.00nan;0;0
27424;8395;65;50;24;4;20;.833;3600000;0
27425;5183;69;0;0;0;0;.00nan;0;0
27425;5372;69;70;31;3;28;.903;3600000;0
27425;6720;68;63;38;4;34;.895;3579000;0
27425;8179;68;0;0;0;0;.00nan;0;0
27426;6093;79;0;0;0;0;.00nan;0;0
27426;6735;79;54;30;4;26;.867;3600000;0
27426;6840;82;0;0;0;0;.00nan;0;0
27426;6921;82;20;25;6;19;.760;3553000;0
27427;5377;64;0;0;0;0;.00nan;0;0
27427;6077;65;68;39;4;35;.897;3574000;0
27427;8395;65;0;0;0;0;.00nan;0;0
27427;9850;65;62;29;3;26;.897;3600000;0
27428;6751;67;51;37;6;31;.838;3180000;0
27428;6945;71;0;0;0;0;.00nan;0;0
27428;8361;71;68;20;1;19;.950;3600000;0
27428;9579;67;51;2;0;2;1.000;420000;0
27429;4919;70;37;8;2;6;.750;549000;0
27429;4942;63;64;22;2;20;.909;3600000;0
27429;5257;70;40;32;6;26;.813;3051000;0
27429;8927;63;0;0;0;0;.00nan;0;0
27430;3837;75;0;0;0;0;.00nan;0;0
27430;5107;77;32;25;5;20;.800;3580000;0
27430;5348;75;51;29;4;25;.862;3600000;0
27430;6905;77;0;0;0;0;.00nan;0;0
27431;5088;78;50;36;5;31;.861;3900000;0
27431;5090;74;0;0;0;0;.00nan;0;0
27431;6916;78;0;0;0;0;.00nan;0;0
27431;7528;74;68;36;5;31;.861;3900000;0
27432;5377;64;0;0;0;0;.00nan;0;0
27432;6664;66;51;30;4;26;.867;3569000;0
27432;8390;66;0;0;0;0;.00nan;0;0
27432;9850;65;80;37;2;35;.946;3600000;0
27433;6720;68;77;34;3;31;.912;3600000;0
27433;6751;67;0;0;0;0;.00nan;0;0
27433;8179;68;0;0;0;0;.00nan;0;0
27433;9579;67;55;36;4;32;.889;3550000;0
27434;4919;70;0;0;0;0;.00nan;0;0
27434;4940;62;100;31;0;31;1.000;3600000;0
27434;5257;70;72;22;1;21;.955;3600000;0
27434;7501;62;0;0;0;0;.00nan;0;0
27435;5183;69;0;0;0;0;.00nan;0;0
27435;5372;69;90;32;2;30;.938;3900000;0
27435;6799;73;80;34;2;32;.941;3900000;0
27435;8403;73;0;0;0;0;.00nan;0;0
27436;4942;63;0;0;0;0;.00nan;0;0
27436;6077;65;39;8;2;6;.750;1099000;0
27436;8395;65;34;30;6;24;.800;2501000;0
27436;8927;63;84;22;1;21;.955;3600000;0
27437;5054;72;75;31;2;29;.935;3600000;0
27437;6825;72;0;0;0;0;.00nan;0;0
27437;6945;71;58;36;4;32;.889;3545000;0
27437;8361;71;0;0;0;0;.00nan;0;0
27438;3837;75;43;39;7;32;.821;3600000;0
27438;5088;78;64;14;1;13;.929;3600000;0
27438;5348;75;0;0;0;0;.00nan;0;0
27438;6916;78;0;0;0;0;.00nan;0;0
27439;5154;83;95;45;2;43;.956;3900000;0
27439;6087;80;73;34;2;32;.941;3900000;0
27439;8300;80;0;0;0;0;.00nan;0;0
27439;8364;83;0;0;0;0;.00nan;0;0
27440;5090;74;51;22;3;19;.864;3894000;0
27440;5107;77;80;37;3;34;.919;3900000;0
27440;6905;77;0;0;0;0;.00nan;0;0
27440;7528;74;0;0;0;0;.00nan;0;0
27441;6701;76;41;37;6;31;.838;2997000;0
27441;7575;81;0;0;0;0;.00nan;0;0
27441;8206;81;64;27;3;24;.889;3600000;0
27441;9564;76;43;5;1;4;.800;603000;0
27442;5377;64;57;36;4;32;.889;3542000;0
27442;6664;66;73;32;2;30;.938;3600000;0
27442;8390;66;0;0;0;0;.00nan;0;0
27442;9850;65;0;0;0;0;.00nan;0;0
27443;4942;63;44;16;3;13;.813;3600000;0
27443;6077;65;31;36;8;28;.778;3600000;0
27443;8395;65;0;0;0;0;.00nan;0;0
27443;8927;63;0;0;0;0;.00nan;0;0
27444;4919;70;81;31;2;29;.935;3600000;0
27444;4940;62;64;32;3;29;.906;3600000;0
27444;5257;70;0;0;0;0;.00nan;0;0
27444;7501;62;0;0;0;0;.00nan;0;0
27445;5183;69;83;50;4;46;.920;3900000;0
27445;5372;69;0;0;0;0;.00nan;0;0
27445;6799;73;0;0;0;0;.00nan;0;0
27445;8403;73;59;31;4;27;.871;3900000;0
27446;5154;83;0;0;0;0;.00nan;0;0
27446;6093;79;0;0;0;0;.00nan;0;0
27446;6735;79;71;25;2;23;.920;3600000;0
27446;8364;83;53;32;5;27;.844;3600000;0
27447;6720;68;0;0;0;0;.00nan;0;0
27447;6751;67;21;10;4;6;.600;1097000;0
27447;8179;68;66;30;3;27;.900;3600000;0
27447;9579;67;64;27;2;25;.926;2503000;0
27448;3837;75;0;0;0;0;.00nan;0;0
27448;5088;78;0;0;0;0;.00nan;0;0
27448;5348;75;75;38;4;34;.895;3561000;0
27448;6916;78;52;13;2;11;.846;3600000;0
27449;5090;74;0;0;0;0;.00nan;0;0
27449;5107;77;0;0;0;0;.00nan;0;0
27449;6905;77;45;30;4;26;.867;3559000;0
27449;7528;74;70;22;2;20;.909;3600000;0
27450;6087;80;0;0;0;0;.00nan;0;0
27450;6840;82;56;45;5;40;.889;3600000;0
27450;6921;82;0;0;0;0;.00nan;0;0
27450;8300;80;34;33;6;27;.818;3553000;0
27451;6701;76;0;0;0;0;.00nan;0;0
27451;7575;81;43;26;4;22;.846;3600000;0
27451;8206;81;0;0;0;0;.00nan;0;0
27451;9564;76;70;38;3;35;.921;3600000;0
27452;5054;72;0;0;0;0;.00nan;0;0
27452;6825;72;78;35;2;33;.943;3600000;0
27452;6945;71;0;0;0;0;.00nan;0;0
27452;8361;71;100;43;1;42;.977;3600000;0
27453;5154;83;77;26;1;25;.962;3600000;0
27453;6093;79;53;28;4;24;.857;3600000;0
27453;6735;79;0;0;0;0;.00nan;0;0
27453;8364;83;0;0;0;0;.00nan;0;0
27455;3837;75;46;41;5;36;.878;3600000;0
27455;5348;75;0;0;0;0;.00nan;0;0
27455;6197;74;0;0;0;0;.00nan;0;0
27455;7528;74;59;21;2;19;.905;3600000;0
27457;6077;65;68;41;4;37;.902;3529000;0
27457;6825;72;65;20;2;18;.900;3600000;0
27457;8395;65;0;0;0;0;.00nan;0;0
27457;9850;65;0;0;0;0;.00nan;0;0
27459;6664;66;33;35;6;29;.829;3541000;0
27459;6840;82;0;0;0;0;.00nan;0;0
27459;8403;73;55;33;4;29;.879;3600000;0
27459;9669;72;50;0;0;0;.00nan;42000;0
27461;5088;78;51;1;0;1;1.000;26000;0
27461;6799;73;0;0;0;0;.00nan;0;0
27461;6916;78;56;44;6;38;.864;3574000;0
27461;7484;73;73;12;1;11;.917;3600000;0
27463;5183;69;0;0;0;0;.00nan;0;0
27463;5372;69;84;34;2;32;.941;3900000;0
27463;6751;67;89;36;2;34;.944;3900000;0
27463;9579;67;0;0;0;0;.00nan;0;0
27465;4940;62;52;23;3;20;.870;3600000;0
27465;5090;74;0;0;0;0;.00nan;0;0
27465;6701;76;40;35;5;30;.857;3600000;0
27465;7501;62;0;0;0;0;.00nan;0;0
27467;4942;63;88;20;0;20;1.000;3600000;0
27467;6720;68;89;31;1;30;.968;3584000;0
27467;8179;68;0;0;0;0;.00nan;0;0
27467;8927;63;0;0;0;0;.00nan;0;0
27469;5054;72;0;0;0;0;.00nan;0;0
27469;7575;81;0;0;0;0;.00nan;0;0
27469;8147;72;81;24;1;23;.958;3600000;0
27469;8206;81;63;22;2;20;.909;3600000;0
27471;6087;80;0;0;0;0;.00nan;0;0
27471;6093;79;24;31;7;24;.774;3153000;0
27471;6735;79;20;10;4;6;.600;447000;0
27471;8300;80;62;33;4;29;.879;3600000;0
27473;4919;70;0;0;0;0;.00nan;0;0
27473;5107;77;32;22;5;17;.773;2388000;0
27473;5257;70;60;28;4;24;.857;3600000;0
27473;6865;77;68;16;0;16;1.000;1166000;0
27475;5154;83;0;0;0;0;.00nan;0;0
27475;6945;71;100;35;1;34;.971;3600000;0
27475;8361;71;0;0;0;0;.00nan;0;0
27475;8364;83;68;25;2;23;.920;3571000;0
27477;4940;62;0;0;0;0;.00nan;0;0
27477;7501;62;56;29;4;25;.862;3600000;0
27477;7575;81;46;19;3;16;.842;3600000;0
27477;8206;81;0;0;0;0;.00nan;0;0
27479;5183;69;68;32;3;29;.906;3600000;0
27479;5372;69;0;0;0;0;.00nan;0;0
27479;6799;73;100;40;0;40;1.000;3600000;0
27479;7484;73;0;0;0;0;.00nan;0;0
27481;5088;78;39;28;5;23;.821;2610000;0
27481;6720;68;74;21;1;20;.952;3600000;0
27481;6916;78;31;18;4;14;.778;990000;0
27481;8179;68;0;0;0;0;.00nan;0;0
27483;3837;75;88;27;1;26;.963;3600000;0
27483;5054;72;69;37;3;34;.919;3569000;0
27483;5348;75;0;0;0;0;.00nan;0;0
27483;8147;72;0;0;0;0;.00nan;0;0
27485;6087;80;80;31;2;29;.935;3600000;0
27485;6825;72;0;0;0;0;.00nan;0;0
27485;8300;80;0;0;0;0;.00nan;0;0
27485;9850;65;56;24;4;20;.833;3586000;0
27487;4942;63;82;16;0;16;1.000;3600000;0
27487;5107;77;41;37;6;31;.838;3134000;0
27487;6865;77;42;9;2;7;.778;466000;0
27487;8927;63;0;0;0;0;.00nan;0;0
27489;6093;79;70;38;4;34;.895;3600000;0
27489;6735;79;0;0;0;0;.00nan;0;0
27489;6751;67;0;0;0;0;.00nan;0;0
27489;9579;67;32;23;5;18;.783;3555000;0
27491;6077;65;66;28;3;25;.893;3600000;0
27491;6840;82;52;41;5;36;.878;3535000;0
27491;8395;65;0;0;0;0;.00nan;0;0
27491;8403;73;0;0;0;0;.00nan;0;0
27493;4919;70;86;32;1;31;.969;3600000;0
27493;5257;70;0;0;0;0;.00nan;0;0
27493;6197;74;61;27;3;24;.889;3525000;0
27493;7528;74;0;0;0;0;.00nan;0;0
27495;5090;74;79;34;3;31;.912;3739000;0
27495;5154;83;51;15;2;13;.867;3739000;0
27495;6701;76;0;0;0;0;.00nan;0;0
27495;8364;83;0;0;0;0;.00nan;0;0
27497;6664;66;0;0;0;0;.00nan;0;0
27497;6945;71;0;0;0;0;.00nan;0;0
27497;8361;71;90;41;2;39;.951;3600000;0
27497;9669;72;28;44;8;36;.818;3600000;0
27499;3837;75;0;0;0;0;.00nan;0;0
27499;5348;75;90;46;3;43;.935;3900000;0
27499;6664;66;58;27;3;24;.889;3900000;0
27499;9669;72;0;0;0;0;.00nan;0;0
27501;4940;62;57;28;3;25;.893;3600000;0
27501;6093;79;33;5;2;3;.600;306000;0
27501;6735;79;36;44;8;36;.818;3294000;0
27501;7501;62;0;0;0;0;.00nan;0;0
27503;6945;71;99;49;2;47;.959;3600000;0
27503;7575;81;0;0;0;0;.00nan;0;0
27503;8206;81;31;29;6;23;.793;3600000;0
27503;8361;71;0;0;0;0;.00nan;0;0
27505;5054;72;0;0;0;0;.00nan;0;0
27505;6077;65;0;0;0;0;.00nan;0;0
27505;8147;72;59;23;2;21;.913;3600000;0
27505;8395;65;71;43;4;39;.907;3600000;0
27507;5154;83;0;0;0;0;.00nan;0;0
27507;6840;82;0;0;0;0;.00nan;0;0
27507;8364;83;75;38;4;34;.895;3600000;0
27507;8403;73;72;30;3;27;.900;3600000;0
27509;5090;74;0;0;0;0;.00nan;0;0
27509;6087;80;0;0;0;0;.00nan;0;0
27509;6701;76;80;25;1;24;.960;3600000;0
27509;8300;80;85;42;2;40;.952;3585000;0
27511;5107;77;0;0;0;0;.00nan;0;0
27511;6799;73;44;18;4;14;.778;3900000;0
27511;6865;77;93;56;4;52;.929;3900000;0
27511;7484;73;0;0;0;0;.00nan;0;0
27513;6751;67;26;21;5;16;.762;3591000;0
27513;6825;72;57;37;4;33;.892;3600000;0
27513;9579;67;0;0;0;0;.00nan;0;0
27513;9850;65;0;0;0;0;.00nan;0;0
27515;5088;78;0;0;0;0;.00nan;0;0
27515;6197;74;0;0;0;0;.00nan;0;0
27515;6916;78;82;55;6;49;.891;3600000;0
27515;7528;74;72;19;1;18;.947;3600000;0
27517;4942;63;0;0;0;0;.00nan;0;0
27517;6720;68;50;8;1;7;.875;691000;0
27517;8179;68;12;33;8;25;.758;2909000;0
27517;8927;63;34;25;5;20;.800;3600000;0
27519;4919;70;0;0;0;0;.00nan;0;0
27519;5183;69;0;0;0;0;.00nan;0;0
27519;5257;70;52;28;4;24;.857;3584000;0
27519;5372;69;68;24;2;22;.917;3600000;0
27521;5154;83;53;46;6;40;.870;3600000;0
27521;6664;66;0;0;0;0;.00nan;0;0
27521;8364;83;0;0;0;0;.00nan;0;0
27521;9669;72;66;35;3;32;.914;3600000;0
27523;5088;78;99;50;1;49;.980;3722000;0
27523;5090;74;0;0;0;0;.00nan;0;0
27523;6701;76;58;20;2;18;.900;3722000;0
27523;6916;78;0;0;0;0;.00nan;0;0
27525;6825;72;53;24;3;21;.875;3600000;0
27525;6945;71;0;0;0;0;.00nan;0;0
27525;8361;71;83;40;4;36;.900;3581000;0
27525;9850;65;0;0;0;0;.00nan;0;0
27527;4940;62;0;0;0;0;.00nan;0;0
27527;7501;62;68;33;2;31;.939;3900000;0
27527;7575;81;86;38;2;36;.947;3900000;0
27527;8206;81;0;0;0;0;.00nan;0;0
27529;6077;65;65;41;5;36;.878;3900000;0
27529;6720;68;0;0;0;0;.00nan;0;0
27529;8179;68;50;38;5;33;.868;3900000;0
27529;8395;65;0;0;0;0;.00nan;0;0
27531;5183;69;0;0;0;0;.00nan;0;0
27531;5372;69;83;29;1;28;.966;3600000;0
27531;6840;82;76;41;4;37;.902;3600000;0
27531;8403;73;0;0;0;0;.00nan;0;0
27533;5054;72;86;31;2;29;.935;3600000;0
27533;6087;80;85;43;3;40;.930;3584000;0
27533;8147;72;0;0;0;0;.00nan;0;0
27533;8300;80;0;0;0;0;.00nan;0;0
27535;4919;70;87;19;0;19;1.000;3600000;0
27535;5107;77;35;13;3;10;.769;564000;0
27535;5257;70;0;0;0;0;.00nan;0;0
27535;6865;77;51;41;5;36;.878;3036000;0
27537;6197;74;0;0;0;0;.00nan;0;0
27537;6751;67;35;32;5;27;.844;3600000;0
27537;7528;74;50;25;4;21;.840;3600000;0
27537;9579;67;0;0;0;0;.00nan;0;0
27539;3837;75;92;41;3;38;.927;3560000;0
27539;5348;75;0;0;0;0;.00nan;0;0
27539;6799;73;0;0;0;0;.00nan;0;0
27539;7484;73;64;20;2;18;.900;3600000;0
27541;4942;63;99;25;0;25;1.000;3600000;0
27541;6093;79;52;1;0;1;1.000;52000;0
27541;6735;79;42;40;6;34;.850;3548000;0
27541;8927;63;0;0;0;0;.00nan;0;0
27543;3837;75;0;0;0;0;.00nan;0;0
27543;5154;83;0;0;0;0;.00nan;0;0
27543;5348;75;44;38;5;33;.868;3600000;0
27543;8364;83;65;30;4;26;.867;3600000;0
27545;6751;67;0;0;0;0;.00nan;0;0
27545;7575;81;0;0;0;0;.00nan;0;0
27545;8206;81;98;35;1;34;.971;3600000;0
27545;9579;67;52;39;4;35;.897;3600000;0
27547;5054;72;0;0;0;0;.00nan;0;0
27547;6077;65;0;0;0;0;.00nan;0;0
27547;8147;72;70;37;3;34;.919;3720000;0
27547;8395;65;57;34;4;30;.882;3720000;0
27549;5183;69;43;29;5;24;.828;3809000;0
27549;5372;69;0;0;0;0;.00nan;0;0
27549;6945;71;74;42;4;38;.905;3809000;0
27549;8361;71;0;0;0;0;.00nan;0;0
27551;5088;78;0;0;0;0;.00nan;0;0
27551;6664;66;70;28;2;26;.929;3900000;0
27551;6916;78;84;40;2;38;.950;3900000;0
27551;9669;72;0;0;0;0;.00nan;0;0
27553;6093;79;69;35;3;32;.914;3553000;0
27553;6197;74;99;49;2;47;.959;3600000;0
27553;6735;79;0;0;0;0;.00nan;0;0
27553;7528;74;0;0;0;0;.00nan;0;0
27555;4942;63;0;0;0;0;.00nan;0;0
27555;6720;68;48;27;4;23;.852;3543000;0
27555;8179;68;0;0;0;0;.00nan;0;0
27555;8927;63;68;23;2;21;.913;3600000;0
27557;4919;70;79;25;1;24;.960;3600000;0
27557;5107;77;86;40;2;38;.950;3571000;0
27557;5257;70;0;0;0;0;.00nan;0;0
27557;6865;77;0;0;0;0;.00nan;0;0
27559;4940;62;53;42;6;36;.857;3544000;0
27559;6799;73;62;37;5;32;.865;3600000;0
27559;7484;73;0;0;0;0;.00nan;0;0
27559;7501;62;0;0;0;0;.00nan;0;0
27561;6825;72;0;0;0;0;.00nan;0;0
27561;6840;82;0;0;0;0;.00nan;0;0
27561;8403;73;54;26;3;23;.885;3600000;0
27561;9850;65;46;37;5;32;.865;3536000;0
27563;5090;74;63;44;5;39;.886;3515000;0
27563;6087;80;0;0;0;0;.00nan;0;0
27563;6701;76;0;0;0;0;.00nan;0;0
27563;8300;80;74;33;3;30;.909;3600000;0
27565;5054;72;68;31;3;28;.903;3600000;0
27565;6087;80;61;35;4;31;.886;3570000;0
27565;8147;72;0;0;0;0;.00nan;0;0
27565;8300;80;0;0;0;0;.00nan;0;0
27567;6197;74;0;0;0;0;.00nan;0;0
27567;6664;66;49;6;1;5;.833;370000;0
27567;7528;74;48;33;6;27;.818;3772000;0
27567;9669;72;57;40;6;34;.850;3402000;0
27569;5090;74;0;0;0;0;.00nan;0;0
27569;6093;79;53;39;6;33;.846;3671000;0
27569;6701;76;51;33;5;28;.848;3671000;0
27569;6735;79;0;0;0;0;.00nan;0;0
27571;4940;62;0;0;0;0;.00nan;0;0
27571;6945;71;59;15;1;14;.933;725000;0
27571;7501;62;36;29;5;24;.828;3600000;0
27571;8361;71;19;20;6;14;.700;2863000;0
27573;6077;65;65;31;3;28;.903;3600000;0
27573;6840;82;48;24;4;20;.833;3542000;0
27573;8395;65;0;0;0;0;.00nan;0;0
27573;8403;73;0;0;0;0;.00nan;0;0
27575;5183;69;0;0;0;0;.00nan;0;0
27575;5372;69;28;26;6;20;.769;3600000;0
27575;6751;67;73;35;2;33;.943;3600000;0
27575;9579;67;0;0;0;0;.00nan;0;0
27577;5088;78;81;28;1;27;.964;3900000;0
27577;5107;77;0;0;0;0;.00nan;0;0
27577;6865;77;90;32;1;31;.969;3900000;0
27577;6916;78;0;0;0;0;.00nan;0;0
27579;6720;68;0;0;0;0;.00nan;0;0
27579;6825;72;84;34;2;32;.941;3600000;0
27579;8179;68;70;39;3;36;.923;3584000;0
27579;9850;65;0;0;0;0;.00nan;0;0
27581;6799;73;0;0;0;0;.00nan;0;0
27581;7484;73;52;34;4;30;.882;3600000;0
27581;7575;81;0;0;0;0;.00nan;0;0
27581;8206;81;100;31;0;31;1.000;3600000;0
27583;3837;75;81;40;4;36;.900;3900000;0
27583;4942;63;0;0;0;0;.00nan;0;0
27583;5348;75;0;0;0;0;.00nan;0;0
27583;8927;63;55;31;4;27;.871;3891000;0
27585;4919;70;0;0;0;0;.00nan;0;0
27585;5154;83;66;27;2;25;.926;3690000;0
27585;5257;70;54;26;3;23;.885;3690000;0
27585;8364;83;0;0;0;0;.00nan;0;0
27587;5107;77;100;43;1;42;.977;3900000;0
27587;6197;74;0;0;0;0;.00nan;0;0
27587;6865;77;0;0;0;0;.00nan;0;0
27587;7528;74;97;35;1;34;.971;3900000;0
27589;4919;70;66;21;1;20;.952;3600000;0
27589;5257;70;0;0;0;0;.00nan;0;0
27589;6720;68;35;33;6;27;.818;3199000;0
27589;8179;68;47;9;1;8;.889;401000;0
27591;4942;63;71;22;2;20;.909;3600000;0
27591;5088;78;0;0;0;0;.00nan;0;0
27591;6916;78;51;38;5;33;.868;3600000;0
27591;8927;63;0;0;0;0;.00nan;0;0
27593;5183;69;67;26;2;24;.923;3582000;0
27593;5372;69;0;0;0;0;.00nan;0;0
27593;6077;65;0;0;0;0;.00nan;0;0
27593;8395;65;91;20;0;20;1.000;3600000;0
27595;4940;62;26;14;4;10;.714;908000;0
27595;6664;66;51;32;4;28;.875;3600000;0
27595;7501;62;37;21;4;17;.810;2692000;0
27595;9669;72;0;0;0;0;.00nan;0;0
27597;5090;74;93;36;2;34;.944;3600000;0
27597;6093;79;0;0;0;0;.00nan;0;0
27597;6701;76;0;0;0;0;.00nan;0;0
27597;6735;79;57;30;4;26;.867;3559000;0
27599;5154;83;0;0;0;0;.00nan;0;0
27599;6840;82;0;0;0;0;.00nan;0;0
27599;8364;83;71;36;3;33;.917;3600000;0
27599;8403;73;87;16;0;16;1.000;3600000;0
27601;5054;72;0;0;0;0;.00nan;0;0
27601;6945;71;77;40;3;37;.925;3660000;0
27601;8147;72;59;31;4;27;.871;3660000;0
27601;8361;71;0;0;0;0;.00nan;0;0
27603;6087;80;0;0;0;0;.00nan;0;0
27603;6799;73;68;21;2;19;.905;3600000;0
27603;7484;73;0;0;0;0;.00nan;0;0
27603;8300;80;50;36;6;30;.833;3600000;0
27605;3837;75;50;0;0;0;.00nan;16000;0
27605;5348;75;54;36;5;31;.861;3584000;0
27605;6825;72;0;0;0;0;.00nan;0;0
27605;9850;65;100;27;0;27;1.000;3600000;0
27607;6751;67;0;0;0;0;.00nan;0;0
27607;7575;81;42;7;2;5;.714;891000;0
27607;8206;81;30;28;6;22;.786;2709000;0
27607;9579;67;49;38;5;33;.868;3600000;0
28378;6077;65;0;0;0;0;.00nan;0;0
28378;6799;73;58;13;1;12;.923;3600000;0
28378;8395;65;52;25;3;22;.880;3600000;0
28378;8403;73;0;0;0;0;.00nan;0;0
28379;5183;69;0;0;0;0;.00nan;0;0
28379;5372;69;58;24;3;21;.875;3600000;0
28379;6720;68;23;13;4;9;.692;1118000;0
28379;8179;68;59;20;2;18;.900;2482000;0
28380;4942;63;49;14;2;12;.857;3600000;0
28380;6664;66;38;42;6;36;.857;3421000;0
28380;8390;66;48;0;0;0;.00nan;179000;0
28380;8927;63;0;0;0;0;.00nan;0;0
28381;4919;70;0;0;0;0;.00nan;0;0
28381;4940;62;69;30;3;27;.900;3559000;0
28381;5257;70;55;22;2;20;.909;3600000;0
28381;7501;62;0;0;0;0;.00nan;0;0
28382;5090;74;0;0;0;0;.00nan;0;0
28382;6093;79;0;0;0;0;.00nan;0;0
28382;6735;79;67;42;4;38;.905;3600000;0
28382;7528;74;61;14;1;13;.929;3600000;0
28383;5088;78;75;36;4;32;.889;3600000;0
28383;6701;76;80;29;1;28;.966;3600000;0
28383;6916;78;0;0;0;0;.00nan;0;0
28383;9564;76;0;0;0;0;.00nan;0;0
28384;6087;80;54;37;3;34;.919;5775000;0
28384;6840;82;92;61;4;57;.934;5775000;0
28384;6921;82;0;0;0;0;.00nan;0;0
28384;8300;80;0;0;0;0;.00nan;0;0
28385;5154;83;0;0;0;0;.00nan;0;0
28385;7575;81;20;18;5;13;.722;1154000;0
28385;8206;81;62;26;3;23;.885;2446000;0
28385;8364;83;34;20;4;16;.800;3600000;0
28386;6077;65;53;3;0;3;1.000;375000;0
28386;6799;73;59;14;1;13;.929;3600000;0
28386;8395;65;60;48;6;42;.875;3225000;0
28386;8403;73;0;0;0;0;.00nan;0;0
28387;5183;69;0;0;0;0;.00nan;0;0
28387;5372;69;100;22;0;22;1.000;3600000;0
28387;6720;68;93;34;1;33;.971;3600000;0
28387;8179;68;0;0;0;0;.00nan;0;0
28388;4942;63;97;24;0;24;1.000;3600000;0
28388;6664;66;32;46;8;38;.826;3600000;0
28388;8390;66;0;0;0;0;.00nan;0;0
28388;8927;63;0;0;0;0;.00nan;0;0
28389;4919;70;0;0;0;0;.00nan;0;0
28389;4940;62;70;30;2;28;.933;3725000;0
28389;5257;70;87;42;3;39;.929;3725000;0
28389;7501;62;0;0;0;0;.00nan;0;0
28390;5090;74;0;0;0;0;.00nan;0;0
28390;6093;79;0;0;0;0;.00nan;0;0
28390;6735;79;76;47;5;42;.894;3600000;0
28390;7528;74;69;22;2;20;.909;3600000;0
28391;5088;78;37;25;5;20;.800;3570000;0
28391;6701;76;49;24;4;20;.833;3600000;0
28391;6916;78;0;0;0;0;.00nan;0;0
28391;9564;76;0;0;0;0;.00nan;0;0
28392;6087;80;56;11;1;10;.909;3600000;0
28392;6840;82;30;31;6;25;.806;3241000;0
28392;6921;82;52;9;1;8;.889;359000;0
28392;8300;80;0;0;0;0;.00nan;0;0
28393;5154;83;0;0;0;0;.00nan;0;0
28393;7575;81;74;34;2;32;.941;4281000;0
28393;8206;81;0;0;0;0;.00nan;0;0
28393;8364;83;71;39;3;36;.923;4281000;0
28394;6077;65;0;0;0;0;.00nan;0;0
28394;6799;73;65;32;4;28;.875;3600000;0
28394;8395;65;40;39;6;33;.846;3552000;0
28394;8403;73;0;0;0;0;.00nan;0;0
28395;5183;69;0;0;0;0;.00nan;0;0
28395;5372;69;63;32;4;28;.875;3600000;0
28395;6720;68;99;26;0;26;1.000;3600000;0
28395;8179;68;0;0;0;0;.00nan;0;0
28396;4942;63;70;34;3;31;.912;3513000;0
28396;6664;66;80;28;1;27;.964;3600000;0
28396;8390;66;0;0;0;0;.00nan;0;0
28396;8927;63;0;0;0;0;.00nan;0;0
28397;4919;70;0;0;0;0;.00nan;0;0
28397;4940;62;62;28;3;25;.893;3600000;0
28397;5257;70;53;27;4;23;.852;3569000;0
28397;7501;62;0;0;0;0;.00nan;0;0
28398;5090;74;0;0;0;0;.00nan;0;0
28398;6093;79;0;0;0;0;.00nan;0;0
28398;6735;79;64;49;6;43;.878;3721000;0
28398;7528;74;33;26;5;21;.808;3721000;0
28399;5088;78;57;25;3;22;.880;3600000;0
28399;6701;76;49;26;4;22;.846;3547000;0
28399;6916;78;0;0;0;0;.00nan;0;0
28399;9564;76;0;0;0;0;.00nan;0;0
28400;6087;80;78;24;2;22;.917;3690000;0
28400;6840;82;0;0;0;0;.00nan;0;0
28400;6921;82;98;36;1;35;.972;3690000;0
28400;8300;80;0;0;0;0;.00nan;0;0
28401;5154;83;74;17;0;17;1.000;1017000;0
28401;7575;81;75;21;1;20;.952;3600000;0
28401;8206;81;0;0;0;0;.00nan;0;0
28401;8364;83;37;34;6;28;.824;2583000;0
28402;6077;65;48;8;1;7;.875;1028000;0
28402;6799;73;61;14;2;12;.857;3600000;0
28402;8395;65;24;27;6;21;.778;2572000;0
28402;8403;73;0;0;0;0;.00nan;0;0
28403;5183;69;0;0;0;0;.00nan;0;0
28403;5372;69;35;30;6;24;.800;3600000;0
28403;6720;68;93;34;1;33;.971;3600000;0
28403;8179;68;0;0;0;0;.00nan;0;0
28404;4942;63;0;0;0;0;.00nan;0;0
28404;6664;66;58;33;3;30;.909;3568000;0
28404;8390;66;0;0;0;0;.00nan;0;0
28404;8927;63;66;26;2;24;.923;3600000;0
28405;4919;70;0;0;0;0;.00nan;0;0
28405;4940;62;75;33;2;31;.939;3907000;0
28405;5257;70;60;28;3;25;.893;3907000;0
28405;7501;62;0;0;0;0;.00nan;0;0
28406;5090;74;0;0;0;0;.00nan;0;0
28406;6093;79;0;0;0;0;.00nan;0;0
28406;6735;79;37;32;5;27;.844;3600000;0
28406;7528;74;82;34;2;32;.941;3600000;0
28407;5088;78;0;0;0;0;.00nan;0;0
28407;6701;76;69;29;2;27;.931;3543000;0
28407;6916;78;70;19;1;18;.947;3600000;0
28407;9564;76;0;0;0;0;.00nan;0;0
28408;6087;80;85;16;0;16;1.000;3600000;0
28408;6840;82;0;0;0;0;.00nan;0;0
28408;6921;82;82;43;4;39;.907;3600000;0
28408;8300;80;0;0;0;0;.00nan;0;0
28409;5154;83;40;36;6;30;.833;2313000;0
28409;7575;81;100;19;0;19;1.000;3600000;0
28409;8206;81;0;0;0;0;.00nan;0;0
28409;8364;83;55;11;1;10;.909;1287000;0
28474;5183;69;0;0;0;0;.00nan;0;0
28474;5372;69;79;33;2;31;.939;3865000;0
28474;6720;68;70;19;1;18;.947;3865000;0
28474;8179;68;0;0;0;0;.00nan;0;0
28475;4942;63;0;0;0;0;.00nan;0;0
28475;6664;66;84;33;2;31;.939;3600000;0
28475;8390;66;0;0;0;0;.00nan;0;0
28475;8927;63;30;24;5;19;.792;3600000;0
28476;4919;70;0;0;0;0;.00nan;0;0
28476;4940;62;70;29;3;26;.897;3723000;0
28476;5257;70;70;26;2;24;.923;3723000;0
28476;7501;62;0;0;0;0;.00nan;0;0
28477;5088;78;0;0;0;0;.00nan;0;0
28477;6701;76;34;13;4;9;.692;903000;0
28477;6916;78;90;37;2;35;.946;3600000;0
28477;9564;76;57;19;2;17;.895;2697000;0
28478;6087;80;48;27;4;23;.852;3600000;0
28478;6840;82;0;0;0;0;.00nan;0;0
28478;6921;82;28;25;6;19;.760;3600000;0
28478;8300;80;0;0;0;0;.00nan;0;0
28479;5154;83;0;0;0;0;.00nan;0;0
28479;7575;81;68;35;3;32;.914;3547000;0
28479;8206;81;0;0;0;0;.00nan;0;0
28479;8364;83;92;39;2;37;.949;3600000;0
28491;5183;69;36;21;4;17;.810;1108000;0
28491;5372;69;46;29;4;25;.862;2492000;0
28491;8179;68;74;19;1;18;.947;3600000;0
28491;9056;68;0;0;0;0;.00nan;0;0
28492;4942;63;0;0;0;0;.00nan;0;0
28492;6664;66;51;37;5;32;.865;3600000;0
28492;8390;66;0;0;0;0;.00nan;0;0
28492;8927;63;50;15;2;13;.867;3600000;0
28493;4919;70;53;2;0;2;1.000;456000;0
28493;4940;62;99;38;1;37;.974;3600000;0
28493;5257;70;27;27;6;21;.778;3144000;0
28493;7501;62;0;0;0;0;.00nan;0;0
28494;5088;78;0;0;0;0;.00nan;0;0
28494;6701;76;0;0;0;0;.00nan;0;0
28494;6916;78;73;30;2;28;.933;3600000;0
28494;9564;76;92;43;3;40;.930;3563000;0
28495;5154;83;0;0;0;0;.00nan;0;0
28495;7575;81;30;22;5;17;.773;3557000;0
28495;8206;81;0;0;0;0;.00nan;0;0
28495;8364;83;75;42;4;38;.905;3600000;0
28512;5154;83;0;0;0;0;.00nan;0;0
28512;7575;81;69;29;3;26;.897;3600000;0
28512;8206;81;0;0;0;0;.00nan;0;0
28512;8364;83;49;31;4;27;.871;3544000;0
28522;6799;73;58;17;2;15;.882;3600000;0
28522;8179;68;66;34;3;31;.912;3556000;0
28522;8403;73;0;0;0;0;.00nan;0;0
28522;9056;68;0;0;0;0;.00nan;0;0
28523;4940;62;84;27;1;26;.963;3830000;0
28523;4942;63;0;0;0;0;.00nan;0;0
28523;7501;62;0;0;0;0;.00nan;0;0
28523;8927;63;73;31;2;29;.935;3830000;0
28524;5088;78;0;0;0;0;.00nan;0;0
28524;5090;74;0;0;0;0;.00nan;0;0
28524;6916;78;77;35;3;32;.914;3564000;0
28524;7528;74;79;32;2;30;.938;3600000;0
28525;6087;80;95;42;2;40;.952;3592000;0
28525;7575;81;73;23;1;22;.957;3600000;0
28525;8206;81;0;0;0;0;.00nan;0;0
28525;8300;80;0;0;0;0;.00nan;0;0
28526;6720;68;0;0;0;0;.00nan;0;0
28526;6799;73;57;20;2;18;.900;3600000;0
28526;8179;68;100;43;1;42;.977;3600000;0
28526;8403;73;0;0;0;0;.00nan;0;0
28527;4940;62;65;26;2;24;.923;3600000;0
28527;4942;63;0;0;0;0;.00nan;0;0
28527;7501;62;0;0;0;0;.00nan;0;0
28527;8927;63;38;31;5;26;.839;3600000;0
28528;5088;78;0;0;0;0;.00nan;0;0
28528;5090;74;0;0;0;0;.00nan;0;0
28528;6916;78;82;36;2;34;.944;3600000;0
28528;7528;74;69;30;3;27;.900;3572000;0
28529;6087;80;57;37;4;33;.892;3549000;0
28529;7575;81;77;30;2;28;.933;3600000;0
28529;8206;81;0;0;0;0;.00nan;0;0
28529;8300;80;0;0;0;0;.00nan;0;0
28530;6720;68;50;0;0;0;.00nan;3000;0
28530;6799;73;37;25;5;20;.800;3600000;0
28530;8179;68;25;41;8;33;.805;3597000;0
28530;8403;73;0;0;0;0;.00nan;0;0
28531;4940;62;59;32;4;28;.875;3547000;0
28531;4942;63;0;0;0;0;.00nan;0;0
28531;7501;62;0;0;0;0;.00nan;0;0
28531;8927;63;70;30;3;27;.900;3600000;0
28532;5088;78;46;28;4;24;.857;3546000;0
28532;5090;74;0;0;0;0;.00nan;0;0
28532;6916;78;0;0;0;0;.00nan;0;0
28532;7528;74;67;31;3;28;.903;3600000;0
28533;6087;80;46;27;4;23;.852;3600000;0
28533;7575;81;56;23;3;20;.870;3600000;0
28533;8206;81;0;0;0;0;.00nan;0;0
28533;8300;80;0;0;0;0;.00nan;0;0
28534;6720;68;0;0;0;0;.00nan;0;0
28534;6799;73;59;18;2;16;.889;5172000;0
28534;8179;68;92;66;3;63;.955;5172000;0
28534;8403;73;0;0;0;0;.00nan;0;0
28535;4940;62;86;53;4;49;.925;4966000;0
28535;4942;63;0;0;0;0;.00nan;0;0
28535;7501;62;0;0;0;0;.00nan;0;0
28535;8927;63;67;35;3;32;.914;4966000;0
28536;5088;78;48;23;4;19;.826;3555000;0
28536;5090;74;0;0;0;0;.00nan;0;0
28536;6916;78;0;0;0;0;.00nan;0;0
28536;7528;74;62;22;2;20;.909;3600000;0
28537;6087;80;78;33;2;31;.939;3600000;0
28537;7575;81;31;16;4;12;.750;3600000;0
28537;8206;81;0;0;0;0;.00nan;0;0
28537;8300;80;0;0;0;0;.00nan;0;0
28622;6720;68;0;0;0;0;.00nan;0;0
28622;6799;73;72;22;2;20;.909;3600000;0
28622;8179;68;82;42;3;39;.929;3583000;0
28622;8403;73;0;0;0;0;.00nan;0;0
28623;4940;62;45;24;4;20;.833;2265000;0
28623;4942;63;0;0;0;0;.00nan;0;0
28623;7501;62;45;12;2;10;.833;1331000;0
28623;8927;63;56;35;4;31;.886;3600000;0
28624;5088;78;26;26;6;20;.769;2976000;0
28624;5090;74;0;0;0;0;.00nan;0;0
28624;6916;78;61;5;0;5;1.000;571000;0
28624;7528;74;43;26;5;21;.808;3600000;0
28625;6087;80;63;39;5;34;.872;3600000;0
28625;7575;81;70;23;1;22;.957;3600000;0
28625;8206;81;0;0;0;0;.00nan;0;0
28625;8300;80;0;0;0;0;.00nan;0;0
28632;4940;62;0;0;0;0;.00nan;0;0
28632;4942;63;0;0;0;0;.00nan;0;0
28632;7501;62;73;31;2;29;.935;3600000;0
28632;8927;63;41;31;5;26;.839;3600000;0
28638;4940;62;0;0;0;0;.00nan;0;0
28638;4942;63;0;0;0;0;.00nan;0;0
28638;7501;62;60;28;3;25;.893;3600000;0
28638;8927;63;53;27;4;23;.852;3551000;0
28642;4940;62;0;0;0;0;.00nan;0;0
28642;6799;73;77;27;2;25;.926;3600000;0
28642;7501;62;38;37;6;31;.838;3600000;0
28642;8403;73;0;0;0;0;.00nan;0;0
28643;5090;74;0;0;0;0;.00nan;0;0
28643;7528;74;51;32;5;27;.844;3576000;0
28643;7575;81;47;26;4;22;.846;3600000;0
28643;8206;81;0;0;0;0;.00nan;0;0
28644;4940;62;0;0;0;0;.00nan;0;0
28644;6799;73;84;35;2;33;.943;4335000;0
28644;7501;62;89;41;3;38;.927;4335000;0
28644;8403;73;0;0;0;0;.00nan;0;0
28645;5090;74;0;0;0;0;.00nan;0;0
28645;7528;74;65;24;2;22;.917;3600000;0
28645;7575;81;64;34;4;30;.882;3559000;0
28645;8206;81;0;0;0;0;.00nan;0;0
28646;4940;62;0;0;0;0;.00nan;0;0
28646;6799;73;84;23;1;22;.957;3600000;0
28646;7501;62;87;61;5;56;.918;3600000;0
28646;8403;73;0;0;0;0;.00nan;0;0
28647;5090;74;0;0;0;0;.00nan;0;0
28647;7528;74;94;62;4;58;.935;5533000;0
28647;7575;81;76;42;3;39;.929;5533000;0
28647;8206;81;0;0;0;0;.00nan;0;0
28648;4940;62;45;7;1;6;.857;1036000;0
28648;6799;73;40;35;6;29;.829;3600000;0
28648;7501;62;18;27;7;20;.741;2505000;0
28648;8403;73;0;0;0;0;.00nan;0;0
28649;5090;74;44;4;1;3;.750;510000;0
28649;7528;74;40;29;6;23;.793;3090000;0
28649;7575;81;84;30;1;29;.967;3600000;0
28649;8206;81;0;0;0;0;.00nan;0;0
28693;5090;74;85;38;1;37;.974;4290000;0
28693;7528;74;0;0;0;0;.00nan;0;0
28693;7575;81;66;27;2;25;.926;4290000;0
28693;8206;81;0;0;0;0;.00nan;0;0
28715;5090;74;70;32;3;29;.906;3600000;0
28715;7528;74;0;0;0;0;.00nan;0;0
28715;7575;81;26;30;6;24;.800;3403000;0
28715;8206;81;49;2;0;2;1.000;197000;0
28717;5090;74;45;33;4;29;.879;3511000;0
28717;7528;74;0;0;0;0;.00nan;0;0
28717;7575;81;68;25;2;23;.920;3600000;0
28717;8206;81;0;0;0;0;.00nan;0;0
28719;6799;73;73;22;1;21;.955;3600000;0
28719;7575;81;79;60;5;55;.917;3600000;0
28719;8206;81;0;0;0;0;.00nan;0;0
28719;8403;73;0;0;0;0;.00nan;0;0
28720;6799;73;77;26;3;23;.885;3678000;0
28720;7575;81;71;40;4;36;.900;3678000;0
28720;8206;81;0;0;0;0;.00nan;0;0
28720;8403;73;0;0;0;0;.00nan;0;0
28721;6799;73;94;31;2;29;.935;3722000;0
28721;7575;81;68;31;3;28;.903;3722000;0
28721;8206;81;0;0;0;0;.00nan;0;0
28721;8403;73;0;0;0;0;.00nan;0;0
28722;6799;73;38;21;4;17;.810;3633000;0
28722;7575;81;38;29;5;24;.828;3633000;0
28722;8206;81;0;0;0;0;.00nan;0;0
28722;8403;73;0;0;0;0;.00nan;0;0
27608;5714;106;0;0;0;0;.00nan;0;0
27608;5808;105;69;44;4;40;.909;3547000;0
27608;7063;106;54;21;3;18;.857;3600000;0
27608;7145;105;0;0;0;0;.00nan;0;0
27609;5714;106;37;25;5;20;.800;3900000;0
27609;7063;106;0;0;0;0;.00nan;0;0
27609;7192;104;65;44;5;39;.886;3900000;0
27609;10126;104;0;0;0;0;.00nan;0;0
27610;5492;117;0;0;0;0;.00nan;0;0
27610;5655;117;59;48;6;42;.875;3688000;0
27610;8515;118;38;30;5;25;.833;3688000;0
27610;8534;118;0;0;0;0;.00nan;0;0
27611;7160;112;61;25;2;23;.920;3600000;0
27611;8562;111;34;23;5;18;.783;3600000;0
27611;9208;106;0;0;0;0;.00nan;0;0
27611;10008;109;0;0;0;0;.00nan;0;0
27612;5651;107;26;32;7;25;.781;3600000;0
27612;5832;110;0;0;0;0;.00nan;0;0
27612;6248;107;0;0;0;0;.00nan;0;0
27612;7251;110;71;30;3;27;.900;3600000;0
27613;6250;116;54;3;0;3;1.000;405000;0
27613;6326;116;16;26;7;19;.731;3154000;0
27613;7678;119;0;0;0;0;.00nan;0;0
27613;8676;119;44;31;5;26;.839;3600000;0
27614;6311;120;0;0;0;0;.00nan;0;0
27614;7141;120;56;44;6;38;.864;3600000;0
27614;9106;115;0;0;0;0;.00nan;0;0
27614;9214;115;26;23;5;18;.783;3600000;0
27615;5611;114;0;0;0;0;.00nan;0;0
27615;5614;114;33;34;6;28;.824;3600000;0
27615;7095;108;55;40;5;35;.875;3600000;0
27615;9148;121;0;0;0;0;.00nan;0;0
27616;7109;115;25;22;5;17;.773;2251000;0
27616;7263;-1;62;13;0;13;1.000;1649000;0
27616;7673;113;52;37;5;32;.865;3900000;0
27616;8685;113;0;0;0;0;.00nan;0;0
27617;5492;117;20;26;6;20;.769;3444000;0
27617;5655;117;48;0;0;0;.00nan;156000;0
27617;8515;118;0;0;0;0;.00nan;0;0
27617;8534;118;80;34;2;32;.941;3600000;0
27618;7095;108;0;0;0;0;.00nan;0;0
27618;8562;111;0;0;0;0;.00nan;0;0
27618;9148;121;73;40;3;37;.925;3900000;0
27618;9208;106;53;19;3;16;.842;3900000;0
27619;5651;107;34;21;4;17;.810;1526000;0
27619;6248;107;57;38;5;33;.868;2074000;0
27619;7160;112;0;0;0;0;.00nan;0;0
27619;10008;109;53;26;3;23;.885;3600000;0
27620;6250;116;60;29;3;26;.897;3600000;0
27620;6311;120;73;28;1;27;.964;3600000;0
27620;6326;116;0;0;0;0;.00nan;0;0
27620;7141;120;0;0;0;0;.00nan;0;0
27621;7678;119;26;27;6;21;.778;1671000;0
27621;8676;119;54;26;4;22;.846;1929000;0
27621;9106;115;55;22;3;19;.864;3600000;0
27621;9214;115;0;0;0;0;.00nan;0;0
27622;7109;115;43;41;7;34;.829;3545000;0
27622;7263;-1;47;2;0;2;1.000;355000;0
27622;7673;113;67;17;1;16;.941;1478000;0
27622;8685;113;22;26;6;20;.769;2422000;0
27623;5551;108;89;20;0;20;1.000;3600000;0
27623;5786;105;0;0;0;0;.00nan;0;0
27623;5808;105;0;0;0;0;.00nan;0;0
27623;7145;105;98;55;2;53;.964;3569000;0
27624;5611;114;0;0;0;0;.00nan;0;0
27624;5614;114;40;36;6;30;.833;3600000;0
27624;5832;110;74;21;1;20;.952;3600000;0
27624;7251;110;0;0;0;0;.00nan;0;0
27625;5551;108;66;33;4;29;.879;3618000;0
27625;5786;105;0;0;0;0;.00nan;0;0
27625;7192;104;0;0;0;0;.00nan;0;0
27625;10126;104;35;26;5;21;.808;3618000;0
27626;5808;105;84;52;5;47;.904;3600000;0
27626;7095;108;95;25;1;24;.960;3600000;0
27626;7145;105;0;0;0;0;.00nan;0;0
27626;9148;121;0;0;0;0;.00nan;0;0
27627;8515;118;19;22;6;16;.727;2908000;0
27627;8534;118;54;4;0;4;1.000;692000;0
27627;9106;115;0;0;0;0;.00nan;0;0
27627;9214;115;93;21;0;21;1.000;3600000;0
27628;5651;107;87;39;2;37;.949;3600000;0
27628;6248;107;0;0;0;0;.00nan;0;0
27628;7109;115;51;29;4;25;.862;3565000;0
27628;7263;-1;0;0;0;0;.00nan;0;0
27629;6250;116;0;0;0;0;.00nan;0;0
27629;6311;120;0;0;0;0;.00nan;0;0
27629;6326;116;57;28;3;25;.893;3600000;0
27629;7141;120;31;25;5;20;.800;3541000;0
27630;5714;106;0;0;0;0;.00nan;0;0
27630;7063;106;50;48;7;41;.854;3600000;0
27630;8562;111;55;23;3;20;.870;3600000;0
27630;9208;106;0;0;0;0;.00nan;0;0
27631;5611;114;0;0;0;0;.00nan;0;0
27631;5614;114;56;34;4;30;.882;3528000;0
27631;5808;105;0;0;0;0;.00nan;0;0
27631;7145;105;80;34;2;32;.941;3600000;0
27632;7160;112;90;56;5;51;.911;3600000;0
27632;7673;113;45;17;3;14;.824;3600000;0
27632;8685;113;0;0;0;0;.00nan;0;0
27632;10008;109;0;0;0;0;.00nan;0;0
27633;5832;110;33;4;2;2;.500;608000;0
27633;7192;104;47;29;5;24;.828;3600000;0
27633;7251;110;52;42;6;36;.857;2992000;0
27633;10126;104;0;0;0;0;.00nan;0;0
27634;5551;108;85;43;3;40;.930;3600000;0
27634;5786;105;0;0;0;0;.00nan;0;0
27634;7095;108;58;9;1;8;.889;1445000;0
27634;9148;121;13;23;6;17;.739;2155000;0
27635;6250;116;67;41;5;36;.878;3600000;0
27635;6326;116;0;0;0;0;.00nan;0;0
27635;8515;118;0;0;0;0;.00nan;0;0
27635;8534;118;68;19;1;18;.947;3600000;0
27636;5651;107;44;5;1;4;.800;799000;0
27636;6248;107;18;36;8;28;.778;2801000;0
27636;8562;111;0;0;0;0;.00nan;0;0
27636;9208;106;76;22;1;21;.955;3600000;0
27637;5611;114;62;40;4;36;.900;3571000;0
27637;5614;114;0;0;0;0;.00nan;0;0
27637;5808;105;43;20;3;17;.850;3600000;0
27637;7145;105;0;0;0;0;.00nan;0;0
27638;5492;117;0;0;0;0;.00nan;0;0
27638;5655;117;65;37;4;33;.892;3574000;0
27638;7678;119;67;33;3;30;.909;3600000;0
27638;8676;119;0;0;0;0;.00nan;0;0
27639;5551;108;0;0;0;0;.00nan;0;0
27639;5786;105;46;35;5;30;.857;3595000;0
27639;7192;104;0;0;0;0;.00nan;0;0
27639;10126;104;72;35;3;32;.914;3600000;0
27640;7109;115;100;26;0;26;1.000;3600000;0
27640;7160;112;0;0;0;0;.00nan;0;0
27640;7263;-1;0;0;0;0;.00nan;0;0
27640;10008;109;62;26;3;23;.885;3600000;0
27641;6311;120;37;37;6;31;.838;3138000;0
27641;7141;120;39;1;1;0;.000;462000;0
27641;9106;115;0;0;0;0;.00nan;0;0
27641;9214;115;42;25;4;21;.840;3600000;0
27642;5832;110;0;0;0;0;.00nan;0;0
27642;7251;110;98;53;3;50;.943;3900000;0
27642;7673;113;0;0;0;0;.00nan;0;0
27642;8685;113;63;25;3;22;.880;3900000;0
27643;5492;117;91;38;2;36;.947;3600000;0
27643;5655;117;0;0;0;0;.00nan;0;0
27643;7678;119;0;0;0;0;.00nan;0;0
27643;8676;119;30;29;5;24;.828;3600000;0
27644;5714;106;0;0;0;0;.00nan;0;0
27644;6319;121;43;38;6;32;.842;3600000;0
27644;7063;106;71;28;2;26;.929;3600000;0
27644;7095;108;0;0;0;0;.00nan;0;0
27645;7160;112;98;40;1;39;.975;3600000;0
27645;7192;104;48;22;3;19;.864;3569000;0
27645;10008;109;0;0;0;0;.00nan;0;0
27645;10126;104;0;0;0;0;.00nan;0;0
27646;5492;117;0;0;0;0;.00nan;0;0
27646;5655;117;47;46;7;39;.848;3831000;0
27646;7673;113;39;38;6;32;.842;3831000;0
27646;8685;113;0;0;0;0;.00nan;0;0
27647;5832;110;50;0;0;0;.00nan;18000;0
27647;6250;116;51;25;4;21;.840;3600000;0
27647;6326;116;0;0;0;0;.00nan;0;0
27647;7251;110;38;38;6;32;.842;3502000;0
27648;5651;107;0;0;0;0;.00nan;0;0
27648;6248;107;72;57;5;52;.912;3600000;0
27648;9106;115;46;17;3;14;.824;3600000;0
27648;9214;115;0;0;0;0;.00nan;0;0
27649;5808;105;0;0;0;0;.00nan;0;0
27649;7145;105;61;25;3;22;.880;3600000;0
27649;7160;112;0;0;0;0;.00nan;0;0
27649;10008;109;37;42;7;35;.833;3600000;0
27650;6319;121;0;0;0;0;.00nan;0;0
27650;7095;108;53;18;2;16;.889;3600000;0
27650;7109;115;93;31;1;30;.968;3600000;0
27650;7263;-1;0;0;0;0;.00nan;0;0
27651;5611;114;0;0;0;0;.00nan;0;0
27651;5614;114;81;46;3;43;.935;3600000;0
27651;7050;118;0;0;0;0;.00nan;0;0
27651;8515;118;59;27;4;23;.852;3559000;0
27652;6311;120;0;0;0;0;.00nan;0;0
27652;7141;120;75;29;2;27;.931;3600000;0
27652;7678;119;0;0;0;0;.00nan;0;0
27652;8676;119;63;49;5;44;.898;3600000;0
27653;5551;108;90;56;4;52;.929;3600000;0
27653;5714;106;47;36;5;31;.861;3592000;0
27653;5786;105;0;0;0;0;.00nan;0;0
27653;7063;106;0;0;0;0;.00nan;0;0
27654;5492;117;75;23;2;21;.913;3600000;0
27654;5655;117;0;0;0;0;.00nan;0;0
27654;7109;115;0;0;0;0;.00nan;0;0
27654;7263;-1;52;38;5;33;.868;3600000;0
27655;5832;110;0;0;0;0;.00nan;0;0
27655;7192;104;43;9;2;7;.778;3600000;0
27655;7251;110;71;50;6;44;.880;3600000;0
27655;10126;104;0;0;0;0;.00nan;0;0
27656;5651;107;42;30;5;25;.833;2337000;0
27656;6248;107;49;9;1;8;.889;1205000;0
27656;6319;121;0;0;0;0;.00nan;0;0
27656;7095;108;68;31;4;27;.871;3600000;0
27657;6250;116;41;3;1;2;.667;163000;0
27657;6326;116;56;45;6;39;.867;3437000;0
27657;8562;111;54;35;4;31;.886;3600000;0
27657;9208;106;0;0;0;0;.00nan;0;0
27658;5808;105;42;29;5;24;.828;2313000;0
27658;7145;105;25;26;6;20;.769;1287000;0
27658;9106;115;0;0;0;0;.00nan;0;0
27658;9214;115;73;9;0;9;1.000;3600000;0
27659;5611;114;0;0;0;0;.00nan;0;0
27659;5614;114;50;49;6;43;.878;3600000;0
27659;6311;120;64;24;2;22;.917;3600000;0
27659;7141;120;0;0;0;0;.00nan;0;0
27660;7160;112;36;20;4;16;.800;979000;0
27660;7673;113;0;0;0;0;.00nan;0;0
27660;8685;113;24;18;5;13;.722;3600000;0
27660;10008;109;78;42;4;38;.905;2621000;0
27661;7050;118;99;38;2;36;.947;3900000;0
27661;7678;119;63;25;2;23;.920;3900000;0
27661;8515;118;0;0;0;0;.00nan;0;0
27661;8676;119;0;0;0;0;.00nan;0;0
27662;5492;117;0;0;0;0;.00nan;0;0
27662;5655;117;100;31;0;31;1.000;3600000;0
27662;8562;111;0;0;0;0;.00nan;0;0
27662;9208;106;49;22;3;19;.864;3600000;0
27663;5808;105;77;44;4;40;.909;3600000;0
27663;5832;110;30;27;6;21;.778;3039000;0
27663;7145;105;0;0;0;0;.00nan;0;0
27663;7251;110;49;1;0;1;1.000;513000;0
27664;6250;116;81;40;4;36;.900;3686000;0
27664;6326;116;0;0;0;0;.00nan;0;0
27664;7109;115;72;29;3;26;.897;3686000;0
27664;7263;-1;0;0;0;0;.00nan;0;0
27665;7192;104;0;0;0;0;.00nan;0;0
27665;9106;115;0;0;0;0;.00nan;0;0
27665;9214;115;78;60;6;54;.900;3600000;0
27665;10126;104;61;26;3;23;.885;3600000;0
27666;5714;106;0;0;0;0;.00nan;0;0
27666;7063;106;72;27;2;25;.926;3600000;0
27666;7673;113;58;29;4;25;.862;3515000;0
27666;8685;113;0;0;0;0;.00nan;0;0
27667;5551;108;45;24;4;20;.833;2591000;0
27667;5651;107;58;5;0;5;1.000;906000;0
27667;5786;105;28;14;4;10;.714;967000;0
27667;6248;107;62;46;6;40;.870;2694000;0
27668;6311;120;0;0;0;0;.00nan;0;0
27668;7050;118;0;0;0;0;.00nan;0;0
27668;7141;120;50;24;3;21;.875;3514000;0
27668;8515;118;99;40;1;39;.975;3600000;0
27669;5611;114;21;22;6;16;.727;2195000;0
27669;5614;114;49;14;2;12;.857;1405000;0
27669;7678;119;0;0;0;0;.00nan;0;0
27669;8676;119;65;25;2;23;.920;3600000;0
27670;6319;121;0;0;0;0;.00nan;0;0
27670;7095;108;97;36;1;35;.972;3600000;0
27670;7673;113;0;0;0;0;.00nan;0;0
27670;8685;113;79;41;3;38;.927;3516000;0
27671;5714;106;52;32;4;28;.875;3900000;0
27671;7063;106;0;0;0;0;.00nan;0;0
27671;7160;112;75;43;4;39;.907;3900000;0
27671;10008;109;0;0;0;0;.00nan;0;0
27672;5714;106;0;0;0;0;.00nan;0;0
27672;5832;110;0;0;0;0;.00nan;0;0
27672;7063;106;50;40;5;35;.875;3580000;0
27672;7251;110;87;50;4;46;.920;3600000;0
27673;5492;117;48;0;0;0;.00nan;287000;0
27673;5655;117;46;47;7;40;.851;3228000;0
27673;9106;115;0;0;0;0;.00nan;0;0
27673;9214;115;44;31;5;26;.839;3600000;0
27674;5551;108;60;28;4;24;.857;3701000;0
27674;5786;105;0;0;0;0;.00nan;0;0
27674;7109;115;68;44;5;39;.886;3701000;0
27674;7263;-1;0;0;0;0;.00nan;0;0
27675;5808;105;60;45;5;40;.889;3600000;0
27675;7050;118;0;0;0;0;.00nan;0;0
27675;7145;105;0;0;0;0;.00nan;0;0
27675;8515;118;72;25;2;23;.920;3600000;0
27676;6250;116;0;0;0;0;.00nan;0;0
27676;6326;116;80;39;4;35;.897;3600000;0
27676;7678;119;0;0;0;0;.00nan;0;0
27676;8676;119;28;31;6;25;.806;3598000;0
27677;5551;108;0;0;0;0;.00nan;0;0
27677;5786;105;89;28;1;27;.964;3600000;0
27677;8562;111;66;37;4;33;.892;3600000;0
27677;9208;106;0;0;0;0;.00nan;0;0
27678;5714;106;93;41;1;40;.976;3600000;0
27678;7063;106;0;0;0;0;.00nan;0;0
27678;7109;115;0;0;0;0;.00nan;0;0
27678;7263;-1;68;34;3;31;.912;3548000;0
27679;5611;114;0;0;0;0;.00nan;0;0
27679;5614;114;95;58;3;55;.948;3585000;0
27679;8562;111;0;0;0;0;.00nan;0;0
27679;9208;106;56;19;2;17;.895;3600000;0
27680;6250;116;37;42;7;35;.833;3403000;0
27680;6326;116;39;1;1;0;.000;197000;0
27680;9106;115;79;29;2;27;.931;3600000;0
27680;9214;115;0;0;0;0;.00nan;0;0
27681;5808;105;0;0;0;0;.00nan;0;0
27681;6311;120;0;0;0;0;.00nan;0;0
27681;7141;120;53;14;2;12;.857;3561000;0
27681;7145;105;100;65;1;64;.985;3600000;0
27682;5651;107;56;28;4;24;.857;3900000;0
27682;6248;107;0;0;0;0;.00nan;0;0
27682;7160;112;0;0;0;0;.00nan;0;0
27682;10008;109;67;39;4;35;.897;3900000;0
27683;7192;104;16;8;4;4;.500;733000;0
27683;7678;119;87;44;4;40;.909;3600000;0
27683;8676;119;0;0;0;0;.00nan;0;0
27683;10126;104;36;22;5;17;.773;2867000;0
27684;6319;121;69;45;5;40;.889;3580000;0
27684;7095;108;0;0;0;0;.00nan;0;0
27684;7673;113;63;25;3;22;.880;3600000;0
27684;8685;113;0;0;0;0;.00nan;0;0
27685;6311;120;43;24;4;20;.833;3600000;0
27685;7050;118;42;39;6;33;.846;2822000;0
27685;7141;120;0;0;0;0;.00nan;0;0
27685;8515;118;55;5;0;5;1.000;722000;0
27686;5832;110;96;37;1;36;.973;3600000;0
27686;7109;115;52;30;4;26;.867;3600000;0
27686;7251;110;0;0;0;0;.00nan;0;0
27686;7263;-1;0;0;0;0;.00nan;0;0
27687;5714;106;0;0;0;0;.00nan;0;0
27687;7063;106;69;30;2;28;.933;3639000;0
27687;7160;112;71;36;3;33;.917;3639000;0
27687;10008;109;0;0;0;0;.00nan;0;0
27688;5551;108;73;26;2;24;.923;3600000;0
27688;5651;107;0;0;0;0;.00nan;0;0
27688;5786;105;0;0;0;0;.00nan;0;0
27688;6248;107;51;38;5;33;.868;3600000;0
27689;5492;117;0;0;0;0;.00nan;0;0
27689;5655;117;67;43;5;38;.884;3900000;0
27689;7192;104;52;36;5;31;.861;3900000;0
27689;10126;104;0;0;0;0;.00nan;0;0
27690;5651;107;74;37;3;34;.919;3544000;0
27690;5832;110;0;0;0;0;.00nan;0;0
27690;6248;107;0;0;0;0;.00nan;0;0
27690;7251;110;87;29;2;27;.931;3600000;0
27691;7673;113;64;35;4;31;.886;3600000;0
27691;8562;111;24;23;6;17;.739;2866000;0
27691;8685;113;0;0;0;0;.00nan;0;0
27691;9208;106;45;5;1;4;.800;734000;0
27692;5492;117;26;13;4;9;.692;1016000;0
27692;5655;117;59;15;1;14;.933;2584000;0
27692;5808;105;100;37;0;37;1.000;3600000;0
27692;7145;105;0;0;0;0;.00nan;0;0
27693;7678;119;0;0;0;0;.00nan;0;0
27693;8676;119;83;44;3;41;.932;3572000;0
27693;9106;115;0;0;0;0;.00nan;0;0
27693;9214;115;73;22;2;20;.909;3600000;0
27694;6250;116;67;44;3;41;.932;3900000;0
27694;6326;116;0;0;0;0;.00nan;0;0
27694;7192;104;0;0;0;0;.00nan;0;0
27694;10126;104;58;23;3;20;.870;3900000;0
27695;5611;114;0;0;0;0;.00nan;0;0
27695;5614;114;72;33;2;31;.939;3600000;0
27695;6319;121;0;0;0;0;.00nan;0;0
27695;8628;121;84;40;3;37;.925;3579000;0
27696;6250;116;52;25;3;22;.880;1306000;0
27696;6311;120;0;0;0;0;.00nan;0;0
27696;6326;116;25;35;7;28;.800;2294000;0
27696;7141;120;59;19;2;17;.895;3600000;0
27697;5551;108;0;0;0;0;.00nan;0;0
27697;5611;114;29;32;6;26;.813;3600000;0
27697;5614;114;0;0;0;0;.00nan;0;0
27697;7095;108;67;38;3;35;.921;3600000;0
27698;6319;121;59;23;3;20;.870;3600000;0
27698;7160;112;0;0;0;0;.00nan;0;0
27698;8628;121;0;0;0;0;.00nan;0;0
27698;10008;109;84;50;4;46;.920;3549000;0
27699;7109;115;42;26;4;22;.846;3590000;0
27699;7263;-1;0;0;0;0;.00nan;0;0
27699;7673;113;0;0;0;0;.00nan;0;0
27699;8685;113;54;18;2;16;.889;3600000;0
27700;5492;117;41;38;6;32;.842;1595000;0
27700;5655;117;71;26;2;24;.923;2005000;0
27700;6311;120;62;23;3;20;.870;3600000;0
27700;7141;120;0;0;0;0;.00nan;0;0
27701;5832;110;0;0;0;0;.00nan;0;0
27701;7251;110;90;38;2;36;.947;3900000;0
27701;8562;111;79;36;2;34;.944;3900000;0
27701;9208;106;0;0;0;0;.00nan;0;0
27702;5651;107;39;1;1;0;.000;454000;0
27702;6248;107;23;32;6;26;.813;3146000;0
27702;6319;121;0;0;0;0;.00nan;0;0
27702;8628;121;58;23;3;20;.870;3600000;0
27703;7050;118;0;0;0;0;.00nan;0;0
27703;7678;119;0;0;0;0;.00nan;0;0
27703;8515;118;77;31;2;29;.935;3600000;0
27703;8676;119;46;23;3;20;.870;3600000;0
27704;7109;115;0;0;0;0;.00nan;0;0
27704;7263;-1;40;31;5;26;.839;3600000;0
27704;8562;111;0;0;0;0;.00nan;0;0
27704;9208;106;73;27;2;25;.926;3600000;0
27705;5651;107;40;30;5;25;.833;1992000;0
27705;5714;106;28;32;6;26;.813;3600000;0
27705;6248;107;25;19;5;14;.737;1608000;0
27705;7063;106;0;0;0;0;.00nan;0;0
27706;5832;110;81;36;2;34;.944;3900000;0
27706;6319;121;0;0;0;0;.00nan;0;0
27706;7251;110;0;0;0;0;.00nan;0;0
27706;8628;121;61;17;2;15;.882;3900000;0
27707;5492;117;13;13;5;8;.615;1139000;0
27707;5655;117;42;21;4;17;.810;2461000;0
27707;6250;116;62;35;5;30;.857;3600000;0
27707;6326;116;0;0;0;0;.00nan;0;0
27708;7050;118;83;37;3;34;.919;3600000;0
27708;8515;118;0;0;0;0;.00nan;0;0
27708;9106;115;0;0;0;0;.00nan;0;0
27708;9214;115;65;30;4;26;.867;3573000;0
27709;5611;114;0;0;0;0;.00nan;0;0
27709;5614;114;92;55;3;52;.945;3596000;0
27709;7673;113;63;26;2;24;.923;3609000;0
27709;8685;113;0;0;0;0;.00nan;0;0
27710;6311;120;0;0;0;0;.00nan;0;0
27710;7141;120;71;35;3;32;.914;3600000;0
27710;7678;119;65;32;4;28;.875;3574000;0
27710;8676;119;0;0;0;0;.00nan;0;0
27711;5551;108;68;39;4;35;.897;3600000;0
27711;7095;108;0;0;0;0;.00nan;0;0
27711;7160;112;0;0;0;0;.00nan;0;0
27711;10008;109;36;26;5;21;.808;3591000;0
27712;5808;105;98;53;4;49;.925;3600000;0
27712;7145;105;0;0;0;0;.00nan;0;0
27712;7192;104;52;24;3;21;.875;3600000;0
27712;7655;104;0;0;0;0;.00nan;0;0
27713;7050;118;0;0;0;0;.00nan;0;0
27713;8515;118;48;32;5;27;.844;3571000;0
27713;9106;115;40;26;4;22;.846;3600000;0
27713;9214;115;0;0;0;0;.00nan;0;0
27714;5492;117;0;0;0;0;.00nan;0;0
27714;5655;117;54;44;6;38;.864;3600000;0
27714;6250;116;0;0;0;0;.00nan;0;0
27714;6326;116;83;33;2;31;.939;3600000;0
27715;6311;120;82;25;1;24;.960;3600000;0
27715;7141;120;0;0;0;0;.00nan;0;0
27715;7678;119;0;0;0;0;.00nan;0;0
27715;8676;119;92;52;4;48;.923;3600000;0
27716;7109;115;76;33;3;30;.909;3600000;0
27716;7263;-1;0;0;0;0;.00nan;0;0
27716;8562;111;48;38;5;33;.868;3600000;0
27716;9208;106;0;0;0;0;.00nan;0;0
27717;5808;105;50;0;0;0;.00nan;5000;0
27717;7145;105;72;47;4;43;.915;3581000;0
27717;7192;104;0;0;0;0;.00nan;0;0
27717;7655;104;65;13;1;12;.923;3600000;0
27718;5651;107;30;27;6;21;.778;2287000;0
27718;5714;106;0;0;0;0;.00nan;0;0
27718;6248;107;57;17;1;16;.941;1313000;0
27718;7063;106;61;18;2;16;.889;3600000;0
27719;5611;114;0;0;0;0;.00nan;0;0
27719;5614;114;82;32;2;30;.938;3600000;0
27719;7673;113;0;0;0;0;.00nan;0;0
27719;8685;113;49;30;4;26;.867;3544000;0
27720;5551;108;0;0;0;0;.00nan;0;0
27720;7095;108;88;32;2;30;.938;3600000;0
27720;7160;112;16;14;5;9;.643;1647000;0
27720;10008;109;1;15;7;8;.533;1953000;0
27721;5832;110;50;0;0;0;.00nan;0;0
27721;6319;121;50;23;4;19;.826;3600000;0
27721;7251;110;59;41;5;36;.878;3600000;0
27721;8628;121;0;0;0;0;.00nan;0;0
27722;5651;107;66;13;0;13;1.000;780000;0
27722;6248;107;58;46;6;40;.870;2820000;0
27722;7192;104;57;28;3;25;.893;3600000;0
27722;7655;104;0;0;0;0;.00nan;0;0
27723;5611;114;48;0;0;0;.00nan;119000;0
27723;5614;114;57;46;6;40;.870;3481000;0
27723;7109;115;67;31;3;28;.903;3600000;0
27723;7263;-1;0;0;0;0;.00nan;0;0
27724;7673;113;67;25;2;23;.920;3600000;0
27724;8562;111;28;13;4;9;.692;1176000;0
27724;8685;113;0;0;0;0;.00nan;0;0
27724;9208;106;54;24;3;21;.875;2424000;0
27725;5651;107;61;43;4;39;.907;3550000;0
27725;5808;105;0;0;0;0;.00nan;0;0
27725;6248;107;0;0;0;0;.00nan;0;0
27725;7145;105;46;22;3;19;.864;3600000;0
27726;7160;112;56;22;3;19;.864;3556000;0
27726;7678;119;0;0;0;0;.00nan;0;0
27726;8676;119;70;33;2;31;.939;3600000;0
27726;10008;109;0;0;0;0;.00nan;0;0
27727;5808;105;84;38;2;36;.947;3600000;0
27727;7050;118;67;24;3;21;.875;3570000;0
27727;7145;105;0;0;0;0;.00nan;0;0
27727;8515;118;0;0;0;0;.00nan;0;0
27728;5714;106;0;0;0;0;.00nan;0;0
27728;6311;120;0;0;0;0;.00nan;0;0
27728;7063;106;71;48;5;43;.896;3600000;0
27728;7141;120;51;16;2;14;.875;3600000;0
27729;7160;112;0;0;0;0;.00nan;0;0
27729;9106;115;0;0;0;0;.00nan;0;0
27729;9214;115;18;20;6;14;.700;3600000;0
27729;10008;109;91;47;3;44;.936;3600000;0
27730;5492;117;0;0;0;0;.00nan;0;0
27730;5655;117;54;33;5;28;.848;3870000;0
27730;6319;121;0;0;0;0;.00nan;0;0
27730;8628;121;58;41;6;35;.854;3870000;0
27731;7050;118;46;8;1;7;.875;748000;0
27731;7192;104;55;22;2;20;.909;3600000;0
27731;7655;104;0;0;0;0;.00nan;0;0
27731;8515;118;40;40;6;34;.850;2852000;0
27732;5611;114;54;9;1;8;.889;730000;0
27732;5614;114;32;29;6;23;.793;2870000;0
27732;5832;110;0;0;0;0;.00nan;0;0
27732;7251;110;59;32;4;28;.875;3600000;0
27733;6250;116;53;24;4;20;.833;3600000;0
27733;6326;116;0;0;0;0;.00nan;0;0
27733;9106;115;59;44;5;39;.886;3589000;0
27733;9214;115;0;0;0;0;.00nan;0;0
27734;5551;108;0;0;0;0;.00nan;0;0
27734;7095;108;56;35;5;30;.857;3615000;0
27734;7673;113;52;46;6;40;.870;3615000;0
27734;8685;113;0;0;0;0;.00nan;0;0
27735;5714;106;37;36;7;29;.806;2667000;0
27735;7063;106;49;9;1;8;.889;933000;0
27735;7109;115;75;33;3;30;.909;3600000;0
27735;7263;-1;0;0;0;0;.00nan;0;0
27736;5808;105;0;0;0;0;.00nan;0;0
27736;6311;120;65;13;1;12;.923;3600000;0
27736;7141;120;0;0;0;0;.00nan;0;0
27736;7145;105;65;60;7;53;.883;3600000;0
27737;5832;110;32;30;6;24;.800;1997000;0
27737;7251;110;63;10;0;10;1.000;1537000;0
27737;8562;111;45;24;4;20;.833;3600000;0
27737;9208;106;0;0;0;0;.00nan;0;0
27738;6250;116;0;0;0;0;.00nan;0;0
27738;6326;116;60;28;4;24;.857;3631000;0
27738;7678;119;0;0;0;0;.00nan;0;0
27738;8676;119;54;26;3;23;.885;3624000;0
27739;5551;108;84;28;1;27;.964;3600000;0
27739;5611;114;77;45;3;42;.933;3600000;0
27739;5614;114;0;0;0;0;.00nan;0;0
27739;7095;108;0;0;0;0;.00nan;0;0
27740;5492;117;36;33;6;27;.818;3887000;0
27740;5655;117;0;0;0;0;.00nan;0;0
27740;7160;112;0;0;0;0;.00nan;0;0
27740;10008;109;52;46;6;40;.870;3900000;0
27741;6319;121;0;0;0;0;.00nan;0;0
27741;8628;121;77;46;4;42;.913;3600000;0
27741;9106;115;0;0;0;0;.00nan;0;0
27741;9214;115;61;22;2;20;.909;3600000;0
27742;5651;107;0;0;0;0;.00nan;0;0
27742;6248;107;86;49;4;45;.918;3600000;0
27742;7050;118;0;0;0;0;.00nan;0;0
27742;8515;118;64;29;3;26;.897;3600000;0
27743;5714;106;0;0;0;0;.00nan;0;0
27743;7063;106;55;38;5;33;.868;3600000;0
27743;8562;111;41;9;2;7;.778;1457000;0
27743;9208;106;19;23;6;17;.739;2143000;0
27744;6311;120;0;0;0;0;.00nan;0;0
27744;7141;120;74;28;3;25;.893;3575000;0
27744;7192;104;83;33;2;31;.939;3600000;0
27744;7655;104;0;0;0;0;.00nan;0;0
27745;5832;110;78;42;4;38;.905;3600000;0
27745;7109;115;0;0;0;0;.00nan;0;0
27745;7251;110;0;0;0;0;.00nan;0;0
27745;7263;-1;58;14;1;13;.929;3600000;0
27746;5551;108;0;0;0;0;.00nan;0;0
27746;7095;108;32;45;9;36;.800;3600000;0
27746;7673;113;0;0;0;0;.00nan;0;0
27746;8685;113;68;33;3;30;.909;3600000;0
27747;6319;121;76;28;2;26;.929;3600000;0
27747;7678;119;58;40;5;35;.875;3600000;0
27747;8628;121;0;0;0;0;.00nan;0;0
27747;8676;119;0;0;0;0;.00nan;0;0
27748;5492;117;0;0;0;0;.00nan;0;0
27748;5655;117;52;30;5;25;.833;3527000;0
27748;6250;116;59;28;3;25;.893;3600000;0
27748;6326;116;0;0;0;0;.00nan;0;0
27749;5611;114;0;0;0;0;.00nan;0;0
27749;5614;114;57;35;5;30;.857;3577000;0
27749;7192;104;49;28;4;24;.857;3600000;0
27749;7655;104;0;0;0;0;.00nan;0;0
27750;5808;105;71;24;2;22;.917;3600000;0
27750;5832;110;0;0;0;0;.00nan;0;0
27750;7145;105;0;0;0;0;.00nan;0;0
27750;7251;110;91;33;1;32;.970;3600000;0
27751;5492;117;86;26;1;25;.962;3600000;0
27751;5655;117;0;0;0;0;.00nan;0;0
27751;9106;115;0;0;0;0;.00nan;0;0
27751;9214;115;40;48;7;41;.854;3600000;0
27752;7673;113;0;0;0;0;.00nan;0;0
27752;7678;119;0;0;0;0;.00nan;0;0
27752;8676;119;52;29;4;25;.862;3532000;0
27752;8685;113;71;31;2;29;.935;3600000;0
27753;5808;105;0;0;0;0;.00nan;0;0
27753;7145;105;77;33;3;30;.909;3650000;0
27753;7160;112;75;28;2;26;.929;3650000;0
27753;10008;109;0;0;0;0;.00nan;0;0
27754;6319;121;0;0;0;0;.00nan;0;0
27754;7109;115;79;19;1;18;.947;3600000;0
27754;8628;121;65;43;5;38;.884;3600000;0
27754;9166;117;0;0;0;0;.00nan;0;0
27755;5551;108;0;0;0;0;.00nan;0;0
27755;7095;108;55;32;4;28;.875;3600000;0
27755;8562;111;56;41;6;35;.854;3549000;0
27755;9208;106;51;1;0;1;1.000;37000;0
27756;6250;116;0;0;0;0;.00nan;0;0
27756;6326;116;73;44;4;40;.909;3559000;0
27756;7050;118;0;0;0;0;.00nan;0;0
27756;8515;118;64;27;3;24;.889;3600000;0
27757;5611;114;48;17;3;14;.824;2386000;0
27757;5614;114;30;16;4;12;.750;1197000;0
27757;5651;107;61;49;6;43;.878;3600000;0
27757;6248;107;0;0;0;0;.00nan;0;0
27758;6311;120;35;15;3;12;.800;1307000;0
27758;7141;120;33;28;6;22;.786;2293000;0
27758;7673;113;100;48;2;46;.958;3600000;0
27758;8685;113;0;0;0;0;.00nan;0;0
27759;5832;110;93;36;1;35;.972;3600000;0
27759;7160;112;6;17;6;11;.647;1456000;0
27759;7251;110;0;0;0;0;.00nan;0;0
27759;10008;109;18;29;7;22;.759;2144000;0
27760;5714;106;63;40;4;36;.900;3560000;0
27760;7063;106;0;0;0;0;.00nan;0;0
27760;7192;104;0;0;0;0;.00nan;0;0
27760;7655;104;66;32;3;29;.906;3600000;0
27761;5551;108;78;42;3;39;.929;3750000;0
27761;7095;108;0;0;0;0;.00nan;0;0
27761;7109;115;0;0;0;0;.00nan;0;0
27761;9166;117;88;38;2;36;.947;3750000;0
27762;5492;117;0;0;0;0;.00nan;0;0
27762;5655;117;61;27;3;24;.889;3600000;0
27762;9106;115;0;0;0;0;.00nan;0;0
27762;9214;115;46;30;4;26;.867;3559000;0
27763;6311;120;0;0;0;0;.00nan;0;0
27763;7050;118;81;48;4;44;.917;3600000;0
27763;7141;120;39;28;5;23;.821;3599000;0
27763;8515;118;0;0;0;0;.00nan;0;0
27764;6319;121;0;0;0;0;.00nan;0;0
27764;8562;111;0;0;0;0;.00nan;0;0
27764;8628;121;51;32;5;27;.844;3600000;0
27764;9208;106;73;31;2;29;.935;3600000;0
27765;5611;114;0;0;0;0;.00nan;0;0
27765;5614;114;81;34;2;32;.941;3600000;0
27765;5651;107;0;0;0;0;.00nan;0;0
27765;6248;107;64;30;3;27;.900;3600000;0
27766;5714;106;0;0;0;0;.00nan;0;0
27766;5808;105;0;0;0;0;.00nan;0;0
27766;7063;106;80;31;2;29;.935;3600000;0
27766;7145;105;64;32;3;29;.906;3600000;0
27767;6250;116;32;9;3;6;.667;515000;0
27767;6326;116;84;31;2;29;.935;3085000;0
27767;7678;119;0;0;0;0;.00nan;0;0
27767;8676;119;66;23;2;21;.913;3600000;0
27768;5832;110;0;0;0;0;.00nan;0;0
27768;7192;104;36;22;4;18;.818;3600000;0
27768;7251;110;46;49;8;41;.837;3600000;0
27768;7655;104;0;0;0;0;.00nan;0;0
27769;7109;115;85;54;4;50;.926;3900000;0
27769;7192;104;34;11;3;8;.727;576000;0
27769;7655;104;82;22;1;21;.955;3324000;0
27769;9166;117;0;0;0;0;.00nan;0;0
27770;5832;110;86;41;3;38;.927;3600000;0
27770;6311;120;76;46;4;42;.913;3600000;0
27770;7141;120;0;0;0;0;.00nan;0;0
27770;7251;110;0;0;0;0;.00nan;0;0
27771;5808;105;68;27;3;24;.889;2674000;0
27771;7109;115;0;0;0;0;.00nan;0;0
27771;7145;105;27;12;4;8;.667;926000;0
27771;9166;117;63;19;2;17;.895;3600000;0
27772;5611;114;0;0;0;0;.00nan;0;0
27772;5614;114;78;33;2;31;.939;3600000;0
27772;5714;106;59;43;6;37;.860;3600000;0
27772;7063;106;0;0;0;0;.00nan;0;0
27773;5832;110;49;1;0;1;1.000;324000;0
27773;6250;116;37;31;5;26;.839;3600000;0
27773;6326;116;0;0;0;0;.00nan;0;0
27773;7251;110;40;38;6;32;.842;3227000;0
27774;5651;107;0;0;0;0;.00nan;0;0
27774;6248;107;90;37;2;35;.946;3600000;0
27774;7673;113;49;8;1;7;.875;1573000;0
27774;8685;113;10;19;6;13;.684;2027000;0
27775;7050;118;0;0;0;0;.00nan;0;0
27775;8515;118;56;30;3;27;.900;3600000;0
27775;9106;115;0;0;0;0;.00nan;0;0
27775;9214;115;35;24;5;19;.792;3575000;0
27776;6319;121;0;0;0;0;.00nan;0;0
27776;8562;111;45;20;3;17;.850;3600000;0
27776;8628;121;67;40;4;36;.900;3600000;0
27776;9208;106;0;0;0;0;.00nan;0;0
27777;6250;116;0;0;0;0;.00nan;0;0
27777;6326;116;96;37;1;36;.973;3600000;0
27777;7050;118;29;21;5;16;.762;3600000;0
27777;8515;118;0;0;0;0;.00nan;0;0
27778;5808;105;0;0;0;0;.00nan;0;0
27778;7109;115;72;30;3;27;.900;3600000;0
27778;7145;105;50;30;4;26;.867;3600000;0
27778;9166;117;0;0;0;0;.00nan;0;0
27779;5492;117;0;0;0;0;.00nan;0;0
27779;5655;117;93;37;3;34;.919;3600000;0
27779;6311;120;36;27;5;22;.815;3582000;0
27779;7141;120;0;0;0;0;.00nan;0;0
27780;5651;107;28;37;7;30;.811;3227000;0
27780;6248;107;52;2;0;2;1.000;373000;0
27780;7673;113;54;27;4;23;.852;3600000;0
27780;8685;113;0;0;0;0;.00nan;0;0
27781;5714;106;0;0;0;0;.00nan;0;0
27781;7063;106;100;25;0;25;1.000;3600000;0
27781;7678;119;90;37;2;35;.946;3600000;0
27781;8676;119;0;0;0;0;.00nan;0;0
27782;5551;108;67;32;3;29;.906;3600000;0
27782;6319;121;59;8;0;8;1.000;758000;0
27782;7095;108;0;0;0;0;.00nan;0;0
27782;8628;121;23;24;6;18;.750;2842000;0
27783;7160;112;96;49;3;46;.939;3900000;0
27783;7192;104;0;0;0;0;.00nan;0;0
27783;7655;104;64;24;3;21;.875;3900000;0
27783;10008;109;0;0;0;0;.00nan;0;0
27784;7050;118;30;16;4;12;.750;771000;0
27784;8515;118;44;36;6;30;.833;2829000;0
27784;9106;115;0;0;0;0;.00nan;0;0
27784;9214;115;66;17;1;16;.941;3600000;0
27785;5714;106;0;0;0;0;.00nan;0;0
27785;7063;106;63;34;4;30;.882;3600000;0
27785;7160;112;0;0;0;0;.00nan;0;0
27785;10008;109;70;50;5;45;.900;3600000;0
27786;5492;117;57;27;4;23;.852;3547000;0
27786;5655;117;0;0;0;0;.00nan;0;0
27786;5832;110;0;0;0;0;.00nan;0;0
27786;7251;110;79;37;3;34;.919;3600000;0
27787;6319;121;31;34;6;28;.824;2190000;0
27787;7678;119;0;0;0;0;.00nan;0;0
27787;8628;121;31;12;4;8;.667;1410000;0
27787;8676;119;43;24;4;20;.833;3600000;0
27788;5551;108;0;0;0;0;.00nan;0;0
27788;7095;108;81;35;2;33;.943;3600000;0
27788;8562;111;0;0;0;0;.00nan;0;0
27788;9208;106;57;39;5;34;.872;3600000;0
27789;5611;114;0;0;0;0;.00nan;0;0
27789;5614;114;100;35;0;35;1.000;3600000;0
27789;7192;104;36;29;5;24;.828;3600000;0
27789;7655;104;0;0;0;0;.00nan;0;0
27790;5651;107;61;38;4;34;.895;3579000;0
27790;6248;107;0;0;0;0;.00nan;0;0
27790;6311;120;0;0;0;0;.00nan;0;0
27790;7141;120;71;25;2;23;.920;3600000;0
27791;5551;108;0;0;0;0;.00nan;0;0
27791;7095;108;61;31;5;26;.839;3600000;0
27791;7678;119;50;2;0;2;1.000;89000;0
27791;8676;119;38;41;7;34;.829;3476000;0
27792;5714;106;87;29;1;28;.966;3600000;0
27792;6250;116;45;11;2;9;.818;1149000;0
27792;6326;116;19;26;7;19;.731;2451000;0
27792;7063;106;0;0;0;0;.00nan;0;0
27793;5492;117;0;0;0;0;.00nan;0;0
27793;5655;117;47;30;5;25;.833;3600000;0
27793;7160;112;98;45;1;44;.978;3600000;0
27793;10008;109;0;0;0;0;.00nan;0;0
27794;6311;120;67;40;4;36;.900;3600000;0
27794;7141;120;0;0;0;0;.00nan;0;0
27794;9106;115;0;0;0;0;.00nan;0;0
27794;9214;115;23;27;6;21;.778;3527000;0
27795;7109;115;53;26;4;22;.846;3877000;0
27795;8562;111;62;37;4;33;.892;3900000;0
27795;9166;117;0;0;0;0;.00nan;0;0
27795;9208;106;0;0;0;0;.00nan;0;0
27796;5651;107;0;0;0;0;.00nan;0;0
27796;6248;107;70;47;4;43;.915;3577000;0
27796;7050;118;0;0;0;0;.00nan;0;0
27796;8515;118;75;28;2;26;.929;3600000;0
27797;5611;114;57;12;1;11;.917;1362000;0
27797;5614;114;6;22;7;15;.682;2238000;0
27797;7673;113;0;0;0;0;.00nan;0;0
27797;8685;113;59;32;4;28;.875;3600000;0
27798;7192;104;0;0;0;0;.00nan;0;0
27798;7655;104;61;14;1;13;.929;3600000;0
27798;7678;119;0;0;0;0;.00nan;0;0
27798;8676;119;91;49;3;46;.939;3570000;0
27799;5714;106;0;0;0;0;.00nan;0;0
27799;5832;110;81;43;4;39;.907;3600000;0
27799;7063;106;43;32;5;27;.844;3594000;0
27799;7251;110;0;0;0;0;.00nan;0;0
27800;5492;117;0;0;0;0;.00nan;0;0
27800;5551;108;0;0;0;0;.00nan;0;0
27800;5655;117;41;26;4;22;.846;3900000;0
27800;7095;108;35;25;4;21;.840;3864000;0
27801;5651;107;40;37;6;31;.838;2174000;0
27801;6248;107;63;15;1;14;.933;1426000;0
27801;9106;115;48;20;3;17;.850;3600000;0
27801;9214;115;0;0;0;0;.00nan;0;0
27802;6250;116;0;0;0;0;.00nan;0;0
27802;6326;116;82;47;4;43;.915;3600000;0
27802;7192;104;80;19;1;18;.947;3600000;0
27802;7655;104;0;0;0;0;.00nan;0;0
27803;5808;105;97;27;0;27;1.000;3600000;0
27803;7145;105;0;0;0;0;.00nan;0;0
27803;7678;119;73;51;5;46;.902;3600000;0
27803;8676;119;0;0;0;0;.00nan;0;0
27804;5492;117;68;37;5;32;.865;3600000;0
27804;5655;117;0;0;0;0;.00nan;0;0
27804;6319;121;55;4;0;4;1.000;1105000;0
27804;8628;121;33;34;7;27;.794;2495000;0
27805;6311;120;54;23;3;20;.870;3543000;0
27805;7050;118;0;0;0;0;.00nan;0;0
27805;7141;120;0;0;0;0;.00nan;0;0
27805;8515;118;99;44;2;42;.955;3600000;0
27806;5808;105;72;45;5;40;.889;3531000;0
27806;6250;116;81;42;4;38;.905;3600000;0
27806;6326;116;0;0;0;0;.00nan;0;0
27806;7145;105;0;0;0;0;.00nan;0;0
27807;5611;114;0;0;0;0;.00nan;0;0
27807;5614;114;62;37;4;33;.892;3900000;0
27807;7109;115;0;0;0;0;.00nan;0;0
27807;9166;117;53;21;4;17;.810;3900000;0
27808;7160;112;64;39;5;34;.872;3600000;0
27808;8562;111;48;0;0;0;.00nan;154000;0
27808;9208;106;49;43;6;37;.860;3396000;0
27808;10008;109;0;0;0;0;.00nan;0;0
27809;5714;106;71;29;3;26;.897;3600000;0
27809;5832;110;0;0;0;0;.00nan;0;0
27809;7063;106;0;0;0;0;.00nan;0;0
27809;7251;110;66;34;4;30;.882;3583000;0
27810;6311;120;0;0;0;0;.00nan;0;0
27810;7141;120;82;28;1;27;.964;3600000;0
27810;9106;115;0;0;0;0;.00nan;0;0
27810;9214;115;71;44;3;41;.932;3534000;0
27811;5611;114;78;39;3;36;.923;3600000;0
27811;5614;114;0;0;0;0;.00nan;0;0
27811;8562;111;60;32;4;28;.875;3563000;0
27811;9208;106;0;0;0;0;.00nan;0;0
27812;5551;108;88;40;3;37;.925;3600000;0
27812;7095;108;0;0;0;0;.00nan;0;0
27812;7673;113;41;30;5;25;.833;3600000;0
27812;8685;113;0;0;0;0;.00nan;0;0
27813;7109;115;96;20;0;20;1.000;3600000;0
27813;7160;112;46;11;2;9;.818;1146000;0
27813;9166;117;0;0;0;0;.00nan;0;0
27813;10008;109;26;26;6;20;.769;2454000;0
27814;6311;120;56;32;4;28;.875;3600000;0
27814;7109;115;29;38;7;31;.816;2436000;0
27814;7141;120;0;0;0;0;.00nan;0;0
27814;9166;117;33;12;3;9;.750;1164000;0
27815;5551;108;0;0;0;0;.00nan;0;0
27815;5832;110;0;0;0;0;.00nan;0;0
27815;7095;108;71;40;3;37;.925;3600000;0
27815;7251;110;57;30;4;26;.867;3559000;0
27816;5808;105;0;0;0;0;.00nan;0;0
27816;6319;121;0;0;0;0;.00nan;0;0
27816;7145;105;55;25;3;22;.880;3900000;0
27816;8628;121;80;38;3;35;.921;3900000;0
27817;6250;116;59;26;2;24;.923;3751000;0
27817;6326;116;0;0;0;0;.00nan;0;0
27817;7109;115;86;45;3;42;.933;3751000;0
27817;8500;112;0;0;0;0;.00nan;0;0
27818;8562;111;0;0;0;0;.00nan;0;0
27818;9106;115;0;0;0;0;.00nan;0;0
27818;9208;106;75;43;4;39;.907;3583000;0
27818;9214;115;52;24;3;21;.875;3600000;0
27819;6319;121;45;22;3;19;.864;1458000;0
27819;7192;104;56;12;1;11;.917;3600000;0
27819;7655;104;0;0;0;0;.00nan;0;0
27819;8628;121;21;28;6;22;.786;2142000;0
27820;7678;119;0;0;0;0;.00nan;0;0
27820;8562;111;64;38;4;34;.895;3600000;0
27820;8676;119;45;36;5;31;.861;3544000;0
27820;9208;106;0;0;0;0;.00nan;0;0
27821;5651;107;41;37;6;31;.838;2706000;0
27821;6248;107;64;18;1;17;.944;894000;0
27821;7673;113;0;0;0;0;.00nan;0;0
27821;8685;113;61;22;2;20;.909;3600000;0
27822;5551;108;66;52;6;46;.885;3497000;0
27822;5611;114;0;0;0;0;.00nan;0;0
27822;5614;114;83;27;1;26;.963;3600000;0
27822;7095;108;48;0;0;0;.00nan;103000;0
27823;5832;110;95;39;1;38;.974;3600000;0
27823;7160;112;48;0;0;0;.00nan;281000;0
27823;7251;110;0;0;0;0;.00nan;0;0
27823;10008;109;29;36;7;29;.806;3319000;0
27824;5492;117;0;0;0;0;.00nan;0;0
27824;5655;117;96;34;2;32;.941;3600000;0
27824;7109;115;0;0;0;0;.00nan;0;0
27824;8500;112;44;35;5;30;.857;3600000;0
27825;6311;120;74;30;2;28;.933;3600000;0
27825;7141;120;0;0;0;0;.00nan;0;0
27825;7160;112;93;49;3;46;.939;3583000;0
27825;10008;109;0;0;0;0;.00nan;0;0
27826;6250;116;0;0;0;0;.00nan;0;0
27826;6326;116;98;52;3;49;.942;3900000;0
27826;9106;115;0;0;0;0;.00nan;0;0
27826;9214;115;46;21;3;18;.857;3900000;0
27827;5611;114;0;0;0;0;.00nan;0;0
27827;5614;114;31;29;6;23;.793;3600000;0
27827;6319;121;0;0;0;0;.00nan;0;0
27827;8628;121;87;44;3;41;.932;3600000;0
27828;5714;106;0;0;0;0;.00nan;0;0
27828;7063;106;84;31;2;29;.935;3600000;0
27828;7673;113;57;23;3;20;.870;3572000;0
27828;8685;113;0;0;0;0;.00nan;0;0
27829;5551;108;0;0;0;0;.00nan;0;0
27829;5808;105;0;0;0;0;.00nan;0;0
27829;7095;108;90;45;4;41;.911;3900000;0
27829;7145;105;72;41;4;37;.902;3848000;0
27830;7050;118;0;0;0;0;.00nan;0;0
27830;7678;119;87;28;1;27;.964;3600000;0
27830;8515;118;63;23;3;20;.870;3556000;0
27830;8676;119;0;0;0;0;.00nan;0;0
27831;5651;107;0;0;0;0;.00nan;0;0
27831;6248;107;65;42;4;38;.905;3545000;0
27831;7192;104;0;0;0;0;.00nan;0;0
27831;7655;104;66;21;2;19;.905;3600000;0
27832;7050;118;68;33;3;30;.909;3544000;0
27832;7678;119;0;0;0;0;.00nan;0;0
27832;8515;118;0;0;0;0;.00nan;0;0
27832;8676;119;81;40;2;38;.950;3600000;0
27833;5611;114;65;41;4;37;.902;3900000;0
27833;5614;114;0;0;0;0;.00nan;0;0
27833;6311;120;0;0;0;0;.00nan;0;0
27833;7141;120;46;24;4;20;.833;3900000;0
27834;5492;117;0;0;0;0;.00nan;0;0
27834;5655;117;55;22;3;19;.864;3600000;0
27834;8562;111;57;19;2;17;.895;2410000;0
27834;9208;106;24;12;4;8;.667;1190000;0
27835;5832;110;33;4;2;2;.500;684000;0
27835;7251;110;22;29;7;22;.759;2916000;0
27835;7673;113;0;0;0;0;.00nan;0;0
27835;8685;113;69;28;2;26;.929;3600000;0
27836;5714;106;32;29;6;23;.793;3600000;0
27836;7063;106;0;0;0;0;.00nan;0;0
27836;7192;104;97;38;1;37;.974;3600000;0
27836;7655;104;0;0;0;0;.00nan;0;0
27837;6311;120;76;28;2;26;.929;3600000;0
27837;7141;120;0;0;0;0;.00nan;0;0
27837;7673;113;98;51;3;48;.941;3595000;0
27837;8685;113;0;0;0;0;.00nan;0;0
27838;5492;117;0;0;0;0;.00nan;0;0
27838;5655;117;59;19;2;17;.895;3600000;0
27838;7678;119;0;0;0;0;.00nan;0;0
27838;8676;119;64;39;4;35;.897;3600000;0
27839;5651;107;44;22;4;18;.818;1066000;0
27839;6248;107;88;24;0;24;1.000;2534000;0
27839;8562;111;25;25;6;19;.760;3016000;0
27839;9208;106;38;9;2;7;.778;584000;0
27840;6250;116;0;0;0;0;.00nan;0;0
27840;6326;116;76;26;2;24;.923;3600000;0
27840;7050;118;0;0;0;0;.00nan;0;0
27840;8515;118;45;33;5;28;.848;3600000;0
27841;5492;117;47;48;6;42;.875;3600000;0
27841;5551;108;0;0;0;0;.00nan;0;0
27841;5655;117;0;0;0;0;.00nan;0;0
27841;7095;108;70;31;3;28;.903;3600000;0
27842;7160;112;64;13;1;12;.923;1358000;0
27842;7673;113;0;0;0;0;.00nan;0;0
27842;8685;113;99;46;2;44;.957;3600000;0
27842;10008;109;36;38;6;32;.842;2242000;0
27843;7192;104;63;20;2;18;.900;3600000;0
27843;7655;104;0;0;0;0;.00nan;0;0
27843;9106;115;0;0;0;0;.00nan;0;0
27843;9214;115;60;47;5;42;.894;3600000;0
27844;5611;114;0;0;0;0;.00nan;0;0
27844;5614;114;45;23;4;19;.826;3600000;0
27844;6319;121;0;0;0;0;.00nan;0;0
27844;8628;121;87;41;3;38;.927;3600000;0
27845;5714;106;55;3;0;3;1.000;379000;0
27845;7063;106;41;40;7;33;.825;3221000;0
27845;9106;115;6;32;8;24;.750;3581000;0
27845;9214;115;0;0;0;0;.00nan;0;0
27846;5808;105;0;0;0;0;.00nan;0;0
27846;7109;115;54;33;4;29;.879;2846000;0
27846;7145;105;64;25;3;22;.880;3600000;0
27846;8500;112;51;2;0;2;1.000;701000;0
27847;6311;120;62;29;3;26;.897;3600000;0
27847;7141;120;0;0;0;0;.00nan;0;0
27847;7192;104;0;0;0;0;.00nan;0;0
27847;7655;104;32;28;5;23;.821;3600000;0
27848;5714;106;35;29;5;24;.828;3552000;0
27848;6250;116;0;0;0;0;.00nan;0;0
27848;6326;116;47;22;4;18;.818;3600000;0
27848;7063;106;50;0;0;0;.00nan;11000;0
27849;5651;107;95;63;4;59;.937;3900000;0
27849;6248;107;0;0;0;0;.00nan;0;0
27849;7109;115;0;0;0;0;.00nan;0;0
27849;8500;112;32;15;4;11;.733;3900000;0
27850;5611;114;0;0;0;0;.00nan;0;0
27850;5614;114;73;27;2;25;.926;3600000;0
27850;7160;112;0;0;0;0;.00nan;0;0
27850;10008;109;51;31;4;27;.871;3600000;0
27851;5808;105;72;36;3;33;.917;3900000;0
27851;7145;105;0;0;0;0;.00nan;0;0
27851;8562;111;0;0;0;0;.00nan;0;0
27851;9208;106;70;32;3;29;.906;3900000;0
27852;5551;108;19;21;6;15;.714;3799000;0
27852;7095;108;0;0;0;0;.00nan;0;0
27852;7678;119;44;25;4;21;.840;1144000;0
27852;8676;119;98;42;1;41;.976;2655000;0
27853;7050;118;0;0;0;0;.00nan;0;0
27853;7192;104;64;41;4;37;.902;3600000;0
27853;7655;104;0;0;0;0;.00nan;0;0
27853;8515;118;56;38;5;33;.868;3546000;0
27854;5832;110;0;0;0;0;.00nan;0;0
27854;6319;121;0;0;0;0;.00nan;0;0
27854;7251;110;67;27;3;24;.889;3600000;0
27854;8628;121;54;35;4;31;.886;3600000;0
27855;5714;106;0;0;0;0;.00nan;0;0
27855;7063;106;63;17;1;16;.941;3600000;0
27855;7678;119;59;40;5;35;.875;3600000;0
27855;8676;119;0;0;0;0;.00nan;0;0
27856;5832;110;42;38;6;32;.842;3411000;0
27856;7251;110;57;6;0;6;1.000;189000;0
27856;7673;113;70;16;1;15;.938;3600000;0
27856;8685;113;0;0;0;0;.00nan;0;0
27857;6250;116;27;15;4;11;.733;920000;0
27857;6311;120;0;0;0;0;.00nan;0;0
27857;6326;116;98;41;1;40;.976;2680000;0
27857;7141;120;52;14;2;12;.857;3600000;0
27858;5492;117;0;0;0;0;.00nan;0;0
27858;5655;117;84;51;5;46;.902;3579000;0
27858;9106;115;0;0;0;0;.00nan;0;0
27858;9214;115;53;24;3;21;.875;3600000;0
27859;5808;105;0;0;0;0;.00nan;0;0
27859;7145;105;59;47;6;41;.872;3600000;0
27859;8562;111;27;21;5;16;.762;3600000;0
27859;9208;106;0;0;0;0;.00nan;0;0
27860;5551;108;0;0;0;0;.00nan;0;0
27860;7050;118;47;39;6;33;.846;2747000;0
27860;7095;108;64;32;3;29;.906;3600000;0
27860;8515;118;31;9;3;6;.667;853000;0
27861;5611;114;85;30;2;28;.933;3600000;0
27861;5614;114;0;0;0;0;.00nan;0;0
27861;7160;112;23;20;5;15;.750;3600000;0
27861;10008;109;0;0;0;0;.00nan;0;0
27862;7050;118;0;0;0;0;.00nan;0;0
27862;7109;115;39;48;8;40;.833;3600000;0
27862;8500;112;0;0;0;0;.00nan;0;0
27862;8515;118;45;34;5;29;.853;3600000;0
27863;5611;114;90;31;1;30;.968;3600000;0
27863;5614;114;0;0;0;0;.00nan;0;0
27863;5832;110;65;16;1;15;.938;1548000;0
27863;7251;110;32;23;5;18;.783;2052000;0
27864;5808;105;25;34;7;27;.794;2148000;0
27864;7145;105;36;19;4;15;.789;1452000;0
27864;7673;113;0;0;0;0;.00nan;0;0
27864;8685;113;81;28;2;26;.929;3600000;0
27865;5651;107;41;29;5;24;.828;3600000;0
27865;6248;107;0;0;0;0;.00nan;0;0
27865;7678;119;0;0;0;0;.00nan;0;0
27865;8676;119;59;33;4;29;.879;3600000;0
27866;6319;121;42;24;4;20;.833;2990000;0
27866;8628;121;28;8;3;5;.625;574000;0
27866;9106;115;54;37;5;32;.865;3600000;0
27866;9214;115;0;0;0;0;.00nan;0;0
27867;7050;118;88;37;2;35;.946;3600000;0
27867;8515;118;0;0;0;0;.00nan;0;0
27867;8562;111;0;0;0;0;.00nan;0;0
27867;9208;106;34;20;4;16;.800;3519000;0
27868;5492;117;0;0;0;0;.00nan;0;0
27868;5655;117;55;31;4;27;.871;3541000;0
27868;6250;116;69;31;3;28;.903;3600000;0
27868;6326;116;0;0;0;0;.00nan;0;0
27869;6311;120;59;13;1;12;.923;3600000;0
27869;7109;115;87;54;4;50;.926;3600000;0
27869;7141;120;0;0;0;0;.00nan;0;0
27869;8500;112;0;0;0;0;.00nan;0;0
27870;5651;107;0;0;0;0;.00nan;0;0
27870;6248;107;52;33;5;28;.848;3600000;0
27870;6319;121;0;0;0;0;.00nan;0;0
27870;8628;121;79;24;1;23;.958;3600000;0
27871;7160;112;38;7;2;5;.714;658000;0
27871;9106;115;0;0;0;0;.00nan;0;0
27871;9214;115;92;23;0;23;1.000;3600000;0
27871;10008;109;51;41;6;35;.854;2942000;0
27872;7192;104;55;28;4;24;.857;3600000;0
27872;7655;104;0;0;0;0;.00nan;0;0
27872;7673;113;63;41;5;36;.878;3564000;0
27872;8685;113;0;0;0;0;.00nan;0;0
27873;5832;110;48;7;1;6;.857;573000;0
27873;7251;110;24;36;7;29;.806;3027000;0
27873;7678;119;0;0;0;0;.00nan;0;0
27873;8676;119;54;20;3;17;.850;3600000;0
27874;5551;108;0;0;0;0;.00nan;0;0
27874;5714;106;0;0;0;0;.00nan;0;0
27874;7063;106;64;40;4;36;.900;3900000;0
27874;7095;108;68;43;4;39;.907;3900000;0
27875;6311;120;0;0;0;0;.00nan;0;0
27875;7141;120;55;26;4;22;.846;3600000;0
27875;8562;111;55;36;5;31;.861;3554000;0
27875;9208;106;0;0;0;0;.00nan;0;0
27876;5492;117;55;28;4;24;.857;3600000;0
27876;5655;117;0;0;0;0;.00nan;0;0
27876;6250;116;0;0;0;0;.00nan;0;0
27876;6326;116;72;43;5;38;.884;3600000;0
27877;5832;110;69;39;4;35;.897;3900000;0
27877;7251;110;0;0;0;0;.00nan;0;0
27877;9106;115;0;0;0;0;.00nan;0;0
27877;9214;115;38;26;4;22;.846;3900000;0
27878;5808;105;89;52;4;48;.923;3600000;0
27878;7145;105;0;0;0;0;.00nan;0;0
27878;7673;113;0;0;0;0;.00nan;0;0
27878;8685;113;63;16;1;15;.938;3600000;0
27879;7160;112;84;31;2;29;.935;3251000;0
27879;7678;119;23;19;6;13;.684;2221000;0
27879;8676;119;51;10;1;9;.900;1347000;0
27879;10008;109;30;8;3;5;.625;349000;0
27880;5551;108;0;0;0;0;.00nan;0;0
27880;6319;121;94;50;3;47;.940;3600000;0
27880;7095;108;37;22;4;18;.818;3600000;0
27880;8628;121;0;0;0;0;.00nan;0;0
27881;5611;114;49;33;4;29;.879;3600000;0
27881;5614;114;0;0;0;0;.00nan;0;0
27881;7050;118;0;0;0;0;.00nan;0;0
27881;8515;118;62;36;5;31;.861;3598000;0
27882;6311;120;79;28;2;26;.929;3600000;0
27882;6319;121;0;0;0;0;.00nan;0;0
27882;7141;120;0;0;0;0;.00nan;0;0
27882;8628;121;51;33;4;29;.879;3548000;0
27883;5551;108;30;27;5;22;.815;2988000;0
27883;7095;108;33;4;2;2;.500;612000;0
27883;8562;111;0;0;0;0;.00nan;0;0
27883;9208;106;75;36;3;33;.917;3600000;0
27884;7192;104;0;0;0;0;.00nan;0;0
27884;7655;104;36;29;5;24;.828;3600000;0
27884;7673;113;58;32;4;28;.875;3600000;0
27884;8685;113;0;0;0;0;.00nan;0;0
27885;5651;107;63;23;2;21;.913;3600000;0
27885;5808;105;0;0;0;0;.00nan;0;0
27885;6248;107;0;0;0;0;.00nan;0;0
27885;7145;105;45;35;5;30;.857;3600000;0
27886;5714;106;0;0;0;0;.00nan;0;0
27886;7063;106;62;28;3;25;.893;3600000;0
27886;7160;112;0;0;0;0;.00nan;0;0
27886;10008;109;63;41;5;36;.878;3532000;0
27887;5651;107;43;3;1;2;.667;491000;0
27887;5714;106;68;23;2;21;.913;3600000;0
27887;6248;107;38;37;6;31;.838;3109000;0
27887;7063;106;0;0;0;0;.00nan;0;0
27888;5492;117;0;0;0;0;.00nan;0;0
27888;5655;117;56;36;5;31;.861;3552000;0
27888;7050;118;74;38;4;34;.895;3600000;0
27888;8515;118;0;0;0;0;.00nan;0;0
27889;6250;116;76;35;4;31;.886;3900000;0
27889;6311;120;41;18;4;14;.778;3900000;0
27889;6326;116;0;0;0;0;.00nan;0;0
27889;7141;120;0;0;0;0;.00nan;0;0
27890;7678;119;0;0;0;0;.00nan;0;0
27890;8676;119;39;27;5;22;.815;3583000;0
27890;9106;115;0;0;0;0;.00nan;0;0
27890;9214;115;61;32;3;29;.906;3600000;0
27891;6319;121;0;0;0;0;.00nan;0;0
27891;7160;112;84;25;1;24;.960;3600000;0
27891;8628;121;52;33;4;29;.879;3600000;0
27891;10008;109;0;0;0;0;.00nan;0;0
27892;7109;115;35;32;6;26;.813;3559000;0
27892;8500;112;0;0;0;0;.00nan;0;0
27892;8562;111;44;27;5;22;.815;3600000;0
27892;9208;106;0;0;0;0;.00nan;0;0
27893;5492;117;53;2;0;2;1.000;482000;0
27893;5655;117;32;47;9;38;.809;3118000;0
27893;9106;115;0;0;0;0;.00nan;0;0
27893;9214;115;54;25;3;22;.880;3600000;0
27894;6250;116;0;0;0;0;.00nan;0;0
27894;6311;120;0;0;0;0;.00nan;0;0
27894;6326;116;100;53;2;51;.962;3600000;0
27894;7141;120;36;21;4;17;.810;3531000;0
27895;5832;110;0;0;0;0;.00nan;0;0
27895;7160;112;49;1;0;1;1.000;347000;0
27895;7251;110;90;29;1;28;.966;3600000;0
27895;10008;109;24;24;6;18;.750;3253000;0
27896;5651;107;50;48;7;41;.854;3405000;0
27896;5714;106;0;0;0;0;.00nan;0;0
27896;6248;107;50;2;0;2;1.000;195000;0
27896;7063;106;100;25;0;25;1.000;3600000;0
27897;5551;108;0;0;0;0;.00nan;0;0
27897;5611;114;89;36;3;33;.917;3600000;0
27897;5614;114;0;0;0;0;.00nan;0;0
27897;7095;108;47;35;5;30;.857;3600000;0
27898;7050;118;58;2;0;2;1.000;362000;0
27898;7678;119;38;22;5;17;.773;3600000;0
27898;8515;118;44;28;6;22;.786;3202000;0
27898;8676;119;0;0;0;0;.00nan;0;0
27899;5808;105;0;0;0;0;.00nan;0;0
27899;7145;105;61;44;5;39;.886;3600000;0
27899;7192;104;49;24;3;21;.875;3600000;0
27899;7655;104;0;0;0;0;.00nan;0;0
27900;6319;121;71;25;2;23;.920;2451000;0
27900;7673;113;0;0;0;0;.00nan;0;0
27900;8628;121;37;19;4;15;.789;1149000;0
27900;8685;113;69;23;1;22;.957;3600000;0
27901;7050;118;92;37;2;35;.946;3600000;0
27901;8515;118;0;0;0;0;.00nan;0;0
27901;9106;115;62;36;4;32;.889;3514000;0
27901;9214;115;0;0;0;0;.00nan;0;0
27902;5714;106;0;0;0;0;.00nan;0;0
27902;6319;121;0;0;0;0;.00nan;0;0
27902;7063;106;55;23;2;21;.913;3555000;0
27902;8628;121;100;42;1;41;.976;3600000;0
27903;5492;117;0;0;0;0;.00nan;0;0
27903;5655;117;100;50;2;48;.960;3600000;0
27903;6311;120;37;15;3;12;.800;3545000;0
27903;7141;120;0;0;0;0;.00nan;0;0
27904;7109;115;0;0;0;0;.00nan;0;0
27904;8500;112;77;32;2;30;.938;3600000;0
27904;8562;111;0;0;0;0;.00nan;0;0
27904;9208;106;58;37;3;34;.919;3560000;0
27905;5651;107;0;0;0;0;.00nan;0;0
27905;5832;110;75;30;2;28;.933;3600000;0
27905;6248;107;61;32;4;28;.875;3531000;0
27905;7251;110;0;0;0;0;.00nan;0;0
27906;6250;116;23;22;6;16;.727;2627000;0
27906;6326;116;52;10;1;9;.900;973000;0
27906;7678;119;0;0;0;0;.00nan;0;0
27906;8676;119;66;35;4;31;.886;3600000;0
27907;5611;114;0;0;0;0;.00nan;0;0
27907;5614;114;92;48;3;45;.938;3600000;0
27907;7673;113;97;23;0;23;1.000;3600000;0
27907;8685;113;0;0;0;0;.00nan;0;0
27908;5808;105;76;37;3;34;.919;3600000;0
27908;7145;105;0;0;0;0;.00nan;0;0
27908;7192;104;69;14;0;14;1.000;1673000;0
27908;7655;104;15;21;6;15;.714;1927000;0
27909;5551;108;0;0;0;0;.00nan;0;0
27909;7095;108;70;20;1;19;.950;3600000;0
27909;7160;112;72;40;4;36;.900;3600000;0
27909;10008;109;0;0;0;0;.00nan;0;0
27910;5551;108;0;0;0;0;.00nan;0;0
27910;7095;108;35;28;5;23;.821;3846000;0
27910;7109;115;75;39;5;34;.872;3900000;0
27910;8500;112;0;0;0;0;.00nan;0;0
27911;5611;114;25;27;6;21;.778;2396000;0
27911;5614;114;41;11;2;9;.818;1204000;0
27911;5714;106;0;0;0;0;.00nan;0;0
27911;7063;106;65;33;4;29;.879;3600000;0
27912;5492;117;0;0;0;0;.00nan;0;0
27912;5655;117;32;26;5;21;.808;3600000;0
27912;6250;116;0;0;0;0;.00nan;0;0
27912;6326;116;49;33;6;27;.818;3557000;0
27913;6311;120;0;0;0;0;.00nan;0;0
27913;7141;120;82;26;2;24;.923;3600000;0
27913;9106;115;0;0;0;0;.00nan;0;0
27913;9214;115;44;39;6;33;.846;3600000;0
27914;7673;113;48;37;5;32;.865;3600000;0
27914;8562;111;0;0;0;0;.00nan;0;0
27914;8618;111;91;36;2;34;.944;3600000;0
27914;8685;113;0;0;0;0;.00nan;0;0
27915;7678;119;0;0;0;0;.00nan;0;0
27915;8515;118;45;26;4;22;.846;3600000;0
27915;8534;118;0;0;0;0;.00nan;0;0
27915;8676;119;29;28;5;23;.821;3564000;0
27916;5651;107;38;47;7;40;.851;3600000;0
27916;6248;107;0;0;0;0;.00nan;0;0
27916;7160;112;73;32;3;29;.906;3600000;0
27916;10008;109;0;0;0;0;.00nan;0;0
27917;5786;105;0;0;0;0;.00nan;0;0
27917;7145;105;99;45;1;44;.978;3600000;0
27917;7192;104;45;18;4;14;.778;3600000;0
27917;7655;104;0;0;0;0;.00nan;0;0
27918;5832;110;46;30;5;25;.833;3401000;0
27918;6319;121;50;11;1;10;.909;1552000;0
27918;7251;110;52;1;0;1;1.000;199000;0
27918;8628;121;44;25;5;20;.800;2020000;0
27919;6311;120;33;26;5;21;.808;3551000;0
27919;7141;120;0;0;0;0;.00nan;0;0
27919;8515;118;0;0;0;0;.00nan;0;0
27919;8534;118;60;31;3;28;.903;3600000;0
27920;7109;115;0;0;0;0;.00nan;0;0
27920;7160;112;0;0;0;0;.00nan;0;0
27920;8500;112;78;33;2;31;.939;3900000;0
27920;10008;109;71;35;2;33;.943;3900000;0
27921;5714;106;55;32;5;27;.844;3589000;0
27921;7063;106;0;0;0;0;.00nan;0;0
27921;7673;113;0;0;0;0;.00nan;0;0
27921;8685;113;31;16;4;12;.750;3600000;0
27922;5611;114;0;0;0;0;.00nan;0;0
27922;5614;114;71;41;4;37;.902;3548000;0
27922;8562;111;53;19;3;16;.842;3600000;0
27922;8618;111;0;0;0;0;.00nan;0;0
27923;5651;107;0;0;0;0;.00nan;0;0
27923;5832;110;0;0;0;0;.00nan;0;0
27923;6248;107;67;28;2;26;.929;3600000;0
27923;7251;110;52;36;5;31;.861;3600000;0
27924;5492;117;50;38;6;32;.842;3886000;0
27924;5655;117;0;0;0;0;.00nan;0;0
27924;6250;116;76;45;5;40;.889;3886000;0
27924;6326;116;0;0;0;0;.00nan;0;0
27925;7678;119;86;46;3;43;.935;3644000;0
27925;8676;119;0;0;0;0;.00nan;0;0
27925;9106;115;61;39;4;35;.897;3633000;0
27925;9214;115;0;0;0;0;.00nan;0;0
27926;5786;105;86;56;6;50;.893;3600000;0
27926;7145;105;0;0;0;0;.00nan;0;0
27926;7192;104;0;0;0;0;.00nan;0;0
27926;7655;104;53;11;1;10;.909;3600000;0
27927;5551;108;0;0;0;0;.00nan;0;0
27927;6319;121;0;0;0;0;.00nan;0;0
27927;7095;108;39;29;5;24;.828;3809000;0
27927;8628;121;58;45;6;39;.867;3809000;0
27928;5492;117;51;13;1;12;.923;901000;0
27928;5655;117;25;27;6;21;.778;2699000;0
27928;6311;120;0;0;0;0;.00nan;0;0
27928;7141;120;73;26;2;24;.923;3600000;0
27929;5832;110;55;42;6;36;.857;3373000;0
27929;7251;110;54;3;0;3;1.000;227000;0
27929;8562;111;0;0;0;0;.00nan;0;0
27929;8618;111;88;29;1;28;.966;3600000;0
27930;7050;118;0;0;0;0;.00nan;0;0
27930;7109;115;55;41;5;36;.878;3564000;0
27930;8515;118;77;34;3;31;.912;3600000;0
27930;9106;115;0;0;0;0;.00nan;0;0
27931;5611;114;0;0;0;0;.00nan;0;0
27931;5614;114;79;37;3;34;.919;3600000;0
27931;7762;112;0;0;0;0;.00nan;0;0
27931;8500;112;51;15;2;13;.867;3600000;0
27932;6319;121;52;44;6;38;.864;3600000;0
27932;7673;113;53;21;3;18;.857;3600000;0
27932;8628;121;0;0;0;0;.00nan;0;0
27932;8685;113;0;0;0;0;.00nan;0;0
27933;5714;106;0;0;0;0;.00nan;0;0
27933;5786;105;62;40;5;35;.875;2606000;0
27933;7063;106;65;24;2;22;.917;3600000;0
27933;7145;105;39;22;4;18;.818;994000;0
27934;6250;116;63;36;4;32;.889;3549000;0
27934;6326;116;0;0;0;0;.00nan;0;0
27934;7678;119;0;0;0;0;.00nan;0;0
27934;8676;119;74;28;2;26;.929;3600000;0
27935;5551;108;0;0;0;0;.00nan;0;0
27935;7095;108;89;35;2;33;.943;3600000;0
27935;7160;112;67;37;4;33;.892;3594000;0
27935;10008;109;0;0;0;0;.00nan;0;0
27936;5651;107;83;38;2;36;.947;3600000;0
27936;6248;107;0;0;0;0;.00nan;0;0
27936;7192;104;59;24;3;21;.875;3546000;0
27936;7655;104;0;0;0;0;.00nan;0;0
27937;5492;117;0;0;0;0;.00nan;0;0
27937;5655;117;40;39;6;33;.846;3546000;0
27937;7050;118;0;0;0;0;.00nan;0;0
27937;8515;118;61;39;5;34;.872;3600000;0
27938;6311;120;41;31;7;24;.774;2796000;0
27938;7141;120;42;3;1;2;.667;776000;0
27938;7678;119;0;0;0;0;.00nan;0;0
27938;8676;119;50;44;6;38;.864;3600000;0
27939;5786;105;0;0;0;0;.00nan;0;0
27939;5832;110;64;25;2;23;.920;3600000;0
27939;7145;105;53;23;3;20;.870;3565000;0
27939;7251;110;0;0;0;0;.00nan;0;0
27940;5551;108;25;5;3;2;.400;533000;0
27940;5651;107;56;44;6;38;.864;3459000;0
27940;6248;107;48;1;0;1;1.000;441000;0
27940;7777;108;70;30;3;27;.900;3367000;0
27941;6250;116;0;0;0;0;.00nan;0;0
27941;6326;116;57;31;4;27;.871;3900000;0
27941;7109;115;51;24;4;20;.833;3900000;0
27941;9106;115;0;0;0;0;.00nan;0;0
27942;5611;114;64;12;1;11;.917;979000;0
27942;5614;114;42;36;6;30;.833;2704000;0
27942;5714;106;57;6;0;6;1.000;717000;0
27942;7063;106;30;28;6;22;.786;2966000;0
27943;7673;113;82;21;1;20;.952;1781000;0
27943;7762;112;71;37;3;34;.919;3600000;0
27943;8500;112;0;0;0;0;.00nan;0;0
27943;8685;113;31;24;5;19;.792;1819000;0
27944;7160;112;0;0;0;0;.00nan;0;0
27944;7192;104;25;22;6;16;.727;2721000;0
27944;7655;104;53;5;0;5;1.000;835000;0
27944;10008;109;62;37;5;32;.865;3600000;0
27945;6319;121;0;0;0;0;.00nan;0;0
27945;8562;111;0;0;0;0;.00nan;0;0
27945;8618;111;79;30;2;28;.933;3600000;0
27945;8628;121;66;34;3;31;.912;3597000;0
27946;6250;116;97;47;2;45;.957;3600000;0
27946;6326;116;0;0;0;0;.00nan;0;0
27946;7050;118;63;33;4;29;.879;3543000;0
27946;8515;118;0;0;0;0;.00nan;0;0
27947;5551;108;73;43;5;38;.884;3600000;0
27947;5714;106;65;21;2;19;.905;3600000;0
27947;7063;106;0;0;0;0;.00nan;0;0
27947;7777;108;0;0;0;0;.00nan;0;0
27948;6311;120;0;0;0;0;.00nan;0;0
27948;7141;120;73;23;2;21;.913;3600000;0
27948;7678;119;54;45;6;39;.867;2834000;0
27948;8676;119;52;9;1;8;.889;766000;0
27949;5832;110;75;13;1;12;.923;988000;0
27949;7192;104;0;0;0;0;.00nan;0;0
27949;7251;110;51;40;6;34;.850;2612000;0
27949;7655;104;40;16;3;13;.813;3600000;0
27950;5611;114;46;26;5;21;.808;3600000;0
27950;5614;114;0;0;0;0;.00nan;0;0
27950;5651;107;0;0;0;0;.00nan;0;0
27950;6248;107;67;32;3;29;.906;3600000;0
27951;5492;117;0;0;0;0;.00nan;0;0
27951;5655;117;72;23;1;22;.957;3600000;0
27951;7109;115;0;0;0;0;.00nan;0;0
27951;9106;115;62;37;4;33;.892;3600000;0
27952;7673;113;0;0;0;0;.00nan;0;0
27952;8562;111;63;28;3;25;.893;3600000;0
27952;8618;111;0;0;0;0;.00nan;0;0
27952;8685;113;64;51;6;45;.882;3600000;0
27953;5786;105;91;29;1;28;.966;3826000;0
27953;7145;105;0;0;0;0;.00nan;0;0
27953;9110;105;87;37;2;35;.946;3826000;0
27953;10008;109;0;0;0;0;.00nan;0;0
27954;6319;121;57;41;5;36;.878;3513000;0
27954;7160;112;94;43;3;40;.930;3600000;0
27954;8500;112;0;0;0;0;.00nan;0;0
27954;8628;121;0;0;0;0;.00nan;0;0
27955;5611;114;0;0;0;0;.00nan;0;0
27955;5614;114;73;29;3;26;.897;3600000;0
27955;5651;107;59;32;4;28;.875;3600000;0
27955;6248;107;0;0;0;0;.00nan;0;0
27956;5714;106;0;0;0;0;.00nan;0;0
27956;5786;105;0;0;0;0;.00nan;0;0
27956;7063;106;48;20;3;17;.850;3548000;0
27956;7145;105;90;36;2;34;.944;3600000;0
27957;5551;108;85;31;2;29;.935;3600000;0
27957;7673;113;50;23;3;20;.870;3583000;0
27957;7777;108;0;0;0;0;.00nan;0;0
27957;8685;113;0;0;0;0;.00nan;0;0
27958;6311;120;90;20;0;20;1.000;3600000;0
27958;7050;118;57;31;4;27;.871;1487000;0
27958;7141;120;0;0;0;0;.00nan;0;0
27958;8515;118;38;39;6;33;.846;2113000;0
27959;5714;106;87;29;2;27;.931;3600000;0
27959;7063;106;0;0;0;0;.00nan;0;0
27959;7192;104;64;28;3;25;.893;3551000;0
27959;7655;104;0;0;0;0;.00nan;0;0
27960;5492;117;36;18;4;14;.778;3600000;0
27960;5655;117;0;0;0;0;.00nan;0;0
27960;7678;119;0;0;0;0;.00nan;0;0
27960;8676;119;64;46;5;41;.891;3555000;0
27961;5611;114;0;0;0;0;.00nan;0;0
27961;5614;114;75;51;5;46;.902;3600000;0
27961;7673;113;0;0;0;0;.00nan;0;0
27961;8685;113;83;16;0;16;1.000;3600000;0
27962;5786;105;0;0;0;0;.00nan;0;0
27962;7145;105;56;33;3;30;.909;3600000;0
27962;9912;109;0;0;0;0;.00nan;0;0
27962;10008;109;66;23;2;21;.913;3600000;0
27963;7050;118;0;0;0;0;.00nan;0;0
27963;7160;112;0;0;0;0;.00nan;0;0
27963;8500;112;72;34;2;32;.941;3600000;0
27963;8515;118;73;42;4;38;.905;3551000;0
27964;6250;116;80;46;3;43;.935;3600000;0
27964;6326;116;0;0;0;0;.00nan;0;0
27964;8562;111;0;0;0;0;.00nan;0;0
27964;8618;111;39;22;4;18;.818;3548000;0
27965;5714;106;0;0;0;0;.00nan;0;0
27965;5832;110;0;0;0;0;.00nan;0;0
27965;7063;106;68;17;1;16;.941;3600000;0
27965;7251;110;98;56;2;54;.964;3579000;0
27966;5492;117;0;0;0;0;.00nan;0;0
27966;5655;117;59;18;2;16;.889;3600000;0
27966;7678;119;28;26;6;20;.769;2472000;0
27966;8676;119;61;10;0;10;1.000;1128000;0
27967;5551;108;0;0;0;0;.00nan;0;0
27967;6319;121;0;0;0;0;.00nan;0;0
27967;7095;108;68;42;5;37;.881;3600000;0
27967;8628;121;48;42;6;36;.857;3600000;0
27968;7192;104;0;0;0;0;.00nan;0;0
27968;7655;104;73;25;1;24;.960;3600000;0
27968;9912;109;34;34;6;28;.824;2208000;0
27968;10008;109;46;17;3;14;.824;1392000;0
27969;7109;115;80;22;1;21;.955;3600000;0
27969;7160;112;66;33;3;30;.909;3518000;0
27969;8500;112;0;0;0;0;.00nan;0;0
27969;9106;115;0;0;0;0;.00nan;0;0
27970;6311;120;45;29;5;24;.828;3600000;0
27970;7141;120;0;0;0;0;.00nan;0;0
27970;8562;111;35;36;6;30;.833;2239000;0
27970;8618;111;56;13;1;12;.923;1282000;0
27971;5786;105;0;0;0;0;.00nan;0;0
27971;7145;105;64;30;4;26;.867;3600000;0
27971;7673;113;0;0;0;0;.00nan;0;0
27971;8685;113;88;14;0;14;1.000;3600000;0
27972;5611;114;0;0;0;0;.00nan;0;0
27972;5614;114;78;50;5;45;.900;3600000;0
27972;7192;104;79;19;1;18;.947;3600000;0
27972;7655;104;0;0;0;0;.00nan;0;0
27973;5651;107;0;0;0;0;.00nan;0;0
27973;6248;107;43;25;4;21;.840;3582000;0
27973;6319;121;85;30;2;28;.933;3600000;0
27973;8628;121;0;0;0;0;.00nan;0;0
27974;7160;112;0;0;0;0;.00nan;0;0
27974;7678;119;82;44;5;39;.886;3600000;0
27974;8500;112;97;19;0;19;1.000;3600000;0
27974;8676;119;0;0;0;0;.00nan;0;0
27975;5651;107;100;39;1;38;.974;3600000;0
27975;5714;106;0;0;0;0;.00nan;0;0
27975;6248;107;0;0;0;0;.00nan;0;0
27975;7063;106;55;19;2;17;.895;3600000;0
27976;5492;117;0;0;0;0;.00nan;0;0
27976;5655;117;80;49;5;44;.898;3866000;0
27976;7109;115;49;0;0;0;.00nan;312000;0
27976;9106;115;37;31;5;26;.839;3588000;0
27977;6250;116;0;0;0;0;.00nan;0;0
27977;6311;120;0;0;0;0;.00nan;0;0
27977;6326;116;61;47;5;42;.894;3585000;0
27977;7141;120;58;31;4;27;.871;3600000;0
27978;7050;118;49;37;5;32;.865;3575000;0
27978;8515;118;0;0;0;0;.00nan;0;0
27978;8562;111;52;28;4;24;.857;3600000;0
27978;8618;111;0;0;0;0;.00nan;0;0
27979;5611;114;29;28;6;22;.786;3453000;0
27979;5614;114;39;6;2;4;.667;147000;0
27979;9912;109;57;32;4;28;.875;3600000;0
27979;10008;109;0;0;0;0;.00nan;0;0
27980;5786;105;73;45;5;40;.889;3600000;0
27980;7145;105;0;0;0;0;.00nan;0;0
27980;7673;113;0;0;0;0;.00nan;0;0
27980;8685;113;65;15;1;14;.933;3600000;0
27981;5551;108;0;0;0;0;.00nan;0;0
27981;5832;110;14;22;6;16;.727;2106000;0
27981;7095;108;87;32;1;31;.969;3600000;0
27981;7251;110;37;20;4;16;.800;1494000;0
27982;7050;118;0;0;0;0;.00nan;0;0
27982;7673;113;54;34;4;30;.882;3600000;0
27982;8515;118;57;25;3;22;.880;3600000;0
27982;8685;113;0;0;0;0;.00nan;0;0
27983;5492;117;53;2;0;2;1.000;135000;0
27983;5655;117;50;45;7;38;.844;3465000;0
27983;6311;120;0;0;0;0;.00nan;0;0
27983;7141;120;62;26;3;23;.885;3600000;0
27984;6250;116;16;16;5;11;.688;1965000;0
27984;6319;121;0;0;0;0;.00nan;0;0
27984;6326;116;78;22;1;21;.955;1635000;0
27984;8628;121;67;26;2;24;.923;3600000;0
27985;5614;114;56;16;2;14;.875;3600000;0
27985;5786;105;0;0;0;0;.00nan;0;0
27985;6290;114;0;0;0;0;.00nan;0;0
27985;7145;105;41;43;6;37;.860;3600000;0
27986;7109;115;55;17;2;15;.882;3600000;0
27986;7678;119;0;0;0;0;.00nan;0;0
27986;8676;119;69;56;5;51;.911;3600000;0
27986;9106;115;0;0;0;0;.00nan;0;0
27987;5551;108;0;0;0;0;.00nan;0;0
27987;7095;108;55;37;4;33;.892;3900000;0
27987;8562;111;0;0;0;0;.00nan;0;0
27987;8618;111;92;52;4;48;.923;3900000;0
27988;5832;110;0;0;0;0;.00nan;0;0
27988;7251;110;74;44;5;39;.886;3540000;0
27988;9912;109;80;40;3;37;.925;3600000;0
27988;10008;109;0;0;0;0;.00nan;0;0
27989;5651;107;49;2;0;2;1.000;252000;0
27989;6248;107;26;22;5;17;.773;3293000;0
27989;7192;104;64;30;3;27;.900;3600000;0
27989;7655;104;0;0;0;0;.00nan;0;0
27990;5492;117;54;33;4;29;.879;3545000;0
27990;5655;117;0;0;0;0;.00nan;0;0
27990;6311;120;59;23;2;21;.913;3600000;0
27990;7141;120;0;0;0;0;.00nan;0;0
27991;6250;116;41;30;5;25;.833;3532000;0
27991;6326;116;0;0;0;0;.00nan;0;0
27991;9912;109;0;0;0;0;.00nan;0;0
27991;10008;109;56;28;3;25;.893;3600000;0
27992;7109;115;80;36;2;34;.944;3600000;0
27992;7678;119;41;31;6;25;.806;3254000;0
27992;8676;119;51;2;0;2;1.000;346000;0
27992;9106;115;0;0;0;0;.00nan;0;0
27993;5614;114;55;14;1;13;.929;1724000;0
27993;5786;105;76;25;2;23;.920;3600000;0
27993;6290;114;21;23;6;17;.739;1876000;0
27993;7145;105;0;0;0;0;.00nan;0;0
27994;7050;118;46;24;4;20;.833;3563000;0
27994;7673;113;0;0;0;0;.00nan;0;0
27994;8515;118;0;0;0;0;.00nan;0;0
27994;8685;113;79;28;2;26;.929;3600000;0
27995;5551;108;82;33;2;31;.939;3600000;0
27995;7095;108;0;0;0;0;.00nan;0;0
27995;7160;112;48;25;4;21;.840;3526000;0
27995;8500;112;0;0;0;0;.00nan;0;0
27996;5714;106;0;0;0;0;.00nan;0;0
27996;6319;121;60;30;3;27;.900;3900000;0
27996;7063;106;97;45;3;42;.933;3893000;0
27996;8628;121;0;0;0;0;.00nan;0;0
27997;5714;106;69;29;2;27;.931;3697000;0
27997;5832;110;100;39;1;38;.974;3697000;0
27997;7063;106;0;0;0;0;.00nan;0;0
27997;7251;110;0;0;0;0;.00nan;0;0
27998;7160;112;0;0;0;0;.00nan;0;0
27998;8500;112;59;35;4;31;.886;3594000;0
27998;8562;111;44;22;3;19;.864;3600000;0
27998;8618;111;0;0;0;0;.00nan;0;0
27999;5651;107;65;34;3;31;.912;3600000;0
27999;6248;107;0;0;0;0;.00nan;0;0
27999;6250;116;0;0;0;0;.00nan;0;0
27999;6326;116;100;36;0;36;1.000;3600000;0
28000;5614;114;56;45;6;39;.867;3600000;0
28000;6290;114;0;0;0;0;.00nan;0;0
28000;7192;104;35;12;3;9;.750;3600000;0
28000;7655;104;0;0;0;0;.00nan;0;0
28001;6319;121;0;0;0;0;.00nan;0;0
28001;8628;121;57;32;4;28;.875;3600000;0
28001;9912;109;75;22;1;21;.955;3600000;0
28001;10008;109;0;0;0;0;.00nan;0;0
28002;7160;112;90;41;2;39;.951;3600000;0
28002;8500;112;0;0;0;0;.00nan;0;0
28002;8562;111;0;0;0;0;.00nan;0;0
28002;8618;111;57;26;3;23;.885;3599000;0
28003;5651;107;0;0;0;0;.00nan;0;0
28003;6248;107;88;43;3;40;.930;3554000;0
28003;7678;119;0;0;0;0;.00nan;0;0
28003;8676;119;70;27;2;25;.926;3600000;0
28004;5832;110;0;0;0;0;.00nan;0;0
28004;7251;110;65;24;2;22;.917;3600000;0
28004;7673;113;20;22;6;16;.727;3164000;0
28004;8685;113;55;3;0;3;1.000;436000;0
28005;5786;105;53;3;0;3;1.000;208000;0
28005;7145;105;51;36;5;31;.861;3392000;0
28005;7192;104;0;0;0;0;.00nan;0;0
28005;7655;104;68;35;3;32;.914;3600000;0
28006;6319;121;0;0;0;0;.00nan;0;0
28006;7050;118;0;0;0;0;.00nan;0;0
28006;8515;118;82;33;2;31;.939;3600000;0
28006;8628;121;60;51;6;45;.882;3600000;0
28007;5492;117;0;0;0;0;.00nan;0;0
28007;5655;117;82;24;1;23;.958;3600000;0
28007;5714;106;0;0;0;0;.00nan;0;0
28007;7063;106;85;41;4;37;.902;3600000;0
28008;5651;107;38;36;6;30;.833;3023000;0
28008;6248;107;35;7;2;5;.714;577000;0
28008;6250;116;0;0;0;0;.00nan;0;0
28008;6326;116;93;34;2;32;.941;3600000;0
28009;5551;108;0;0;0;0;.00nan;0;0
28009;5614;114;85;40;3;37;.925;3900000;0
28009;6290;114;0;0;0;0;.00nan;0;0
28009;7095;108;73;33;3;30;.909;3900000;0
28010;7050;118;83;34;3;31;.912;3600000;0
28010;8515;118;0;0;0;0;.00nan;0;0
28010;9912;109;0;0;0;0;.00nan;0;0
28010;10008;109;43;27;5;22;.815;3538000;0
28011;5614;114;0;0;0;0;.00nan;0;0
28011;6290;114;72;31;2;29;.935;3600000;0
28011;7160;112;9;21;7;14;.667;2745000;0
28011;8500;112;47;6;1;5;.833;855000;0
28012;6311;120;0;0;0;0;.00nan;0;0
28012;7141;120;88;31;2;29;.935;3600000;0
28012;7678;119;70;41;4;37;.902;3588000;0
28012;8676;119;0;0;0;0;.00nan;0;0
28013;7673;113;43;3;1;2;.667;255000;0
28013;8562;111;0;0;0;0;.00nan;0;0
28013;8618;111;81;30;3;27;.900;3600000;0
28013;8685;113;35;31;6;25;.806;3345000;0
28014;5832;110;53;45;6;39;.867;3031000;0
28014;7192;104;46;15;3;12;.800;3600000;0
28014;7251;110;51;2;0;2;1.000;569000;0
28014;7655;104;0;0;0;0;.00nan;0;0
28015;6319;121;0;0;0;0;.00nan;0;0
28015;7160;112;0;0;0;0;.00nan;0;0
28015;8500;112;55;44;6;38;.864;3554000;0
28015;8628;121;45;38;5;33;.868;3600000;0
28016;5714;106;97;56;4;52;.929;3558000;0
28016;6311;120;60;28;3;25;.893;3600000;0
28016;7063;106;0;0;0;0;.00nan;0;0
28016;7141;120;0;0;0;0;.00nan;0;0
28017;5786;105;43;3;1;2;.667;1166000;0
28017;5832;110;0;0;0;0;.00nan;0;0
28017;7145;105;17;19;6;13;.684;2434000;0
28017;7251;110;92;36;2;34;.944;3600000;0
28018;5492;117;0;0;0;0;.00nan;0;0
28018;5651;107;85;47;3;44;.936;3577000;0
28018;5655;117;63;20;2;18;.900;3600000;0
28018;6248;107;0;0;0;0;.00nan;0;0
28019;6250;116;64;57;8;49;.860;3504000;0
28019;6326;116;51;2;0;2;1.000;96000;0
28019;7109;115;86;11;0;11;1.000;3600000;0
28019;9106;115;0;0;0;0;.00nan;0;0
28020;5714;106;0;0;0;0;.00nan;0;0
28020;7050;118;0;0;0;0;.00nan;0;0
28020;7063;106;72;34;3;31;.912;3600000;0
28020;8515;118;92;30;1;29;.967;3600000;0
28021;8562;111;69;27;2;25;.926;3600000;0
28021;8618;111;0;0;0;0;.00nan;0;0
28021;9912;109;48;27;4;23;.852;3600000;0
28021;10008;109;0;0;0;0;.00nan;0;0
28022;6311;120;0;0;0;0;.00nan;0;0
28022;7109;115;59;46;6;40;.870;3158000;0
28022;7141;120;41;23;4;19;.826;3600000;0
28022;9106;115;60;7;0;7;1.000;373000;0
28023;5614;114;59;34;4;30;.882;3558000;0
28023;6290;114;0;0;0;0;.00nan;0;0
28023;7673;113;0;0;0;0;.00nan;0;0
28023;8685;113;73;26;2;24;.923;3600000;0
28024;5786;105;44;5;1;4;.800;500000;0
28024;7145;105;83;66;7;59;.894;3100000;0
28024;7192;104;0;0;0;0;.00nan;0;0
28024;7655;104;57;18;2;16;.889;3600000;0
28025;5551;108;0;0;0;0;.00nan;0;0
28025;6319;121;65;55;7;48;.873;3600000;0
28025;7095;108;68;21;2;19;.905;3600000;0
28025;8628;121;0;0;0;0;.00nan;0;0
28026;5832;110;57;29;3;26;.897;3600000;0
28026;7251;110;0;0;0;0;.00nan;0;0
28026;9912;109;0;0;0;0;.00nan;0;0
28026;10008;109;46;25;4;21;.840;3547000;0
28027;5492;117;68;44;5;39;.886;3600000;0
28027;5655;117;0;0;0;0;.00nan;0;0
28027;7109;115;93;34;1;33;.971;3600000;0
28027;9106;115;0;0;0;0;.00nan;0;0
28028;7673;113;79;26;2;24;.923;3600000;0
28028;7678;119;0;0;0;0;.00nan;0;0
28028;8676;119;66;45;5;40;.889;3600000;0
28028;8685;113;0;0;0;0;.00nan;0;0
28029;6250;116;36;41;6;35;.854;2183000;0
28029;6326;116;54;19;2;17;.895;1417000;0
28029;7050;118;0;0;0;0;.00nan;0;0
28029;8515;118;58;22;3;19;.864;3600000;0
28030;5611;114;51;30;4;26;.867;2710000;0
28030;5614;114;17;7;4;3;.429;852000;0
28030;7678;119;29;34;7;27;.794;3479000;0
28030;8676;119;50;0;0;0;.00nan;121000;0
28031;6319;121;0;0;0;0;.00nan;0;0
28031;7192;104;75;24;1;23;.958;3600000;0
28031;7655;104;0;0;0;0;.00nan;0;0
28031;8628;121;79;40;3;37;.925;3558000;0
28032;5786;105;0;0;0;0;.00nan;0;0
28032;5832;110;0;0;0;0;.00nan;0;0
28032;7145;105;60;16;1;15;.938;3600000;0
28032;7251;110;50;33;5;28;.848;3600000;0
28033;5551;108;0;0;0;0;.00nan;0;0
28033;6311;120;0;0;0;0;.00nan;0;0
28033;7095;108;69;39;4;35;.897;3600000;0
28033;7141;120;40;31;5;26;.839;3545000;0
28034;5492;117;0;0;0;0;.00nan;0;0
28034;5655;117;76;34;2;32;.941;3900000;0
28034;7050;118;93;38;2;36;.947;3871000;0
28034;8515;118;0;0;0;0;.00nan;0;0
28035;5651;107;0;0;0;0;.00nan;0;0
28035;5832;110;100;26;0;26;1.000;3600000;0
28035;6248;107;67;42;4;38;.905;3600000;0
28035;7251;110;0;0;0;0;.00nan;0;0
28036;5714;106;90;38;2;36;.947;3900000;0
28036;5786;105;75;26;2;24;.923;3894000;0
28036;7063;106;0;0;0;0;.00nan;0;0
28036;7145;105;0;0;0;0;.00nan;0;0
28037;7678;119;0;0;0;0;.00nan;0;0
28037;8562;111;0;0;0;0;.00nan;0;0
28037;8618;111;80;35;3;32;.914;3568000;0
28037;8676;119;94;42;2;40;.952;3600000;0
28038;5551;108;30;24;5;19;.792;2701000;0
28038;7095;108;17;9;4;5;.556;899000;0
28038;7109;115;38;28;5;23;.821;3600000;0
28038;9106;115;0;0;0;0;.00nan;0;0
28039;7160;112;60;16;1;15;.938;3600000;0
28039;8500;112;0;0;0;0;.00nan;0;0
28039;9912;109;18;27;7;20;.741;2730000;0
28039;10008;109;49;10;1;9;.900;870000;0
28040;7192;104;50;29;4;25;.862;3600000;0
28040;7655;104;0;0;0;0;.00nan;0;0
28040;7673;113;44;20;3;17;.850;1731000;0
28040;8685;113;15;21;6;15;.714;1869000;0
28041;5611;114;51;8;1;7;.875;701000;0
28041;5614;114;35;39;6;33;.846;2899000;0
28041;6319;121;0;0;0;0;.00nan;0;0
28041;8628;121;68;38;4;34;.895;3600000;0
28042;5492;117;27;30;6;24;.800;3254000;0
28042;5655;117;65;9;0;9;1.000;646000;0
28042;7050;118;51;3;0;3;1.000;743000;0
28042;8515;118;33;34;6;28;.824;3157000;0
28043;6311;120;87;17;0;17;1.000;3600000;0
28043;7109;115;0;0;0;0;.00nan;0;0
28043;7141;120;0;0;0;0;.00nan;0;0
28043;9106;115;28;39;8;31;.795;3600000;0
28044;5611;114;0;0;0;0;.00nan;0;0
28044;5614;114;76;37;3;34;.919;3600000;0
28044;5714;106;0;0;0;0;.00nan;0;0
28044;7063;106;47;29;4;25;.862;3558000;0
28045;5651;107;79;52;4;48;.923;3690000;0
28045;5786;105;0;0;0;0;.00nan;0;0
28045;6248;107;0;0;0;0;.00nan;0;0
28045;7145;105;45;29;5;24;.828;3690000;0
28046;7160;112;0;0;0;0;.00nan;0;0
28046;7678;119;82;61;4;57;.934;3600000;0
28046;8500;112;45;36;6;30;.833;3599000;0
28046;8676;119;0;0;0;0;.00nan;0;0
28047;5551;108;0;0;0;0;.00nan;0;0
28047;6250;116;0;0;0;0;.00nan;0;0
28047;6326;116;71;30;2;28;.933;3600000;0
28047;7095;108;67;32;4;28;.875;3588000;0
28048;8562;111;51;30;4;26;.867;3565000;0
28048;8618;111;0;0;0;0;.00nan;0;0
28048;9912;109;0;0;0;0;.00nan;0;0
28048;10008;109;91;35;2;33;.943;3600000;0
28049;7192;104;0;0;0;0;.00nan;0;0
28049;7655;104;55;21;2;19;.905;3600000;0
28049;7673;113;40;23;4;19;.826;1843000;0
28049;8685;113;78;21;0;21;1.000;1697000;0
28050;6250;116;34;8;2;6;.750;1268000;0
28050;6311;120;82;30;1;29;.967;3600000;0
28050;6326;116;34;26;6;20;.769;2332000;0
28050;7141;120;0;0;0;0;.00nan;0;0
28051;5651;107;37;56;9;47;.839;3600000;0
28051;6248;107;0;0;0;0;.00nan;0;0
28051;7192;104;50;19;3;16;.842;3600000;0
28051;7655;104;0;0;0;0;.00nan;0;0
28052;5551;108;0;0;0;0;.00nan;0;0
28052;7095;108;92;36;2;34;.944;3600000;0
28052;8562;111;0;0;0;0;.00nan;0;0
28052;8618;111;40;29;5;24;.828;3600000;0
28053;5832;110;0;0;0;0;.00nan;0;0
28053;7160;112;91;35;2;33;.943;3600000;0
28053;7251;110;63;36;4;32;.889;3555000;0
28053;8500;112;0;0;0;0;.00nan;0;0
28054;5651;107;0;0;0;0;.00nan;0;0
28054;5786;105;0;0;0;0;.00nan;0;0
28054;6248;107;88;35;2;33;.943;3799000;0
28054;7145;105;72;30;3;27;.900;3799000;0
28055;6319;121;0;0;0;0;.00nan;0;0
28055;7050;118;0;0;0;0;.00nan;0;0
28055;8515;118;80;23;1;22;.957;3600000;0
28055;8628;121;75;30;2;28;.933;3600000;0
28056;7160;112;0;0;0;0;.00nan;0;0
28056;8500;112;75;28;2;26;.929;3600000;0
28056;8562;111;51;4;0;4;1.000;972000;0
28056;8618;111;21;24;6;18;.750;2628000;0
28057;5492;117;0;0;0;0;.00nan;0;0
28057;5611;114;0;0;0;0;.00nan;0;0
28057;5614;114;55;38;4;34;.895;3543000;0
28057;5655;117;75;32;2;30;.938;3600000;0
28058;6250;116;66;40;5;35;.875;3600000;0
28058;6326;116;0;0;0;0;.00nan;0;0
28058;7678;119;0;0;0;0;.00nan;0;0
28058;8676;119;63;20;2;18;.900;3600000;0
28059;5714;106;0;0;0;0;.00nan;0;0
28059;7063;106;94;35;2;33;.943;3600000;0
28059;7109;115;59;25;3;22;.880;3542000;0
28059;9106;115;0;0;0;0;.00nan;0;0
28060;5551;108;24;5;3;2;.400;544000;0
28060;7095;108;78;34;2;32;.941;3056000;0
28060;7673;113;0;0;0;0;.00nan;0;0
28060;8685;113;84;34;2;32;.941;3600000;0
28061;7050;118;57;32;4;28;.875;3600000;0
28061;8515;118;0;0;0;0;.00nan;0;0
28061;9912;109;43;44;6;38;.864;3560000;0
28061;10008;109;0;0;0;0;.00nan;0;0
28062;5786;105;50;20;3;17;.850;1920000;0
28062;7145;105;7;31;8;23;.742;1680000;0
28062;7192;104;0;0;0;0;.00nan;0;0
28062;7655;104;60;23;3;20;.870;3600000;0
28063;6311;120;0;0;0;0;.00nan;0;0
28063;6319;121;76;45;4;41;.911;3576000;0
28063;7141;120;72;27;2;25;.926;3600000;0
28063;8628;121;0;0;0;0;.00nan;0;0
28064;5492;117;0;0;0;0;.00nan;0;0
28064;5655;117;52;36;5;31;.861;3600000;0
28064;5714;106;70;30;3;27;.900;3600000;0
28064;7063;106;0;0;0;0;.00nan;0;0
28065;5832;110;0;0;0;0;.00nan;0;0
28065;7251;110;66;29;4;25;.862;3600000;0
28065;8562;111;44;40;6;34;.850;3544000;0
28065;8618;111;0;0;0;0;.00nan;0;0
28066;5551;108;0;0;0;0;.00nan;0;0
28066;7095;108;98;64;4;60;.938;3600000;0
28066;7109;115;0;0;0;0;.00nan;0;0
28066;9106;115;86;33;1;32;.970;3600000;0
28067;5651;107;36;36;6;30;.833;2764000;0
28067;6248;107;50;8;1;7;.875;1020000;0
28067;7673;113;42;35;6;29;.829;3375000;0
28067;8685;113;53;4;0;4;1.000;409000;0
28068;6311;120;45;12;3;9;.750;3600000;0
28068;7141;120;0;0;0;0;.00nan;0;0
28068;9912;109;0;0;0;0;.00nan;0;0
28068;10008;109;76;58;5;53;.914;3556000;0
28069;6250;116;0;0;0;0;.00nan;0;0
28069;6319;121;0;0;0;0;.00nan;0;0
28069;6326;116;68;22;2;20;.909;3600000;0
28069;8628;121;54;27;3;24;.889;3600000;0
28070;7050;118;65;11;0;11;1.000;1896000;0
28070;7678;119;0;0;0;0;.00nan;0;0
28070;8515;118;14;18;6;12;.667;1704000;0
28070;8676;119;77;36;3;33;.917;3600000;0
28071;5492;117;0;0;0;0;.00nan;0;0
28071;5655;117;98;26;0;26;1.000;3600000;0
28071;5832;110;46;26;4;22;.846;2148000;0
28071;7251;110;57;15;2;13;.867;1452000;0
28072;5611;114;84;22;1;21;.955;2565000;0
28072;5614;114;30;14;4;10;.714;1035000;0
28072;7109;115;72;35;4;31;.886;3600000;0
28072;9106;115;0;0;0;0;.00nan;0;0
28073;5651;107;0;0;0;0;.00nan;0;0
28073;6248;107;91;50;4;46;.920;3527000;0
28073;7673;113;0;0;0;0;.00nan;0;0
28073;8685;113;56;20;2;18;.900;3600000;0
28074;6250;116;64;25;2;23;.920;3600000;0
28074;6326;116;0;0;0;0;.00nan;0;0
28074;9912;109;67;38;4;34;.895;3598000;0
28074;10008;109;0;0;0;0;.00nan;0;0
28075;5551;108;37;38;6;32;.842;3796000;0
28075;7095;108;0;0;0;0;.00nan;0;0
28075;7160;112;0;0;0;0;.00nan;0;0
28075;8500;112;53;36;5;31;.861;3796000;0
28076;5492;117;0;0;0;0;.00nan;0;0
28076;5655;117;96;64;6;58;.906;3600000;0
28076;7192;104;66;18;1;17;.944;3600000;0
28076;7655;104;0;0;0;0;.00nan;0;0
28077;5651;107;83;50;4;46;.920;3600000;0
28077;5714;106;0;0;0;0;.00nan;0;0
28077;6248;107;0;0;0;0;.00nan;0;0
28077;7063;106;77;31;1;30;.968;3600000;0
28078;7109;115;54;31;4;27;.871;3543000;0
28078;7678;119;0;0;0;0;.00nan;0;0
28078;8676;119;99;58;3;55;.948;3600000;0
28078;9106;115;0;0;0;0;.00nan;0;0
28079;5492;117;0;0;0;0;.00nan;0;0
28079;5655;117;40;21;4;17;.810;3900000;0
28079;5786;105;0;0;0;0;.00nan;0;0
28079;7145;105;64;31;4;27;.871;3900000;0
28080;5832;110;64;16;1;15;.938;1554000;0
28080;7251;110;47;31;6;25;.806;2046000;0
28080;9912;109;64;17;1;16;.941;3600000;0
28080;10008;109;0;0;0;0;.00nan;0;0
28081;5832;110;0;0;0;0;.00nan;0;0
28081;7160;112;64;35;4;31;.886;3900000;0
28081;7251;110;85;41;4;37;.902;3900000;0
28081;8500;112;0;0;0;0;.00nan;0;0
28082;5714;106;55;37;5;32;.865;3600000;0
28082;7063;106;0;0;0;0;.00nan;0;0
28082;7673;113;55;30;4;26;.867;3600000;0
28082;8685;113;0;0;0;0;.00nan;0;0
28083;5651;107;97;50;3;47;.940;3600000;0
28083;6248;107;0;0;0;0;.00nan;0;0
28083;6311;120;0;0;0;0;.00nan;0;0
28083;7141;120;100;27;0;27;1.000;3600000;0
28084;7192;104;0;0;0;0;.00nan;0;0
28084;7655;104;77;28;1;27;.964;3600000;0
28084;8562;111;0;0;0;0;.00nan;0;0
28084;8618;111;64;45;5;40;.889;3600000;0
28085;6250;116;78;46;5;41;.891;2939000;0
28085;6326;116;51;9;1;8;.889;661000;0
28085;7050;118;0;0;0;0;.00nan;0;0
28085;8515;118;65;28;3;25;.893;3600000;0
28086;7109;115;47;15;2;13;.867;3600000;0
28086;7678;119;0;0;0;0;.00nan;0;0
28086;8676;119;73;47;5;42;.894;3600000;0
28086;9106;115;0;0;0;0;.00nan;0;0
28087;5611;114;0;0;0;0;.00nan;0;0
28087;5614;114;82;28;2;26;.929;3600000;0
28087;6319;121;65;36;3;33;.917;3587000;0
28087;8628;121;0;0;0;0;.00nan;0;0
28088;5551;108;0;0;0;0;.00nan;0;0
28088;7095;108;57;31;4;27;.871;3805000;0
28088;7160;112;0;0;0;0;.00nan;0;0
28088;8500;112;86;40;3;37;.925;3805000;0
28089;5492;117;0;0;0;0;.00nan;0;0
28089;5651;107;0;0;0;0;.00nan;0;0
28089;5655;117;59;22;3;19;.864;3600000;0
28089;6248;107;59;40;5;35;.875;3573000;0
28090;5832;110;42;37;6;31;.838;2776000;0
28090;6311;120;45;16;3;13;.813;3600000;0
28090;7141;120;0;0;0;0;.00nan;0;0
28090;7251;110;57;13;1;12;.923;824000;0
28091;5786;105;0;0;0;0;.00nan;0;0
28091;7145;105;54;25;4;21;.840;3600000;0
28091;8562;111;100;47;1;46;.979;3600000;0
28091;8618;111;0;0;0;0;.00nan;0;0
28092;7050;118;60;24;3;21;.875;3600000;0
28092;7109;115;50;38;7;31;.816;3538000;0
28092;8515;118;0;0;0;0;.00nan;0;0
28092;9106;115;39;1;1;0;.000;62000;0
28093;6319;121;0;0;0;0;.00nan;0;0
28093;7160;112;62;25;3;22;.880;3600000;0
28093;8500;112;0;0;0;0;.00nan;0;0
28093;8628;121;50;28;5;23;.821;3581000;0
28094;5714;106;0;0;0;0;.00nan;0;0
28094;7063;106;43;44;6;38;.864;3560000;0
28094;9912;109;0;0;0;0;.00nan;0;0
28094;10008;109;56;38;5;33;.868;3600000;0
28095;5551;108;100;47;2;45;.957;3600000;0
28095;6311;120;0;0;0;0;.00nan;0;0
28095;7095;108;0;0;0;0;.00nan;0;0
28095;7141;120;55;28;3;25;.893;3548000;0
28096;7192;104;73;11;0;11;1.000;3600000;0
28096;7655;104;0;0;0;0;.00nan;0;0
28096;8562;111;0;0;0;0;.00nan;0;0
28096;8618;111;68;43;5;38;.884;3600000;0
28097;5611;114;0;0;0;0;.00nan;0;0
28097;5614;114;92;44;2;42;.955;3587000;0
28097;7673;113;0;0;0;0;.00nan;0;0
28097;8685;113;75;24;1;23;.958;3600000;0
28098;6250;116;0;0;0;0;.00nan;0;0
28098;6326;116;74;32;2;30;.938;3600000;0
28098;7678;119;37;28;5;23;.821;3600000;0
28098;8676;119;0;0;0;0;.00nan;0;0
28099;7050;118;0;0;0;0;.00nan;0;0
28099;7678;119;0;0;0;0;.00nan;0;0
28099;8515;118;53;24;3;21;.875;3549000;0
28099;8676;119;100;49;2;47;.959;3600000;0
28100;6250;116;34;44;7;37;.841;3109000;0
28100;6326;116;37;6;2;4;.667;491000;0
28100;7109;115;0;0;0;0;.00nan;0;0
28100;9106;115;56;28;3;25;.893;3600000;0
28101;5551;108;0;0;0;0;.00nan;0;0
28101;5611;114;0;0;0;0;.00nan;0;0
28101;5614;114;62;34;4;30;.882;3583000;0
28101;7095;108;58;27;3;24;.889;3600000;0
28102;5492;117;0;0;0;0;.00nan;0;0
28102;5655;117;52;39;5;34;.872;3524000;0
28102;7050;118;0;0;0;0;.00nan;0;0
28102;8515;118;57;22;3;19;.864;3600000;0
28103;7109;115;60;26;3;23;.885;3600000;0
28103;7673;113;24;13;4;9;.692;1077000;0
28103;8685;113;26;17;4;13;.765;2523000;0
28103;9106;115;0;0;0;0;.00nan;0;0
28104;5611;114;93;41;3;38;.927;3600000;0
28104;5614;114;0;0;0;0;.00nan;0;0
28104;7160;112;0;0;0;0;.00nan;0;0
28104;8500;112;51;38;5;33;.868;3575000;0
28105;6250;116;39;18;3;15;.833;1348000;0
28105;6326;116;6;15;6;9;.600;2252000;0
28105;7673;113;14;20;6;14;.700;3600000;0
28105;8685;113;0;0;0;0;.00nan;0;0
28106;6319;121;0;0;0;0;.00nan;0;0
28106;8628;121;75;29;2;27;.931;3900000;0
28106;9912;109;69;26;2;24;.923;3900000;0
28106;10008;109;0;0;0;0;.00nan;0;0
28107;5714;106;56;31;4;27;.871;3600000;0
28107;6319;121;28;29;6;23;.793;2165000;0
28107;7063;106;0;0;0;0;.00nan;0;0
28107;8628;121;47;12;2;10;.833;1435000;0
28108;5551;108;0;0;0;0;.00nan;0;0
28108;5832;110;0;0;0;0;.00nan;0;0
28108;7095;108;61;33;4;29;.879;3900000;0
28108;7251;110;91;53;4;49;.925;3900000;0
28109;5651;107;76;44;4;40;.909;3600000;0
28109;6248;107;0;0;0;0;.00nan;0;0
28109;9912;109;40;2;1;1;.500;93000;0
28109;10008;109;41;26;5;21;.808;3507000;0
28110;5786;105;0;0;0;0;.00nan;0;0
28110;7109;115;36;24;4;20;.833;3528000;0
28110;7145;105;100;42;2;40;.952;3600000;0
28110;9106;115;0;0;0;0;.00nan;0;0
28111;5492;117;80;27;2;25;.926;3071000;0
28111;5655;117;33;11;3;8;.727;529000;0
28111;7678;119;56;27;3;24;.889;3103000;0
28111;8676;119;31;9;3;6;.667;442000;0
28112;7192;104;69;37;2;35;.946;3900000;0
28112;7655;104;0;0;0;0;.00nan;0;0
28112;8562;111;0;0;0;0;.00nan;0;0
28112;8618;111;86;36;2;34;.944;3900000;0
28113;6311;120;0;0;0;0;.00nan;0;0
28113;7050;118;79;47;4;43;.915;3600000;0
28113;7141;120;64;42;6;36;.857;3524000;0
28113;8515;118;0;0;0;0;.00nan;0;0
28114;5611;114;0;0;0;0;.00nan;0;0
28114;5614;114;50;27;4;23;.852;3558000;0
28114;8562;111;89;33;1;32;.970;3600000;0
28114;8618;111;0;0;0;0;.00nan;0;0
28115;5492;117;0;0;0;0;.00nan;0;0
28115;5655;117;60;36;4;32;.889;3600000;0
28115;7673;113;0;0;0;0;.00nan;0;0
28115;8685;113;36;28;5;23;.821;3600000;0
28116;5786;105;0;0;0;0;.00nan;0;0
28116;6250;116;66;23;2;21;.913;3600000;0
28116;6326;116;0;0;0;0;.00nan;0;0
28116;7145;105;41;29;5;24;.828;3600000;0
28117;7160;112;88;43;3;40;.930;3552000;0
28117;7192;104;0;0;0;0;.00nan;0;0
28117;7655;104;66;28;2;26;.929;3600000;0
28117;8500;112;0;0;0;0;.00nan;0;0
28118;6311;120;79;30;2;28;.933;3900000;0
28118;7050;118;0;0;0;0;.00nan;0;0
28118;7141;120;0;0;0;0;.00nan;0;0
28118;8515;118;93;44;2;42;.955;3900000;0
28119;5714;106;0;0;0;0;.00nan;0;0
28119;5832;110;45;34;5;29;.853;3600000;0
28119;7063;106;54;23;3;20;.870;3600000;0
28119;7251;110;0;0;0;0;.00nan;0;0
28120;6250;116;0;0;0;0;.00nan;0;0
28120;6326;116;100;29;0;29;1.000;3600000;0
28120;7109;115;69;20;1;19;.950;3544000;0
28120;9106;115;0;0;0;0;.00nan;0;0
28121;5786;105;28;17;4;13;.765;1179000;0
28121;7145;105;22;32;7;25;.781;2421000;0
28121;7678;119;0;0;0;0;.00nan;0;0
28121;8676;119;99;23;0;23;1.000;3600000;0
28122;5551;108;30;25;6;19;.760;3559000;0
28122;5651;107;77;51;5;46;.902;3600000;0
28122;6248;107;0;0;0;0;.00nan;0;0
28122;7095;108;0;0;0;0;.00nan;0;0
28123;7160;112;78;21;1;20;.952;3600000;0
28123;7192;104;67;24;2;22;.917;3600000;0
28123;7655;104;0;0;0;0;.00nan;0;0
28123;8500;112;0;0;0;0;.00nan;0;0
28124;6319;121;0;0;0;0;.00nan;0;0
28124;8628;121;87;35;2;33;.943;3600000;0
28124;9912;109;0;0;0;0;.00nan;0;0
28124;10008;109;73;36;3;33;.917;3561000;0
28125;5651;107;100;46;2;44;.957;3600000;0
28125;6248;107;0;0;0;0;.00nan;0;0
28125;8562;111;0;0;0;0;.00nan;0;0
28125;8618;111;51;25;3;22;.880;3595000;0
28126;5714;106;0;0;0;0;.00nan;0;0
28126;7063;106;66;24;2;22;.917;3600000;0
28126;9912;109;64;47;5;42;.894;3600000;0
28126;10008;109;0;0;0;0;.00nan;0;0
28127;5611;114;0;0;0;0;.00nan;0;0
28127;5614;114;82;34;2;32;.941;3900000;0
28127;5832;110;0;0;0;0;.00nan;0;0
28127;7251;110;92;38;2;36;.947;3900000;0
28128;5651;107;0;0;0;0;.00nan;0;0
28128;6248;107;55;39;5;34;.872;3600000;0
28128;7160;112;0;0;0;0;.00nan;0;0
28128;8500;112;93;20;0;20;1.000;3600000;0
28129;7109;115;79;17;1;16;.941;3600000;0
28129;8562;111;0;0;0;0;.00nan;0;0
28129;8618;111;71;57;6;51;.895;3600000;0
28129;9106;115;0;0;0;0;.00nan;0;0
28130;5551;108;0;0;0;0;.00nan;0;0
28130;7050;118;50;2;0;2;1.000;320000;0
28130;7095;108;68;35;4;31;.886;3600000;0
28130;8515;118;36;26;6;20;.769;3222000;0
28131;5492;117;55;6;0;6;1.000;374000;0
28131;5655;117;23;33;7;26;.788;3226000;0
28131;5696;120;62;33;3;30;.909;3600000;0
28131;7141;120;0;0;0;0;.00nan;0;0
28132;5651;107;75;45;4;41;.911;3900000;0
28132;5832;110;0;0;0;0;.00nan;0;0
28132;6248;107;0;0;0;0;.00nan;0;0
28132;7251;110;60;35;4;31;.886;3900000;0
28133;6250;116;0;0;0;0;.00nan;0;0
28133;6326;116;84;48;4;44;.917;3600000;0
28133;7673;113;100;23;0;23;1.000;3600000;0
28133;8685;113;0;0;0;0;.00nan;0;0
28134;7109;115;0;0;0;0;.00nan;0;0
28134;7160;112;0;0;0;0;.00nan;0;0
28134;8500;112;67;29;3;26;.897;3600000;0
28134;9106;115;62;31;4;27;.871;3563000;0
28135;6319;121;0;0;0;0;.00nan;0;0
28135;7192;104;57;33;3;30;.909;3900000;0
28135;7655;104;0;0;0;0;.00nan;0;0
28135;8628;121;77;40;3;37;.925;3900000;0
28136;5832;110;64;34;3;31;.912;3600000;0
28136;7050;118;31;31;6;25;.806;3447000;0
28136;7251;110;0;0;0;0;.00nan;0;0
28136;8515;118;50;1;0;1;1.000;153000;0
28137;5492;117;56;38;5;33;.868;3864000;0
28137;5655;117;0;0;0;0;.00nan;0;0
28137;7678;119;0;0;0;0;.00nan;0;0
28137;8676;119;83;44;4;40;.909;3864000;0
28138;5714;106;94;29;1;28;.966;3600000;0
28138;7063;106;0;0;0;0;.00nan;0;0
28138;8562;111;68;43;5;38;.884;3600000;0
28138;8618;111;0;0;0;0;.00nan;0;0
28139;5611;114;86;27;1;26;.963;3600000;0
28139;5614;114;0;0;0;0;.00nan;0;0
28139;6250;116;43;46;7;39;.848;3600000;0
28139;6326;116;0;0;0;0;.00nan;0;0
28140;7192;104;0;0;0;0;.00nan;0;0
28140;7655;104;65;29;2;27;.931;3600000;0
28140;9912;109;41;46;7;39;.848;3096000;0
28140;10008;109;49;2;0;2;1.000;504000;0
28141;5786;105;0;0;0;0;.00nan;0;0
28141;6319;121;47;22;3;19;.864;3600000;0
28141;7145;105;62;48;6;42;.875;3600000;0
28141;8628;121;0;0;0;0;.00nan;0;0
28142;5714;106;0;0;0;0;.00nan;0;0
28142;7050;118;0;0;0;0;.00nan;0;0
28142;7063;106;76;36;3;33;.917;3600000;0
28142;8515;118;76;47;4;43;.915;3587000;0
28143;5611;114;0;0;0;0;.00nan;0;0
28143;5614;114;83;38;2;36;.947;3900000;0
28143;7160;112;81;31;2;29;.935;3900000;0
28143;8500;112;0;0;0;0;.00nan;0;0
28144;5696;120;0;0;0;0;.00nan;0;0
28144;7141;120;74;20;1;19;.950;3600000;0
28144;7678;119;46;35;5;30;.857;3600000;0
28144;8676;119;0;0;0;0;.00nan;0;0
28145;5651;107;0;0;0;0;.00nan;0;0
28145;6248;107;58;16;1;15;.938;3600000;0
28145;8562;111;0;0;0;0;.00nan;0;0
28145;8618;111;83;39;3;36;.923;3532000;0
28146;5551;108;0;0;0;0;.00nan;0;0
28146;6250;116;68;30;2;28;.933;2624000;0
28146;6326;116;36;21;4;17;.810;976000;0
28146;7095;108;66;29;3;26;.897;3600000;0
28147;7109;115;90;36;1;35;.972;3600000;0
28147;7673;113;45;27;3;24;.889;3595000;0
28147;8685;113;0;0;0;0;.00nan;0;0
28147;9106;115;0;0;0;0;.00nan;0;0
28148;5786;105;59;28;4;24;.857;3600000;0
28148;7145;105;0;0;0;0;.00nan;0;0
28148;9912;109;0;0;0;0;.00nan;0;0
28148;10008;109;39;36;6;30;.833;3551000;0
28149;5714;106;0;0;0;0;.00nan;0;0
28149;7063;106;76;41;3;38;.927;3600000;0
28149;7160;112;59;37;4;33;.892;3556000;0
28149;8500;112;0;0;0;0;.00nan;0;0
28150;5551;108;31;32;7;25;.781;2972000;0
28150;7095;108;45;5;1;4;.800;628000;0
28150;7192;104;58;38;5;33;.868;3600000;0
28150;7655;104;0;0;0;0;.00nan;0;0
28151;5714;106;93;31;1;30;.968;3600000;0
28151;7063;106;0;0;0;0;.00nan;0;0
28151;8562;111;65;43;5;38;.884;3600000;0
28151;8618;111;0;0;0;0;.00nan;0;0
28152;5492;117;0;0;0;0;.00nan;0;0
28152;5611;114;68;36;4;32;.889;3554000;0
28152;5614;114;0;0;0;0;.00nan;0;0
28152;5655;117;69;31;3;28;.903;3600000;0
28153;5551;108;0;0;0;0;.00nan;0;0
28153;5786;105;76;19;1;18;.947;2707000;0
28153;7095;108;63;38;5;33;.868;3900000;0
28153;7145;105;28;17;4;13;.765;1193000;0
28154;6319;121;0;0;0;0;.00nan;0;0
28154;7673;113;0;0;0;0;.00nan;0;0
28154;8628;121;62;44;6;38;.864;3600000;0
28154;8685;113;92;36;1;35;.972;3600000;0
28155;7050;118;0;0;0;0;.00nan;0;0
28155;7109;115;77;25;2;23;.920;3900000;0
28155;8515;118;97;53;2;51;.962;3900000;0
28155;9106;115;0;0;0;0;.00nan;0;0
28156;5696;120;46;36;5;31;.861;3593000;0
28156;7141;120;0;0;0;0;.00nan;0;0
28156;7678;119;0;0;0;0;.00nan;0;0
28156;8676;119;64;36;4;32;.889;3600000;0
28157;5651;107;61;26;3;23;.885;3600000;0
28157;6248;107;0;0;0;0;.00nan;0;0
28157;7160;112;31;17;4;13;.765;661000;0
28157;8500;112;56;27;3;24;.889;2939000;0
28158;5832;110;55;1;0;1;1.000;77000;0
28158;7050;118;59;27;3;24;.889;3600000;0
28158;7251;110;31;48;9;39;.813;3523000;0
28158;8515;118;0;0;0;0;.00nan;0;0
28159;5611;114;56;29;4;25;.862;3738000;0
28159;5614;114;0;0;0;0;.00nan;0;0
28159;6250;116;82;36;3;33;.917;3738000;0
28159;6326;116;0;0;0;0;.00nan;0;0
28160;5786;105;0;0;0;0;.00nan;0;0
28160;6319;121;43;23;4;19;.826;3654000;0
28160;7145;105;63;38;5;33;.868;3654000;0
28160;8628;121;0;0;0;0;.00nan;0;0
28161;5696;120;48;0;0;0;.00nan;121000;0
28161;7141;120;27;23;6;17;.739;3479000;0
28161;7678;119;92;35;2;33;.943;3600000;0
28161;8676;119;0;0;0;0;.00nan;0;0
28162;7192;104;0;0;0;0;.00nan;0;0
28162;7655;104;48;22;3;19;.864;3600000;0
28162;9912;109;46;51;7;44;.863;2665000;0
28162;10008;109;30;10;3;7;.700;935000;0
28163;5714;106;0;0;0;0;.00nan;0;0
28163;7063;106;48;22;3;19;.864;3589000;0
28163;7160;112;70;27;2;25;.926;3600000;0
28163;8500;112;0;0;0;0;.00nan;0;0
28164;5492;117;0;0;0;0;.00nan;0;0
28164;5655;117;86;15;0;15;1.000;3600000;0
28164;6250;116;51;12;2;10;.833;1792000;0
28164;6326;116;28;20;5;15;.750;1808000;0
28165;5832;110;85;39;3;36;.923;3600000;0
28165;7251;110;0;0;0;0;.00nan;0;0
28165;7678;119;0;0;0;0;.00nan;0;0
28165;8676;119;61;34;4;30;.882;3552000;0
28166;5611;114;0;0;0;0;.00nan;0;0
28166;5614;114;73;40;4;36;.900;3600000;0
28166;7109;115;82;25;1;24;.960;3600000;0
28166;9106;115;0;0;0;0;.00nan;0;0
28167;7673;113;43;23;4;19;.826;3600000;0
28167;8562;111;0;0;0;0;.00nan;0;0
28167;8618;111;62;41;5;36;.878;3564000;0
28167;8685;113;0;0;0;0;.00nan;0;0
28168;5551;108;60;25;4;21;.840;3600000;0
28168;5786;105;59;41;5;36;.878;3600000;0
28168;7095;108;0;0;0;0;.00nan;0;0
28168;7145;105;0;0;0;0;.00nan;0;0
28169;5651;107;0;0;0;0;.00nan;0;0
28169;6248;107;29;32;6;26;.813;3600000;0
28169;9912;109;0;0;0;0;.00nan;0;0
28169;10008;109;83;32;2;30;.938;3600000;0
28170;6319;121;83;30;1;29;.967;3600000;0
28170;7192;104;30;19;4;15;.789;3600000;0
28170;7655;104;0;0;0;0;.00nan;0;0
28170;8628;121;0;0;0;0;.00nan;0;0
28171;5492;117;0;0;0;0;.00nan;0;0
28171;5655;117;38;28;5;23;.821;3600000;0
28171;7050;118;0;0;0;0;.00nan;0;0
28171;8515;118;100;38;1;37;.974;3600000;0
28172;5832;110;0;0;0;0;.00nan;0;0
28172;7109;115;64;18;2;16;.889;3600000;0
28172;7251;110;90;68;4;64;.941;3530000;0
28172;9106;115;0;0;0;0;.00nan;0;0
28173;5651;107;42;38;6;32;.842;3569000;0
28173;5714;106;64;39;4;35;.897;3600000;0
28173;6248;107;0;0;0;0;.00nan;0;0
28173;7063;106;0;0;0;0;.00nan;0;0
28174;5551;108;0;0;0;0;.00nan;0;0
28174;7095;108;61;33;4;29;.879;3600000;0
28174;7673;113;0;0;0;0;.00nan;0;0
28174;8685;113;85;49;3;46;.939;3600000;0
28175;6250;116;23;34;7;27;.794;2918000;0
28175;6311;120;94;27;1;26;.963;3600000;0
28175;6326;116;35;11;3;8;.727;682000;0
28175;7141;120;0;0;0;0;.00nan;0;0
28176;5786;105;0;0;0;0;.00nan;0;0
28176;7145;105;72;52;6;46;.885;3579000;0
28176;7192;104;0;0;0;0;.00nan;0;0
28176;7655;104;49;22;3;19;.864;3600000;0
28177;7160;112;0;0;0;0;.00nan;0;0
28177;8500;112;65;33;3;30;.909;3600000;0
28177;8562;111;73;42;5;37;.881;3531000;0
28177;8618;111;0;0;0;0;.00nan;0;0
28178;5492;117;0;0;0;0;.00nan;0;0
28178;5655;117;100;36;1;35;.972;3900000;0
28178;7109;115;74;23;1;22;.957;3900000;0
28178;9106;115;0;0;0;0;.00nan;0;0
28179;5714;106;0;0;0;0;.00nan;0;0
28179;5786;105;0;0;0;0;.00nan;0;0
28179;7063;106;55;22;2;20;.909;3600000;0
28179;7145;105;100;32;0;32;1.000;3600000;0
28180;5714;106;71;41;4;37;.902;3584000;0
28180;7063;106;0;0;0;0;.00nan;0;0
28180;7192;104;66;27;2;25;.926;3600000;0
28180;7655;104;0;0;0;0;.00nan;0;0
28181;5492;117;50;40;5;35;.875;3558000;0
28181;5655;117;0;0;0;0;.00nan;0;0
28181;6311;120;0;0;0;0;.00nan;0;0
28181;7141;120;35;21;4;17;.810;3600000;0
28182;5651;107;92;41;2;39;.951;3600000;0
28182;5786;105;0;0;0;0;.00nan;0;0
28182;6248;107;0;0;0;0;.00nan;0;0
28182;7145;105;78;43;3;40;.930;3565000;0
28183;6250;116;0;0;0;0;.00nan;0;0
28183;6326;116;94;50;3;47;.940;3900000;0
28183;7109;115;48;20;3;17;.850;3900000;0
28183;9106;115;0;0;0;0;.00nan;0;0
28184;5611;114;0;0;0;0;.00nan;0;0
28184;5614;114;72;43;4;39;.907;3900000;0
28184;7673;113;60;34;4;30;.882;3900000;0
28184;8685;113;0;0;0;0;.00nan;0;0
28185;7050;118;0;0;0;0;.00nan;0;0
28185;7678;119;0;0;0;0;.00nan;0;0
28185;8515;118;74;30;2;28;.933;3600000;0
28185;8676;119;56;42;6;36;.857;3600000;0
28186;5551;108;0;0;0;0;.00nan;0;0
28186;5832;110;70;47;6;41;.872;3385000;0
28186;7095;108;82;27;2;25;.926;3600000;0
28186;7251;110;50;2;0;2;1.000;215000;0
28187;6319;121;29;13;4;9;.692;1113000;0
28187;8562;111;0;0;0;0;.00nan;0;0
28187;8618;111;68;25;2;23;.920;3600000;0
28187;8628;121;57;23;3;20;.870;2487000;0
28188;5492;117;72;27;1;26;.963;2772000;0
28188;5655;117;44;16;4;12;.750;1128000;0
28188;6311;120;36;30;5;25;.833;3900000;0
28188;7141;120;0;0;0;0;.00nan;0;0
28189;5551;108;62;33;5;28;.848;3632000;0
28189;5832;110;0;0;0;0;.00nan;0;0
28189;7251;110;88;50;4;46;.920;3632000;0
28189;7777;108;0;0;0;0;.00nan;0;0
28190;5651;107;11;37;8;29;.784;2133000;0
28190;6248;107;45;23;4;19;.826;1467000;0
28190;7192;104;0;0;0;0;.00nan;0;0
28190;7655;104;44;17;3;14;.824;3600000;0
28191;6250;116;36;37;6;31;.838;3219000;0
28191;6326;116;54;4;0;4;1.000;381000;0
28191;7050;118;52;18;3;15;.833;3600000;0
28191;8515;118;0;0;0;0;.00nan;0;0
28192;7673;113;0;0;0;0;.00nan;0;0
28192;8685;113;82;27;1;26;.963;3600000;0
28192;9912;109;43;36;6;30;.833;3305000;0
28192;10008;109;49;2;0;2;1.000;295000;0
28193;6319;121;79;36;3;33;.917;3600000;0
28193;7160;112;56;29;4;25;.862;3600000;0
28193;8500;112;0;0;0;0;.00nan;0;0
28193;8628;121;0;0;0;0;.00nan;0;0
28194;7160;112;0;0;0;0;.00nan;0;0
28194;8500;112;59;38;5;33;.868;3900000;0
28194;8562;111;0;0;0;0;.00nan;0;0
28194;8618;111;66;49;5;44;.898;3900000;0
28195;7109;115;0;0;0;0;.00nan;0;0
28195;7678;119;0;0;0;0;.00nan;0;0
28195;8676;119;75;39;5;34;.872;3600000;0
28195;9106;115;78;26;1;25;.962;3600000;0
28196;5611;114;97;35;1;34;.971;3600000;0
28196;5614;114;0;0;0;0;.00nan;0;0
28196;9912;109;0;0;0;0;.00nan;0;0
28196;10008;109;62;28;3;25;.893;3516000;0
28197;6319;121;65;38;4;34;.895;3600000;0
28197;8562;111;20;24;6;18;.750;2902000;0
28197;8618;111;51;3;0;3;1.000;634000;0
28197;8628;121;0;0;0;0;.00nan;0;0
28198;5492;117;0;0;0;0;.00nan;0;0
28198;5655;117;44;13;3;10;.769;3600000;0
28198;6250;116;93;64;5;59;.922;3587000;0
28198;6326;116;0;0;0;0;.00nan;0;0
28199;5786;105;0;0;0;0;.00nan;0;0
28199;5832;110;20;36;8;28;.778;2459000;0
28199;7145;105;54;17;2;15;.882;3600000;0
28199;7251;110;39;17;4;13;.765;1141000;0
28200;5714;106;0;0;0;0;.00nan;0;0
28200;7063;106;57;25;3;22;.880;3600000;0
28200;9912;109;67;50;6;44;.880;3600000;0
28200;10008;109;0;0;0;0;.00nan;0;0
28201;5551;108;43;23;4;19;.826;3664000;0
28201;7192;104;64;26;3;23;.885;3664000;0
28201;7655;104;0;0;0;0;.00nan;0;0
28201;7777;108;0;0;0;0;.00nan;0;0
28202;6250;116;0;0;0;0;.00nan;0;0
28202;6326;116;74;42;4;38;.905;3589000;0
28202;7050;118;0;0;0;0;.00nan;0;0
28202;8515;118;49;16;3;13;.813;3600000;0
28203;7160;112;46;35;5;30;.857;3600000;0
28203;7673;113;76;24;1;23;.958;3600000;0
28203;8500;112;0;0;0;0;.00nan;0;0
28203;8685;113;0;0;0;0;.00nan;0;0
28204;5492;117;27;6;3;3;.500;375000;0
28204;5655;117;86;36;2;34;.944;3225000;0
28204;7678;119;0;0;0;0;.00nan;0;0
28204;8676;119;86;31;2;29;.935;3600000;0
28205;6311;120;58;26;3;23;.885;3600000;0
28205;7109;115;48;44;6;38;.864;3600000;0
28205;7141;120;0;0;0;0;.00nan;0;0
28205;9106;115;0;0;0;0;.00nan;0;0
28206;5611;114;99;47;3;44;.936;3600000;0
28206;5614;114;0;0;0;0;.00nan;0;0
28206;8562;111;55;31;4;27;.871;3238000;0
28206;8618;111;48;6;1;5;.833;316000;0
28207;5786;105;62;29;4;25;.862;3626000;0
28207;7145;105;0;0;0;0;.00nan;0;0
28207;9912;109;61;28;3;25;.893;3626000;0
28207;10008;109;0;0;0;0;.00nan;0;0
28208;5551;108;46;6;1;5;.833;1216000;0
28208;5714;106;77;24;1;23;.958;3600000;0
28208;7063;106;0;0;0;0;.00nan;0;0
28208;7777;108;32;19;5;14;.737;2384000;0
28209;5832;110;92;45;3;42;.933;3600000;0
28209;7192;104;0;0;0;0;.00nan;0;0
28209;7251;110;0;0;0;0;.00nan;0;0
28209;7655;104;82;18;0;18;1.000;3600000;0
28210;5651;107;29;25;6;19;.760;2464000;0
28210;6248;107;25;14;4;10;.714;1136000;0
28210;6319;121;54;18;2;16;.889;3600000;0
28210;8628;121;0;0;0;0;.00nan;0;0
28211;6311;120;0;0;0;0;.00nan;0;0
28211;7050;118;71;41;5;36;.878;3600000;0
28211;7141;120;58;19;2;17;.895;3600000;0
28211;8515;118;0;0;0;0;.00nan;0;0
28212;7160;112;0;0;0;0;.00nan;0;0
28212;7673;113;32;3;2;1;.333;627000;0
28212;8500;112;59;35;4;31;.886;3600000;0
28212;8685;113;27;29;6;23;.793;2973000;0
28213;5492;117;0;0;0;0;.00nan;0;0
28213;5655;117;38;29;5;24;.828;3600000;0
28213;7678;119;88;30;2;28;.933;3600000;0
28213;8676;119;0;0;0;0;.00nan;0;0
28214;5611;114;0;0;0;0;.00nan;0;0
28214;5614;114;57;36;4;32;.889;3600000;0
28214;8562;111;0;0;0;0;.00nan;0;0
28214;8618;111;77;28;2;26;.929;3600000;0
28215;5832;110;0;0;0;0;.00nan;0;0
28215;6319;121;86;34;2;32;.941;3600000;0
28215;7251;110;71;40;4;36;.900;3592000;0
28215;8628;121;0;0;0;0;.00nan;0;0
28216;6250;116;50;49;7;42;.857;3600000;0
28216;6326;116;0;0;0;0;.00nan;0;0
28216;7109;115;57;20;3;17;.850;3600000;0
28216;9106;115;0;0;0;0;.00nan;0;0
28217;5651;107;0;0;0;0;.00nan;0;0
28217;5786;105;0;0;0;0;.00nan;0;0
28217;6248;107;68;34;4;30;.882;3600000;0
28217;7145;105;95;17;0;17;1.000;3600000;0
28218;5551;108;68;35;4;31;.886;3600000;0
28218;7777;108;0;0;0;0;.00nan;0;0
28218;9912;109;52;10;1;9;.900;1147000;0
28218;10008;109;49;39;6;33;.846;2453000;0
28219;5714;106;84;29;2;27;.931;3239000;0
28219;7063;106;34;11;3;8;.727;519000;0
28219;7192;104;0;0;0;0;.00nan;0;0
28219;7655;104;68;33;4;29;.879;3758000;0
28221;5492;117;0;0;0;0;.00nan;0;0
28221;5655;117;58;17;2;15;.882;3600000;0
28221;9208;106;66;21;2;19;.905;1850000;0
28221;10088;113;17;21;6;15;.714;1750000;0
28223;6250;116;31;33;6;27;.818;2806000;0
28223;6326;116;56;6;0;6;1.000;794000;0
28223;7678;119;0;0;0;0;.00nan;0;0
28223;8676;119;55;28;3;25;.893;3600000;0
28225;5651;107;90;63;3;60;.952;3532000;0
28225;6248;107;0;0;0;0;.00nan;0;0
28225;7192;104;66;17;1;16;.941;3600000;0
28225;10126;104;0;0;0;0;.00nan;0;0
28227;5808;105;0;0;0;0;.00nan;0;0
28227;7095;108;70;21;1;20;.952;3600000;0
28227;7145;105;71;31;3;28;.903;3525000;0
28227;9148;121;0;0;0;0;.00nan;0;0
28229;5832;110;52;41;6;35;.854;3330000;0
28229;7251;110;55;3;0;3;1.000;270000;0
28229;8515;118;66;18;1;17;.944;3600000;0
28229;8534;118;0;0;0;0;.00nan;0;0
28231;7160;112;55;6;0;6;1.000;332000;0
28231;9106;115;0;0;0;0;.00nan;0;0
28231;9214;115;48;16;3;13;.813;3600000;0
28231;10008;109;48;44;7;37;.841;3268000;0
28233;6311;120;76;29;2;27;.931;3600000;0
28233;7109;115;45;37;5;32;.865;3600000;0
28233;7141;120;0;0;0;0;.00nan;0;0
28233;7263;-1;0;0;0;0;.00nan;0;0
28235;5551;108;80;40;4;36;.900;3600000;0
28235;5786;105;0;0;0;0;.00nan;0;0
28235;7673;113;0;0;0;0;.00nan;0;0
28235;8685;113;84;27;1;26;.963;3600000;0
28237;5611;114;0;0;0;0;.00nan;0;0
28237;5614;114;54;32;4;28;.875;3600000;0
28237;5714;106;55;41;5;36;.878;3600000;0
28237;7063;106;0;0;0;0;.00nan;0;0
28239;5651;107;48;0;0;0;.00nan;72000;0
28239;6248;107;74;58;6;52;.897;3528000;0
28239;9208;106;0;0;0;0;.00nan;0;0
28239;10088;113;68;23;2;21;.913;3600000;0
28241;5492;117;42;3;1;2;.667;338000;0
28241;5655;117;50;47;6;41;.872;3262000;0
28241;7192;104;0;0;0;0;.00nan;0;0
28241;10126;104;50;26;4;22;.846;3600000;0
28243;6250;116;81;38;2;36;.947;3600000;0
28243;6326;116;0;0;0;0;.00nan;0;0
28243;7678;119;67;38;4;34;.895;3600000;0
28243;8676;119;0;0;0;0;.00nan;0;0
28245;5611;114;0;0;0;0;.00nan;0;0
28245;5614;114;90;54;4;50;.926;3658000;0
28245;7673;113;46;22;3;19;.864;3658000;0
28245;8685;113;0;0;0;0;.00nan;0;0
28247;7160;112;0;0;0;0;.00nan;0;0
28247;9106;115;50;13;2;11;.846;3600000;0
28247;9214;115;0;0;0;0;.00nan;0;0
28247;10008;109;94;52;3;49;.942;3560000;0
28249;5832;110;0;0;0;0;.00nan;0;0
28249;7095;108;0;0;0;0;.00nan;0;0
28249;7251;110;54;40;6;34;.850;3641000;0
28249;9148;121;53;36;5;31;.861;3641000;0
28251;5551;108;55;46;6;40;.870;3555000;0
28251;5786;105;50;0;0;0;.00nan;6000;0
28251;8515;118;0;0;0;0;.00nan;0;0
28251;8534;118;68;43;4;39;.907;3600000;0
28253;5714;106;0;0;0;0;.00nan;0;0
28253;7063;106;46;30;4;26;.867;3900000;0
28253;7109;115;0;0;0;0;.00nan;0;0
28253;7263;-1;84;52;4;48;.923;3900000;0
28255;5808;105;60;41;4;37;.902;3569000;0
28255;6311;120;0;0;0;0;.00nan;0;0
28255;7141;120;60;26;2;24;.923;3600000;0
28255;7145;105;0;0;0;0;.00nan;0;0
28257;5551;108;0;0;0;0;.00nan;0;0
28257;5714;106;21;24;6;18;.750;3590000;0
28257;5786;105;45;35;5;30;.857;3600000;0
28257;7063;106;0;0;0;0;.00nan;0;0
28259;7673;113;0;0;0;0;.00nan;0;0
28259;7678;119;0;0;0;0;.00nan;0;0
28259;8676;119;82;45;3;42;.933;3600000;0
28259;8685;113;50;25;4;21;.840;3569000;0
28261;5832;110;55;29;4;25;.862;3600000;0
28261;7251;110;0;0;0;0;.00nan;0;0
28261;9208;106;34;26;5;21;.808;3600000;0
28261;10088;113;0;0;0;0;.00nan;0;0
28263;6250;116;0;0;0;0;.00nan;0;0
28263;6326;116;77;44;5;39;.886;3600000;0
28263;7160;112;44;29;4;25;.862;2222000;0
28263;10008;109;42;12;2;10;.833;1346000;0
28265;5611;114;89;36;3;33;.917;3600000;0
28265;5614;114;0;0;0;0;.00nan;0;0
28265;6311;120;55;29;4;25;.862;3545000;0
28265;7141;120;0;0;0;0;.00nan;0;0
28267;7192;104;62;33;3;30;.909;3600000;0
28267;9106;115;61;32;3;29;.906;3282000;0
28267;9214;115;30;10;3;7;.700;318000;0
28267;10126;104;0;0;0;0;.00nan;0;0
28269;5808;105;57;9;0;9;1.000;1290000;0
28269;7145;105;46;33;5;28;.848;2310000;0
28269;8515;118;61;24;2;22;.917;3600000;0
28269;8534;118;0;0;0;0;.00nan;0;0
28271;5651;107;28;32;6;26;.813;3321000;0
28271;6248;107;49;2;0;2;1.000;279000;0
28271;7109;115;55;19;2;17;.895;3600000;0
28271;7263;-1;0;0;0;0;.00nan;0;0
28273;5492;117;75;47;5;42;.894;3600000;0
28273;5655;117;0;0;0;0;.00nan;0;0
28273;7095;108;52;28;4;24;.857;3600000;0
28273;9148;121;0;0;0;0;.00nan;0;0
28275;5551;108;94;45;2;43;.956;3600000;0
28275;5786;105;0;0;0;0;.00nan;0;0
28275;6311;120;48;0;0;0;.00nan;157000;0
28275;7141;120;23;32;7;25;.781;3443000;0
28277;5611;114;41;27;5;22;.815;3600000;0
28277;5614;114;0;0;0;0;.00nan;0;0
28277;7678;119;0;0;0;0;.00nan;0;0
28277;8676;119;39;38;6;32;.842;3545000;0
28279;5714;106;0;0;0;0;.00nan;0;0
28279;7063;106;78;38;3;35;.921;3900000;0
28279;7192;104;53;28;3;25;.893;3900000;0
28279;10126;104;0;0;0;0;.00nan;0;0
28281;8515;118;36;23;5;18;.783;2173000;0
28281;8534;118;58;12;1;11;.917;1427000;0
28281;8562;111;82;34;2;32;.941;3600000;0
28281;9208;106;0;0;0;0;.00nan;0;0
28283;7109;115;36;23;5;18;.783;3600000;0
28283;7160;112;0;0;0;0;.00nan;0;0
28283;7263;-1;0;0;0;0;.00nan;0;0
28283;10008;109;36;34;6;28;.824;3600000;0
28285;5492;117;0;0;0;0;.00nan;0;0
28285;5651;107;0;0;0;0;.00nan;0;0
28285;5655;117;96;19;0;19;1.000;3600000;0
28285;6248;107;97;57;3;54;.947;3600000;0
28287;5808;105;42;23;3;20;.870;2773000;0
28287;6250;116;45;22;3;19;.864;3600000;0
28287;6326;116;0;0;0;0;.00nan;0;0
28287;7145;105;18;12;5;7;.583;827000;0
28289;5832;110;44;35;6;29;.829;2232000;0
28289;7251;110;18;15;5;10;.667;1368000;0
28289;7673;113;61;23;3;20;.870;3600000;0
28289;8685;113;0;0;0;0;.00nan;0;0
28291;7095;108;0;0;0;0;.00nan;0;0
28291;9106;115;0;0;0;0;.00nan;0;0
28291;9148;121;60;28;3;25;.893;3600000;0
28291;9214;115;66;46;4;42;.913;3540000;0
28293;5551;108;48;42;6;36;.857;3533000;0
28293;5786;105;0;0;0;0;.00nan;0;0
28293;7095;108;52;30;4;26;.867;3600000;0
28293;9148;121;0;0;0;0;.00nan;0;0
28295;5611;114;48;0;0;0;.00nan;193000;0
28295;5614;114;32;35;7;28;.800;3407000;0
28295;7678;119;55;23;3;20;.870;3600000;0
28295;8676;119;0;0;0;0;.00nan;0;0
28297;5832;110;0;0;0;0;.00nan;0;0
28297;6311;120;60;22;2;20;.909;3600000;0
28297;7141;120;0;0;0;0;.00nan;0;0
28297;7251;110;57;30;4;26;.867;3600000;0
28299;5808;105;30;16;4;12;.750;1207000;0
28299;7109;115;0;0;0;0;.00nan;0;0
28299;7145;105;14;29;7;22;.759;2393000;0
28299;7263;-1;72;19;1;18;.947;3600000;0
28301;5714;106;32;39;7;32;.821;3133000;0
28301;7063;106;49;1;0;1;1.000;467000;0
28301;8562;111;0;0;0;0;.00nan;0;0
28301;9208;106;58;23;2;21;.913;3600000;0
28303;5651;107;21;24;6;18;.750;1291000;0
28303;6248;107;38;34;6;28;.824;2309000;0
28303;7192;104;0;0;0;0;.00nan;0;0
28303;10126;104;53;25;3;22;.880;3600000;0
28305;6250;116;0;0;0;0;.00nan;0;0
28305;6326;116;78;49;4;45;.918;3536000;0
28305;8515;118;64;23;2;21;.913;3600000;0
28305;8534;118;0;0;0;0;.00nan;0;0
28307;7160;112;96;66;4;62;.939;3600000;0
28307;9106;115;94;19;0;19;1.000;3600000;0
28307;9214;115;0;0;0;0;.00nan;0;0
28307;10008;109;0;0;0;0;.00nan;0;0
28309;5492;117;0;0;0;0;.00nan;0;0
28309;5655;117;51;46;7;39;.848;3600000;0
28309;7673;113;0;0;0;0;.00nan;0;0
28309;8685;113;51;22;3;19;.864;3600000;0
28311;5492;117;0;0;0;0;.00nan;0;0
28311;5655;117;63;39;4;35;.897;3533000;0
28311;7192;104;65;21;2;19;.905;3600000;0
28311;10126;104;0;0;0;0;.00nan;0;0
28313;7095;108;98;36;1;35;.972;2729000;0
28313;8515;118;0;0;0;0;.00nan;0;0
28313;8534;118;73;24;1;23;.958;3600000;0
28313;9148;121;21;10;4;6;.600;871000;0
28315;5808;105;53;52;7;45;.865;3600000;0
28315;7145;105;0;0;0;0;.00nan;0;0
28315;9106;115;70;19;1;18;.947;3600000;0
28315;9214;115;0;0;0;0;.00nan;0;0
28317;5714;106;51;3;0;3;1.000;195000;0
28317;7063;106;24;34;7;27;.794;3405000;0
28317;7160;112;0;0;0;0;.00nan;0;0
28317;10008;109;58;36;4;32;.889;3600000;0
28319;5832;110;79;39;3;36;.923;3600000;0
28319;7109;115;55;30;4;26;.867;3596000;0
28319;7251;110;0;0;0;0;.00nan;0;0
28319;7263;-1;0;0;0;0;.00nan;0;0
28321;5611;114;45;33;5;28;.848;3583000;0
28321;5614;114;0;0;0;0;.00nan;0;0
28321;8562;111;55;24;3;21;.875;3600000;0
28321;9208;106;0;0;0;0;.00nan;0;0
28323;5651;107;66;31;3;28;.903;3600000;0
28323;6248;107;0;0;0;0;.00nan;0;0
28323;7678;119;0;0;0;0;.00nan;0;0
28323;8676;119;90;26;2;24;.923;3600000;0
28325;6311;120;45;11;2;9;.818;1249000;0
28325;7141;120;20;17;5;12;.706;2351000;0
28325;7673;113;50;25;4;21;.840;3600000;0
28325;8685;113;0;0;0;0;.00nan;0;0
28327;5551;108;54;24;3;21;.875;3600000;0
28327;5786;105;0;0;0;0;.00nan;0;0
28327;6250;116;98;52;4;48;.923;3571000;0
28327;6326;116;0;0;0;0;.00nan;0;0
28329;7109;115;0;0;0;0;.00nan;0;0
28329;7160;112;58;44;5;39;.886;3600000;0
28329;7263;-1;61;25;2;23;.920;3600000;0
28329;10008;109;0;0;0;0;.00nan;0;0
28331;5551;108;67;26;2;24;.923;2522000;0
28331;5786;105;18;9;4;5;.556;1078000;0
28331;7673;113;0;0;0;0;.00nan;0;0
28331;8685;113;66;27;2;25;.926;3600000;0
28333;5492;117;53;29;4;25;.862;3600000;0
28333;5655;117;0;0;0;0;.00nan;0;0
28333;8562;111;48;0;0;0;.00nan;303000;0
28333;9208;106;30;30;6;24;.800;3282000;0
28335;8515;118;41;30;6;24;.800;2930000;0
28335;8534;118;65;7;0;7;1.000;670000;0
28335;9106;115;0;0;0;0;.00nan;0;0
28335;9214;115;60;19;2;17;.895;3600000;0
28337;5611;114;0;0;0;0;.00nan;0;0
28337;5614;114;83;50;2;48;.960;3600000;0
28337;6311;120;43;22;4;18;.818;3555000;0
28337;7141;120;0;0;0;0;.00nan;0;0
28339;5832;110;0;0;0;0;.00nan;0;0
28339;7251;110;61;37;5;32;.865;3718000;0
28339;7678;119;45;19;4;15;.789;3416000;0
28339;8676;119;51;1;0;1;1.000;302000;0
28341;5714;106;89;31;1;30;.968;3600000;0
28341;5808;105;0;0;0;0;.00nan;0;0
28341;7063;106;0;0;0;0;.00nan;0;0
28341;7145;105;65;36;4;32;.889;3600000;0
28343;5651;107;0;0;0;0;.00nan;0;0
28343;6248;107;81;50;4;46;.920;3600000;0
28343;7192;104;0;0;0;0;.00nan;0;0
28343;10126;104;75;23;1;22;.957;3600000;0
28345;6250;116;0;0;0;0;.00nan;0;0
28345;6326;116;100;54;0;54;1.000;3600000;0
28345;7095;108;0;0;0;0;.00nan;0;0
28345;9148;121;39;27;5;22;.815;3600000;0
28410;6250;116;47;6;1;5;.833;800000;0
28410;6311;120;46;17;3;14;.824;3600000;0
28410;6326;116;50;42;6;36;.857;2800000;0
28410;7141;120;0;0;0;0;.00nan;0;0
28411;7673;113;0;0;0;0;.00nan;0;0
28411;7678;119;0;0;0;0;.00nan;0;0
28411;8676;119;50;40;6;34;.850;3666000;0
28411;8685;113;29;28;5;23;.821;3666000;0
28412;5492;117;0;0;0;0;.00nan;0;0
28412;5655;117;69;44;4;40;.909;3831000;0
28412;7109;115;49;32;5;27;.844;3831000;0
28412;9106;115;0;0;0;0;.00nan;0;0
28413;7050;118;0;0;0;0;.00nan;0;0
28413;7160;112;49;40;5;35;.875;3600000;0
28413;8500;112;0;0;0;0;.00nan;0;0
28413;8515;118;97;38;1;37;.974;3600000;0
28414;5651;107;0;0;0;0;.00nan;0;0
28414;6248;107;63;52;7;45;.865;3600000;0
28414;7192;104;87;17;0;17;1.000;3600000;0
28414;7655;104;0;0;0;0;.00nan;0;0
28415;5551;108;0;0;0;0;.00nan;0;0
28415;7095;108;30;20;5;15;.750;5093000;0
28415;9912;109;68;65;6;59;.908;5093000;0
28415;10008;109;0;0;0;0;.00nan;0;0
28416;5714;106;0;0;0;0;.00nan;0;0
28416;5786;105;48;0;0;0;.00nan;108000;0
28416;7063;106;41;33;6;27;.818;3600000;0
28416;7145;105;45;47;8;39;.830;3424000;0
28417;5832;110;0;0;0;0;.00nan;0;0
28417;6319;121;0;0;0;0;.00nan;0;0
28417;7251;110;92;46;3;43;.935;4353000;0
28417;8628;121;75;31;2;29;.935;4353000;0
28418;6250;116;0;0;0;0;.00nan;0;0
28418;6311;120;73;25;2;23;.920;3600000;0
28418;6326;116;71;31;3;28;.903;3600000;0
28418;7141;120;0;0;0;0;.00nan;0;0
28419;7673;113;0;0;0;0;.00nan;0;0
28419;7678;119;36;12;3;9;.750;722000;0
28419;8676;119;41;38;6;32;.842;2878000;0
28419;8685;113;95;30;1;29;.967;3600000;0
28420;5492;117;0;0;0;0;.00nan;0;0
28420;5655;117;72;38;4;34;.895;3906000;0
28420;7109;115;35;23;5;18;.783;3906000;0
28420;9106;115;0;0;0;0;.00nan;0;0
28421;7050;118;0;0;0;0;.00nan;0;0
28421;7160;112;65;31;3;28;.903;3551000;0
28421;8500;112;0;0;0;0;.00nan;0;0
28421;8515;118;87;30;2;28;.933;3600000;0
28422;5651;107;0;0;0;0;.00nan;0;0
28422;6248;107;65;55;5;50;.909;3600000;0
28422;7192;104;59;13;1;12;.923;3600000;0
28422;7655;104;0;0;0;0;.00nan;0;0
28423;5551;108;0;0;0;0;.00nan;0;0
28423;7095;108;75;26;1;25;.962;3600000;0
28423;9912;109;28;15;4;11;.733;1076000;0
28423;10008;109;31;23;5;18;.783;2524000;0
28424;5714;106;0;0;0;0;.00nan;0;0
28424;5786;105;0;0;0;0;.00nan;0;0
28424;7063;106;54;31;4;27;.871;3563000;0
28424;7145;105;75;31;3;28;.903;3600000;0
28425;5832;110;0;0;0;0;.00nan;0;0
28425;6319;121;0;0;0;0;.00nan;0;0
28425;7251;110;54;36;5;31;.861;3524000;0
28425;8628;121;76;33;3;30;.909;3600000;0
28426;6250;116;45;13;2;11;.846;1028000;0
28426;6311;120;34;23;6;17;.739;3092000;0
28426;6326;116;36;29;6;23;.793;2565000;0
28426;7141;120;58;8;1;7;.875;508000;0
28427;7673;113;0;0;0;0;.00nan;0;0
28427;7678;119;0;0;0;0;.00nan;0;0
28427;8676;119;94;40;1;39;.975;3600000;0
28427;8685;113;71;26;3;23;.885;3573000;0
28428;5492;117;51;8;1;7;.875;984000;0
28428;5655;117;34;30;6;24;.800;2616000;0
28428;7109;115;74;36;3;33;.917;3600000;0
28428;9106;115;0;0;0;0;.00nan;0;0
28429;7050;118;0;0;0;0;.00nan;0;0
28429;7160;112;86;34;2;32;.941;3600000;0
28429;8500;112;0;0;0;0;.00nan;0;0
28429;8515;118;46;23;3;20;.870;3543000;0
28430;5651;107;0;0;0;0;.00nan;0;0
28430;6248;107;63;48;6;42;.875;3592000;0
28430;7192;104;21;10;4;6;.600;959000;0
28430;7655;104;66;19;1;18;.947;2641000;0
28431;5551;108;0;0;0;0;.00nan;0;0
28431;7095;108;67;13;1;12;.923;3600000;0
28431;9912;109;0;0;0;0;.00nan;0;0
28431;10008;109;97;49;2;47;.959;3600000;0
28432;5714;106;0;0;0;0;.00nan;0;0
28432;5786;105;0;0;0;0;.00nan;0;0
28432;7063;106;69;28;2;26;.929;4301000;0
28432;7145;105;91;54;3;51;.944;4301000;0
28433;5832;110;0;0;0;0;.00nan;0;0
28433;6319;121;0;0;0;0;.00nan;0;0
28433;7251;110;100;29;0;29;1.000;3600000;0
28433;8628;121;45;28;4;24;.857;3600000;0
28434;6250;116;44;4;1;3;.750;160000;0
28434;6311;120;46;4;1;3;.750;1781000;0
28434;6326;116;59;44;6;38;.864;3440000;0
28434;7141;120;18;13;5;8;.615;1819000;0
28435;7673;113;42;3;1;2;.667;215000;0
28435;7678;119;0;0;0;0;.00nan;0;0
28435;8676;119;92;38;2;36;.947;3600000;0
28435;8685;113;8;26;7;19;.731;3385000;0
28436;5492;117;71;30;3;27;.900;3113000;0
28436;5655;117;10;11;5;6;.545;479000;0
28436;7109;115;37;21;4;17;.810;989000;0
28436;9106;115;68;29;3;26;.897;2611000;0
28437;7050;118;0;0;0;0;.00nan;0;0
28437;7160;112;44;38;6;32;.842;3560000;0
28437;8500;112;0;0;0;0;.00nan;0;0
28437;8515;118;62;41;5;36;.878;3600000;0
28438;5651;107;39;16;3;13;.813;1288000;0
28438;6248;107;14;25;7;18;.720;2312000;0
28438;7192;104;64;17;1;16;.941;3600000;0
28438;7655;104;0;0;0;0;.00nan;0;0
28439;5551;108;0;0;0;0;.00nan;0;0
28439;7095;108;97;18;0;18;1.000;3600000;0
28439;9912;109;45;16;3;13;.813;949000;0
28439;10008;109;57;50;6;44;.880;2651000;0
28440;5714;106;0;0;0;0;.00nan;0;0
28440;5786;105;0;0;0;0;.00nan;0;0
28440;7063;106;63;28;3;25;.893;3600000;0
28440;7145;105;34;30;6;24;.800;3600000;0
28441;5832;110;0;0;0;0;.00nan;0;0
28441;6319;121;0;0;0;0;.00nan;0;0
28441;7251;110;84;44;3;41;.932;3596000;0
28441;8628;121;59;19;2;17;.895;3600000;0
28480;7673;113;0;0;0;0;.00nan;0;0
28480;7678;119;0;0;0;0;.00nan;0;0
28480;8676;119;55;26;3;23;.885;3593000;0
28480;8685;113;66;22;2;20;.909;3600000;0
28481;5492;117;0;0;0;0;.00nan;0;0
28481;5655;117;32;33;6;27;.818;3575000;0
28481;7109;115;69;40;4;36;.900;3600000;0
28481;9106;115;0;0;0;0;.00nan;0;0
28482;7050;118;0;0;0;0;.00nan;0;0
28482;7160;112;61;25;3;22;.880;3600000;0
28482;8500;112;0;0;0;0;.00nan;0;0
28482;8515;118;50;30;4;26;.867;3569000;0
28483;5714;106;0;0;0;0;.00nan;0;0
28483;5786;105;63;13;1;12;.923;1513000;0
28483;7063;106;63;24;3;21;.875;3600000;0
28483;7145;105;18;21;6;15;.714;2087000;0
28484;5832;110;0;0;0;0;.00nan;0;0
28484;6319;121;0;0;0;0;.00nan;0;0
28484;7251;110;66;32;3;29;.906;3600000;0
28484;8628;121;77;23;1;22;.957;3600000;0
28496;7673;113;0;0;0;0;.00nan;0;0
28496;7678;119;0;0;0;0;.00nan;0;0
28496;8676;119;46;38;5;33;.868;3563000;0
28496;8685;113;47;23;4;19;.826;3600000;0
28497;5492;117;0;0;0;0;.00nan;0;0
28497;5655;117;96;38;1;37;.974;3600000;0
28497;7109;115;71;40;4;36;.900;3600000;0
28497;9106;115;0;0;0;0;.00nan;0;0
28498;7050;118;0;0;0;0;.00nan;0;0
28498;7160;112;94;44;2;42;.955;4549000;0
28498;8500;112;0;0;0;0;.00nan;0;0
28498;8515;118;94;33;1;32;.970;4549000;0
28513;5492;117;0;0;0;0;.00nan;0;0
28513;5655;117;49;23;4;19;.826;3597000;0
28513;7109;115;73;38;3;35;.921;3600000;0
28513;9106;115;0;0;0;0;.00nan;0;0
28538;6311;120;61;36;5;31;.861;3600000;0
28538;7050;118;0;0;0;0;.00nan;0;0
28538;7141;120;0;0;0;0;.00nan;0;0
28538;8515;118;5;23;7;16;.696;3600000;0
28539;7109;115;30;8;3;5;.625;588000;0
28539;7673;113;0;0;0;0;.00nan;0;0
28539;8685;113;84;30;2;28;.933;3600000;0
28539;9106;115;60;24;2;22;.917;3012000;0
28540;6319;121;66;20;2;18;.900;1300000;0
28540;7192;104;64;24;2;22;.917;3600000;0
28540;7655;104;0;0;0;0;.00nan;0;0
28540;8628;121;11;26;7;19;.731;2300000;0
28541;5551;108;0;0;0;0;.00nan;0;0
28541;5714;106;0;0;0;0;.00nan;0;0
28541;7063;106;76;27;3;24;.889;3600000;0
28541;7095;108;75;43;5;38;.884;3542000;0
28542;6311;120;28;32;7;25;.781;3105000;0
28542;7050;118;56;3;0;3;1.000;447000;0
28542;7141;120;50;1;0;1;1.000;486000;0
28542;8515;118;64;40;6;34;.850;3153000;0
28543;7109;115;0;0;0;0;.00nan;0;0
28543;7673;113;0;0;0;0;.00nan;0;0
28543;8685;113;58;33;4;29;.879;3560000;0
28543;9106;115;72;34;3;31;.912;3600000;0
28544;6319;121;22;25;6;19;.760;2425000;0
28544;7192;104;48;14;2;12;.857;3600000;0
28544;7655;104;0;0;0;0;.00nan;0;0
28544;8628;121;56;7;0;7;1.000;1175000;0
28545;5551;108;0;0;0;0;.00nan;0;0
28545;5714;106;0;0;0;0;.00nan;0;0
28545;7063;106;73;35;3;32;.914;3556000;0
28545;7095;108;84;34;1;33;.971;3600000;0
28546;6311;120;0;0;0;0;.00nan;0;0
28546;7050;118;16;37;9;28;.757;3600000;0
28546;7141;120;69;23;2;21;.913;3600000;0
28546;8515;118;0;0;0;0;.00nan;0;0
28547;7109;115;0;0;0;0;.00nan;0;0
28547;7673;113;13;16;6;10;.625;894000;0
28547;8685;113;10;29;7;22;.759;2706000;0
28547;9106;115;86;28;1;27;.964;3600000;0
28548;6319;121;0;0;0;0;.00nan;0;0
28548;7192;104;56;17;2;15;.882;3600000;0
28548;7655;104;0;0;0;0;.00nan;0;0
28548;8628;121;71;47;4;43;.915;3573000;0
28549;5551;108;0;0;0;0;.00nan;0;0
28549;5714;106;0;0;0;0;.00nan;0;0
28549;7063;106;77;37;3;34;.919;3600000;0
28549;7095;108;51;33;5;28;.848;3541000;0
28550;6311;120;48;0;0;0;.00nan;319000;0
28550;7050;118;78;45;4;41;.911;3600000;0
28550;7141;120;32;29;6;23;.793;3194000;0
28550;8515;118;0;0;0;0;.00nan;0;0
28551;7109;115;0;0;0;0;.00nan;0;0
28551;7673;113;45;27;5;22;.815;3559000;0
28551;8685;113;0;0;0;0;.00nan;0;0
28551;9106;115;62;32;3;29;.906;3600000;0
28552;6319;121;71;18;0;18;1.000;1098000;0
28552;7192;104;80;22;1;21;.955;3600000;0
28552;7655;104;0;0;0;0;.00nan;0;0
28552;8628;121;18;27;7;20;.741;2502000;0
28553;5551;108;0;0;0;0;.00nan;0;0
28553;5714;106;0;0;0;0;.00nan;0;0
28553;7063;106;41;36;6;30;.833;3600000;0
28553;7095;108;100;39;2;37;.949;3600000;0
28626;6311;120;97;24;0;24;1.000;3600000;0
28626;7050;118;85;37;2;35;.946;3538000;0
28626;7141;120;0;0;0;0;.00nan;0;0
28626;8515;118;0;0;0;0;.00nan;0;0
28627;7109;115;0;0;0;0;.00nan;0;0
28627;7673;113;67;43;4;39;.907;3600000;0
28627;8685;113;0;0;0;0;.00nan;0;0
28627;9106;115;59;14;1;13;.929;3600000;0
28628;5551;108;0;0;0;0;.00nan;0;0
28628;5714;106;0;0;0;0;.00nan;0;0
28628;7063;106;76;37;5;32;.865;4106000;0
28628;7095;108;29;34;6;28;.824;4106000;0
28633;6311;120;58;21;2;19;.905;3600000;0
28633;7050;118;75;41;4;37;.902;3552000;0
28633;7141;120;0;0;0;0;.00nan;0;0
28633;8515;118;0;0;0;0;.00nan;0;0
28634;5551;108;0;0;0;0;.00nan;0;0
28634;5714;106;0;0;0;0;.00nan;0;0
28634;7063;106;64;38;5;33;.868;3659000;0
28634;7095;108;80;39;4;35;.897;3659000;0
28639;5551;108;0;0;0;0;.00nan;0;0
28639;5714;106;0;0;0;0;.00nan;0;0
28639;7063;106;94;49;3;46;.939;3639000;0
28639;7095;108;88;31;2;29;.935;3639000;0
28650;6311;120;84;41;3;38;.927;3749000;0
28650;7109;115;0;0;0;0;.00nan;0;0
28650;7141;120;0;0;0;0;.00nan;0;0
28650;9106;115;64;37;4;33;.892;3749000;0
28651;5551;108;0;0;0;0;.00nan;0;0
28651;7095;108;86;53;4;49;.925;3579000;0
28651;7192;104;63;33;3;30;.909;3600000;0
28651;7655;104;0;0;0;0;.00nan;0;0
28652;6311;120;80;31;2;29;.935;3600000;0
28652;7109;115;41;4;1;3;.750;260000;0
28652;7141;120;0;0;0;0;.00nan;0;0
28652;9106;115;12;45;9;36;.800;3340000;0
28653;5551;108;0;0;0;0;.00nan;0;0
28653;7095;108;68;41;5;36;.878;3600000;0
28653;7192;104;13;21;6;15;.714;1963000;0
28653;7655;104;38;16;3;13;.813;1637000;0
28654;6311;120;91;38;1;37;.974;3600000;0
28654;7109;115;0;0;0;0;.00nan;0;0
28654;7141;120;0;0;0;0;.00nan;0;0
28654;9106;115;49;28;4;24;.857;3600000;0
28655;5551;108;0;0;0;0;.00nan;0;0
28655;7095;108;73;29;2;27;.931;3600000;0
28655;7192;104;45;20;3;17;.850;2748000;0
28655;7655;104;20;9;4;5;.556;852000;0
28656;6311;120;81;40;3;37;.925;3998000;0
28656;7109;115;0;0;0;0;.00nan;0;0
28656;7141;120;0;0;0;0;.00nan;0;0
28656;9106;115;54;32;4;28;.875;3998000;0
28657;5551;108;59;16;1;15;.938;1578000;0
28657;7095;108;24;24;6;18;.750;2022000;0
28657;7192;104;53;21;3;18;.857;3600000;0
28657;7655;104;0;0;0;0;.00nan;0;0
28694;5551;108;0;0;0;0;.00nan;0;0
28694;7095;108;68;36;4;32;.889;3600000;0
28694;7192;104;29;30;6;24;.800;3600000;0
28694;7655;104;0;0;0;0;.00nan;0;0
28716;5551;108;0;0;0;0;.00nan;0;0
28716;7095;108;65;52;6;46;.885;3600000;0
28716;7192;104;53;22;3;19;.864;3600000;0
28716;7655;104;0;0;0;0;.00nan;0;0
28718;5551;108;44;5;1;4;.800;472000;0
28718;7095;108;50;44;6;38;.864;3128000;0
28718;7192;104;51;24;4;20;.833;3600000;0
28718;7655;104;0;0;0;0;.00nan;0;0
28723;6311;120;100;31;0;31;1.000;3600000;0
28723;7141;120;0;0;0;0;.00nan;0;0
28723;7192;104;55;32;4;28;.875;3600000;0
28723;7655;104;0;0;0;0;.00nan;0;0
28724;6311;120;47;39;6;33;.846;3050000;0
28724;7141;120;54;3;0;3;1.000;550000;0
28724;7192;104;74;30;3;27;.900;3600000;0
28724;7655;104;0;0;0;0;.00nan;0;0
28725;6311;120;0;0;0;0;.00nan;0;0
28725;7141;120;52;32;4;28;.875;3600000;0
28725;7192;104;95;33;1;32;.970;3600000;0
28725;7655;104;0;0;0;0;.00nan;0;0
28726;6311;120;0;0;0;0;.00nan;0;0
28726;7141;120;75;23;1;22;.957;3600000;0
28726;7192;104;28;28;6;22;.786;3009000;0
28726;7655;104;44;11;2;9;.818;591000;0
28738;6311;120;0;0;0;0;.00nan;0;0
28738;7141;120;68;21;2;19;.905;3600000;0
28738;7192;104;83;43;3;40;.930;3593000;0
28738;7655;104;0;0;0;0;.00nan;0;0
28743;6311;120;0;0;0;0;.00nan;0;0
28743;7141;120;69;39;4;35;.897;3600000;0
28743;7192;104;35;34;6;28;.824;3529000;0
28743;7655;104;0;0;0;0;.00nan;0;0
